ED,Reported As,Reporting,Steven Stern (Republican),J. Gustavo Rivera (Democratic),J. Gustavo Rivera (Working Families),Scattered,Jose A. Padilla Jr. (Independence),Steven Stern (Conservative),Total Votes,Steven Stern RECAP,J. Gustavo Rivera RECAP,Scattered RECAP,Jose A. Padilla Jr. RECAP,p_Steven Stern (Republican),p_J. Gustavo Rivera (Democratic),p_J. Gustavo Rivera (Working Families),p_Scattered,p_Jose A. Padilla Jr. (Independence),p_Steven Stern (Conservative),p_Steven Stern RECAP,p_J. Gustavo Rivera RECAP,p_Scattered RECAP,p_Jose A. Padilla Jr. RECAP,winner,winner_p
77017,77017,100,2,51,6,0,1,0,60,2,57,0,1,0.03333333333333333,0.85,0.1,0.0,0.016666666666666666,0.0,0.03333333333333333,0.95,0.0,0.016666666666666666,J. Gustavo Rivera RECAP,0.95
77029,77029,100,0,49,4,0,2,2,57,2,53,0,2,0.0,0.8596491228070176,0.07017543859649122,0.0,0.03508771929824561,0.03508771929824561,0.03508771929824561,0.9298245614035088,0.0,0.03508771929824561,J. Gustavo Rivera RECAP,0.9298245614035088
77030,77030,100,2,117,3,0,2,1,125,3,120,0,2,0.016,0.936,0.024,0.0,0.016,0.008,0.024,0.96,0.0,0.016,J. Gustavo Rivera RECAP,0.96
77033,77033,100,0,29,1,0,0,0,30,0,30,0,0,0.0,0.9666666666666667,0.03333333333333333,0.0,0.0,0.0,0.0,1.0,0.0,0.0,J. Gustavo Rivera RECAP,1.0
77037,77037,100,3,189,6,0,2,1,201,4,195,0,2,0.014925373134328358,0.9402985074626866,0.029850746268656716,0.0,0.009950248756218905,0.004975124378109453,0.01990049751243781,0.9701492537313433,0.0,0.009950248756218905,J. Gustavo Rivera RECAP,0.9701492537313433
77038,77038,100,2,82,2,0,3,1,90,3,84,0,3,0.022222222222222223,0.9111111111111111,0.022222222222222223,0.0,0.03333333333333333,0.011111111111111112,0.03333333333333333,0.9333333333333333,0.0,0.03333333333333333,J. Gustavo Rivera RECAP,0.9333333333333333
77039,77039,100,7,153,4,1,4,1,170,8,157,1,4,0.041176470588235294,0.9,0.023529411764705882,0.0058823529411764705,0.023529411764705882,0.0058823529411764705,0.047058823529411764,0.9235294117647059,0.0058823529411764705,0.023529411764705882,J. Gustavo Rivera RECAP,0.9235294117647059
77042,77042,100,2,107,4,1,3,0,117,2,111,1,3,0.017094017094017096,0.9145299145299145,0.03418803418803419,0.008547008547008548,0.02564102564102564,0.0,0.017094017094017096,0.9487179487179487,0.008547008547008548,0.02564102564102564,J. Gustavo Rivera RECAP,0.9487179487179487
77043,77043,100,3,205,5,1,3,1,218,4,210,1,3,0.013761467889908258,0.9403669724770642,0.022935779816513763,0.0045871559633027525,0.013761467889908258,0.0045871559633027525,0.01834862385321101,0.963302752293578,0.0045871559633027525,0.013761467889908258,J. Gustavo Rivera RECAP,0.963302752293578
77044,77044,100,7,134,3,2,0,0,146,7,137,2,0,0.04794520547945205,0.9178082191780822,0.02054794520547945,0.0136986301369863,0.0,0.0,0.04794520547945205,0.9383561643835616,0.0136986301369863,0.0,J. Gustavo Rivera RECAP,0.9383561643835616
77045,77045,100,13,234,11,0,4,0,262,13,245,0,4,0.04961832061068702,0.8931297709923665,0.04198473282442748,0.0,0.015267175572519083,0.0,0.04961832061068702,0.9351145038167938,0.0,0.015267175572519083,J. Gustavo Rivera RECAP,0.9351145038167938
77070,77070,100,0,0,0,0,0,0,0,0,0,0,0,0,0,0,0,0,0,0,0,0,0,n/a,0
78001,78001,100,6,144,9,0,1,1,161,7,153,0,1,0.037267080745341616,0.8944099378881988,0.055900621118012424,0.0,0.006211180124223602,0.006211180124223602,0.043478260869565216,0.9503105590062112,0.0,0.006211180124223602,J. Gustavo Rivera RECAP,0.9503105590062112
78002,78002,100,6,202,9,0,5,0,222,6,211,0,5,0.02702702702702703,0.9099099099099099,0.04054054054054054,0.0,0.02252252252252252,0.0,0.02702702702702703,0.9504504504504504,0.0,0.02252252252252252,J. Gustavo Rivera RECAP,0.9504504504504504
78003,78003,100,6,73,2,0,4,6,91,12,75,0,4,0.06593406593406594,0.8021978021978022,0.02197802197802198,0.0,0.04395604395604396,0.06593406593406594,0.13186813186813187,0.8241758241758241,0.0,0.04395604395604396,J. Gustavo Rivera RECAP,0.8241758241758241
78004,78004,100,11,169,4,0,2,5,191,16,173,0,2,0.05759162303664921,0.8848167539267016,0.020942408376963352,0.0,0.010471204188481676,0.02617801047120419,0.08376963350785341,0.9057591623036649,0.0,0.010471204188481676,J. Gustavo Rivera RECAP,0.9057591623036649
78005,78005,100,12,156,6,0,2,4,180,16,162,0,2,0.06666666666666667,0.8666666666666667,0.03333333333333333,0.0,0.011111111111111112,0.022222222222222223,0.08888888888888889,0.9,0.0,0.011111111111111112,J. Gustavo Rivera RECAP,0.9
78006,78006,100,16,189,7,0,3,5,220,21,196,0,3,0.07272727272727272,0.8590909090909091,0.031818181818181815,0.0,0.013636363636363636,0.022727272727272728,0.09545454545454546,0.8909090909090909,0.0,0.013636363636363636,J. Gustavo Rivera RECAP,0.8909090909090909
78008,78008,100,9,73,5,0,3,4,94,13,78,0,3,0.09574468085106383,0.776595744680851,0.05319148936170213,0.0,0.031914893617021274,0.0425531914893617,0.13829787234042554,0.8297872340425532,0.0,0.031914893617021274,J. Gustavo Rivera RECAP,0.8297872340425532
78009,78009,100,8,178,8,1,1,2,198,10,186,1,1,0.04040404040404041,0.898989898989899,0.04040404040404041,0.005050505050505051,0.005050505050505051,0.010101010101010102,0.050505050505050504,0.9393939393939394,0.005050505050505051,0.005050505050505051,J. Gustavo Rivera RECAP,0.9393939393939394
78010,78010,100,5,154,2,0,3,4,168,9,156,0,3,0.02976190476190476,0.9166666666666666,0.011904761904761904,0.0,0.017857142857142856,0.023809523809523808,0.05357142857142857,0.9285714285714286,0.0,0.017857142857142856,J. Gustavo Rivera RECAP,0.9285714285714286
78011,78011,100,5,130,4,0,3,0,142,5,134,0,3,0.035211267605633804,0.9154929577464789,0.028169014084507043,0.0,0.02112676056338028,0.0,0.035211267605633804,0.9436619718309859,0.0,0.02112676056338028,J. Gustavo Rivera RECAP,0.9436619718309859
78012,78012,100,3,184,6,0,0,3,196,6,190,0,0,0.015306122448979591,0.9387755102040817,0.030612244897959183,0.0,0.0,0.015306122448979591,0.030612244897959183,0.9693877551020408,0.0,0.0,J. Gustavo Rivera RECAP,0.9693877551020408
78013,78013,100,10,161,3,0,3,1,178,11,164,0,3,0.056179775280898875,0.9044943820224719,0.016853932584269662,0.0,0.016853932584269662,0.0056179775280898875,0.06179775280898876,0.9213483146067416,0.0,0.016853932584269662,J. Gustavo Rivera RECAP,0.9213483146067416
78014,78014,100,7,117,1,0,1,0,126,7,118,0,1,0.05555555555555555,0.9285714285714286,0.007936507936507936,0.0,0.007936507936507936,0.0,0.05555555555555555,0.9365079365079365,0.0,0.007936507936507936,J. Gustavo Rivera RECAP,0.9365079365079365
78015,78015,100,5,54,6,0,2,1,68,6,60,0,2,0.07352941176470588,0.7941176470588235,0.08823529411764706,0.0,0.029411764705882353,0.014705882352941176,0.08823529411764706,0.8823529411764706,0.0,0.029411764705882353,J. Gustavo Rivera RECAP,0.8823529411764706
78017,78017,100,1,53,2,0,1,0,57,1,55,0,1,0.017543859649122806,0.9298245614035088,0.03508771929824561,0.0,0.017543859649122806,0.0,0.017543859649122806,0.9649122807017544,0.0,0.017543859649122806,J. Gustavo Rivera RECAP,0.9649122807017544
78018,78018,100,9,100,2,0,2,2,115,11,102,0,2,0.0782608695652174,0.8695652173913043,0.017391304347826087,0.0,0.017391304347826087,0.017391304347826087,0.09565217391304348,0.8869565217391304,0.0,0.017391304347826087,J. Gustavo Rivera RECAP,0.8869565217391304
78019,78019,100,7,95,5,0,0,1,108,8,100,0,0,0.06481481481481481,0.8796296296296297,0.046296296296296294,0.0,0.0,0.009259259259259259,0.07407407407407407,0.9259259259259259,0.0,0.0,J. Gustavo Rivera RECAP,0.9259259259259259
78020,78020,100,4,114,6,1,3,1,129,5,120,1,3,0.031007751937984496,0.8837209302325582,0.046511627906976744,0.007751937984496124,0.023255813953488372,0.007751937984496124,0.03875968992248062,0.9302325581395349,0.007751937984496124,0.023255813953488372,J. Gustavo Rivera RECAP,0.9302325581395349
78021,78021,100,8,146,0,0,3,1,158,9,146,0,3,0.05063291139240506,0.9240506329113924,0.0,0.0,0.0189873417721519,0.006329113924050633,0.056962025316455694,0.9240506329113924,0.0,0.0189873417721519,J. Gustavo Rivera RECAP,0.9240506329113924
78022,78022,100,5,137,5,0,0,3,150,8,142,0,0,0.03333333333333333,0.9133333333333333,0.03333333333333333,0.0,0.0,0.02,0.05333333333333334,0.9466666666666667,0.0,0.0,J. Gustavo Rivera RECAP,0.9466666666666667
78023,78023,100,7,150,5,0,3,1,166,8,155,0,3,0.04216867469879518,0.9036144578313253,0.030120481927710843,0.0,0.018072289156626505,0.006024096385542169,0.04819277108433735,0.9337349397590361,0.0,0.018072289156626505,J. Gustavo Rivera RECAP,0.9337349397590361
78024,78024,100,10,133,9,0,8,1,161,11,142,0,8,0.062111801242236024,0.8260869565217391,0.055900621118012424,0.0,0.049689440993788817,0.006211180124223602,0.06832298136645963,0.8819875776397516,0.0,0.049689440993788817,J. Gustavo Rivera RECAP,0.8819875776397516
78025,78025,100,4,102,0,0,2,0,108,4,102,0,2,0.037037037037037035,0.9444444444444444,0.0,0.0,0.018518518518518517,0.0,0.037037037037037035,0.9444444444444444,0.0,0.018518518518518517,J. Gustavo Rivera RECAP,0.9444444444444444
78026,78026,100,2,102,2,1,4,1,112,3,104,1,4,0.017857142857142856,0.9107142857142857,0.017857142857142856,0.008928571428571428,0.03571428571428571,0.008928571428571428,0.026785714285714284,0.9285714285714286,0.008928571428571428,0.03571428571428571,J. Gustavo Rivera RECAP,0.9285714285714286
78027,78027,100,6,89,1,0,1,0,97,6,90,0,1,0.061855670103092786,0.9175257731958762,0.010309278350515464,0.0,0.010309278350515464,0.0,0.061855670103092786,0.9278350515463918,0.0,0.010309278350515464,J. Gustavo Rivera RECAP,0.9278350515463918
78028,78028,100,15,175,5,0,8,3,206,18,180,0,8,0.07281553398058252,0.8495145631067961,0.024271844660194174,0.0,0.038834951456310676,0.014563106796116505,0.08737864077669903,0.8737864077669902,0.0,0.038834951456310676,J. Gustavo Rivera RECAP,0.8737864077669902
78029,78029,100,6,113,11,0,0,0,130,6,124,0,0,0.046153846153846156,0.8692307692307693,0.08461538461538462,0.0,0.0,0.0,0.046153846153846156,0.9538461538461539,0.0,0.0,J. Gustavo Rivera RECAP,0.9538461538461539
78042,78042,100,0,0,0,0,0,0,0,0,0,0,0,0,0,0,0,0,0,0,0,0,0,n/a,0
78043,78043,100,3,60,0,0,1,0,64,3,60,0,1,0.046875,0.9375,0.0,0.0,0.015625,0.0,0.046875,0.9375,0.0,0.015625,J. Gustavo Rivera RECAP,0.9375
78044,78044,100,13,182,11,0,2,1,209,14,193,0,2,0.06220095693779904,0.8708133971291866,0.05263157894736842,0.0,0.009569377990430622,0.004784688995215311,0.06698564593301436,0.9234449760765551,0.0,0.009569377990430622,J. Gustavo Rivera RECAP,0.9234449760765551
78045,78045,100,12,172,2,0,1,1,188,13,174,0,1,0.06382978723404255,0.9148936170212766,0.010638297872340425,0.0,0.005319148936170213,0.005319148936170213,0.06914893617021277,0.925531914893617,0.0,0.005319148936170213,J. Gustavo Rivera RECAP,0.925531914893617
78046,78046,100,9,162,6,0,3,3,183,12,168,0,3,0.04918032786885246,0.8852459016393442,0.03278688524590164,0.0,0.01639344262295082,0.01639344262295082,0.06557377049180328,0.9180327868852459,0.0,0.01639344262295082,J. Gustavo Rivera RECAP,0.9180327868852459
78047,78047,100,4,103,4,0,3,1,115,5,107,0,3,0.034782608695652174,0.8956521739130435,0.034782608695652174,0.0,0.02608695652173913,0.008695652173913044,0.043478260869565216,0.9304347826086956,0.0,0.02608695652173913,J. Gustavo Rivera RECAP,0.9304347826086956
78048,78048,100,24,252,20,0,9,4,309,28,272,0,9,0.07766990291262135,0.8155339805825242,0.06472491909385113,0.0,0.02912621359223301,0.012944983818770227,0.09061488673139159,0.8802588996763754,0.0,0.02912621359223301,J. Gustavo Rivera RECAP,0.8802588996763754
78049,78049,100,10,177,9,0,2,0,198,10,186,0,2,0.050505050505050504,0.8939393939393939,0.045454545454545456,0.0,0.010101010101010102,0.0,0.050505050505050504,0.9393939393939394,0.0,0.010101010101010102,J. Gustavo Rivera RECAP,0.9393939393939394
78050,78050,100,9,177,5,2,7,0,200,9,182,2,7,0.045,0.885,0.025,0.01,0.035,0.0,0.045,0.91,0.01,0.035,J. Gustavo Rivera RECAP,0.91
78051,78051,100,7,187,7,0,5,2,208,9,194,0,5,0.03365384615384615,0.8990384615384616,0.03365384615384615,0.0,0.02403846153846154,0.009615384615384616,0.04326923076923077,0.9326923076923077,0.0,0.02403846153846154,J. Gustavo Rivera RECAP,0.9326923076923077
78052,78052,100,9,152,6,0,3,1,171,10,158,0,3,0.05263157894736842,0.8888888888888888,0.03508771929824561,0.0,0.017543859649122806,0.005847953216374269,0.05847953216374269,0.9239766081871345,0.0,0.017543859649122806,J. Gustavo Rivera RECAP,0.9239766081871345
78053,78053,100,7,98,2,1,4,0,112,7,100,1,4,0.0625,0.875,0.017857142857142856,0.008928571428571428,0.03571428571428571,0.0,0.0625,0.8928571428571429,0.008928571428571428,0.03571428571428571,J. Gustavo Rivera RECAP,0.8928571428571429
78054,78054,100,3,87,3,0,3,0,96,3,90,0,3,0.03125,0.90625,0.03125,0.0,0.03125,0.0,0.03125,0.9375,0.0,0.03125,J. Gustavo Rivera RECAP,0.9375
78055,78055,100,0,0,0,0,0,0,0,0,0,0,0,0,0,0,0,0,0,0,0,0,0,n/a,0
78057,78057,100,0,0,0,0,0,0,0,0,0,0,0,0,0,0,0,0,0,0,0,0,0,n/a,0
79001,79001,100,3,121,3,0,3,0,130,3,124,0,3,0.023076923076923078,0.9307692307692308,0.023076923076923078,0.0,0.023076923076923078,0.0,0.023076923076923078,0.9538461538461539,0.0,0.023076923076923078,J. Gustavo Rivera RECAP,0.9538461538461539
79002,79002,100,3,135,4,0,1,2,145,5,139,0,1,0.020689655172413793,0.9310344827586207,0.027586206896551724,0.0,0.006896551724137931,0.013793103448275862,0.034482758620689655,0.9586206896551724,0.0,0.006896551724137931,J. Gustavo Rivera RECAP,0.9586206896551724
79003,79003,100,0,158,2,0,1,2,163,2,160,0,1,0.0,0.9693251533742331,0.012269938650306749,0.0,0.006134969325153374,0.012269938650306749,0.012269938650306749,0.9815950920245399,0.0,0.006134969325153374,J. Gustavo Rivera RECAP,0.9815950920245399
79004,79004,100,5,102,0,0,1,0,108,5,102,0,1,0.046296296296296294,0.9444444444444444,0.0,0.0,0.009259259259259259,0.0,0.046296296296296294,0.9444444444444444,0.0,0.009259259259259259,J. Gustavo Rivera RECAP,0.9444444444444444
79005,79005,100,0,138,8,0,3,0,149,0,146,0,3,0.0,0.9261744966442953,0.053691275167785234,0.0,0.020134228187919462,0.0,0.0,0.9798657718120806,0.0,0.020134228187919462,J. Gustavo Rivera RECAP,0.9798657718120806
79007,79007,100,3,105,3,0,4,0,115,3,108,0,4,0.02608695652173913,0.9130434782608695,0.02608695652173913,0.0,0.034782608695652174,0.0,0.02608695652173913,0.9391304347826087,0.0,0.034782608695652174,J. Gustavo Rivera RECAP,0.9391304347826087
79008,79008,100,7,75,2,0,1,0,85,7,77,0,1,0.08235294117647059,0.8823529411764706,0.023529411764705882,0.0,0.011764705882352941,0.0,0.08235294117647059,0.9058823529411765,0.0,0.011764705882352941,J. Gustavo Rivera RECAP,0.9058823529411765
79009,79009,100,3,67,2,0,0,0,72,3,69,0,0,0.041666666666666664,0.9305555555555556,0.027777777777777776,0.0,0.0,0.0,0.041666666666666664,0.9583333333333334,0.0,0.0,J. Gustavo Rivera RECAP,0.9583333333333334
79010,79010,100,3,178,8,0,3,3,195,6,186,0,3,0.015384615384615385,0.9128205128205128,0.041025641025641026,0.0,0.015384615384615385,0.015384615384615385,0.03076923076923077,0.9538461538461539,0.0,0.015384615384615385,J. Gustavo Rivera RECAP,0.9538461538461539
79013,79013,100,9,156,10,0,1,0,176,9,166,0,1,0.05113636363636364,0.8863636363636364,0.056818181818181816,0.0,0.005681818181818182,0.0,0.05113636363636364,0.9431818181818182,0.0,0.005681818181818182,J. Gustavo Rivera RECAP,0.9431818181818182
79020,79020,100,4,78,5,0,4,1,92,5,83,0,4,0.043478260869565216,0.8478260869565217,0.05434782608695652,0.0,0.043478260869565216,0.010869565217391304,0.05434782608695652,0.9021739130434783,0.0,0.043478260869565216,J. Gustavo Rivera RECAP,0.9021739130434783
79074,79074,100,0,19,0,0,1,0,20,0,19,0,1,0.0,0.95,0.0,0.0,0.05,0.0,0.0,0.95,0.0,0.05,J. Gustavo Rivera RECAP,0.95
79029,79074,100,0,0,0,0,0,0,0,0,0,0,0,0,0,0,0,0,0,0,0,0,0,n/a,0
79030,79030,100,3,223,9,0,9,0,244,3,232,0,9,0.012295081967213115,0.9139344262295082,0.036885245901639344,0.0,0.036885245901639344,0.0,0.012295081967213115,0.9508196721311475,0.0,0.036885245901639344,J. Gustavo Rivera RECAP,0.9508196721311475
79031,79031,100,3,171,2,0,2,1,179,4,173,0,2,0.01675977653631285,0.9553072625698324,0.0111731843575419,0.0,0.0111731843575419,0.00558659217877095,0.0223463687150838,0.9664804469273743,0.0,0.0111731843575419,J. Gustavo Rivera RECAP,0.9664804469273743
79032,79032,100,6,125,7,0,2,0,140,6,132,0,2,0.04285714285714286,0.8928571428571429,0.05,0.0,0.014285714285714285,0.0,0.04285714285714286,0.9428571428571428,0.0,0.014285714285714285,J. Gustavo Rivera RECAP,0.9428571428571428
79033,79033,100,2,95,4,0,0,0,101,2,99,0,0,0.019801980198019802,0.9405940594059405,0.039603960396039604,0.0,0.0,0.0,0.019801980198019802,0.9801980198019802,0.0,0.0,J. Gustavo Rivera RECAP,0.9801980198019802
79034,79034,100,9,250,6,0,2,2,269,11,256,0,2,0.03345724907063197,0.929368029739777,0.022304832713754646,0.0,0.007434944237918215,0.007434944237918215,0.040892193308550186,0.9516728624535316,0.0,0.007434944237918215,J. Gustavo Rivera RECAP,0.9516728624535316
79035,79035,100,9,136,3,0,4,1,153,10,139,0,4,0.058823529411764705,0.8888888888888888,0.0196078431372549,0.0,0.026143790849673203,0.006535947712418301,0.06535947712418301,0.9084967320261438,0.0,0.026143790849673203,J. Gustavo Rivera RECAP,0.9084967320261438
79036,79036,100,2,147,2,0,1,0,152,2,149,0,1,0.013157894736842105,0.9671052631578947,0.013157894736842105,0.0,0.006578947368421052,0.0,0.013157894736842105,0.9802631578947368,0.0,0.006578947368421052,J. Gustavo Rivera RECAP,0.9802631578947368
79037,79037,100,8,226,1,0,1,2,238,10,227,0,1,0.03361344537815126,0.9495798319327731,0.004201680672268907,0.0,0.004201680672268907,0.008403361344537815,0.04201680672268908,0.9537815126050421,0.0,0.004201680672268907,J. Gustavo Rivera RECAP,0.9537815126050421
79067,79067,100,2,83,5,0,0,0,90,2,88,0,0,0.022222222222222223,0.9222222222222223,0.05555555555555555,0.0,0.0,0.0,0.022222222222222223,0.9777777777777777,0.0,0.0,J. Gustavo Rivera RECAP,0.9777777777777777
79077,79077,100,3,66,2,0,0,0,71,3,68,0,0,0.04225352112676056,0.9295774647887324,0.028169014084507043,0.0,0.0,0.0,0.04225352112676056,0.9577464788732394,0.0,0.0,J. Gustavo Rivera RECAP,0.9577464788732394
80009,80009,100,10,51,2,0,3,2,68,12,53,0,3,0.14705882352941177,0.75,0.029411764705882353,0.0,0.04411764705882353,0.029411764705882353,0.17647058823529413,0.7794117647058824,0.0,0.04411764705882353,J. Gustavo Rivera RECAP,0.7794117647058824
80010,80010,100,16,90,5,1,0,9,121,25,95,1,0,0.1322314049586777,0.743801652892562,0.04132231404958678,0.008264462809917356,0.0,0.0743801652892562,0.2066115702479339,0.7851239669421488,0.008264462809917356,0.0,J. Gustavo Rivera RECAP,0.7851239669421488
80011,80011,100,7,24,3,0,2,0,36,7,27,0,2,0.19444444444444445,0.6666666666666666,0.08333333333333333,0.0,0.05555555555555555,0.0,0.19444444444444445,0.75,0.0,0.05555555555555555,J. Gustavo Rivera RECAP,0.75
80012,80012,100,10,36,2,0,0,0,48,10,38,0,0,0.20833333333333334,0.75,0.041666666666666664,0.0,0.0,0.0,0.20833333333333334,0.7916666666666666,0.0,0.0,J. Gustavo Rivera RECAP,0.7916666666666666
80013,80013,100,25,65,7,0,2,3,102,28,72,0,2,0.24509803921568626,0.6372549019607843,0.06862745098039216,0.0,0.0196078431372549,0.029411764705882353,0.27450980392156865,0.7058823529411765,0.0,0.0196078431372549,J. Gustavo Rivera RECAP,0.7058823529411765
80015,80015,100,7,51,4,1,4,3,70,10,55,1,4,0.1,0.7285714285714285,0.05714285714285714,0.014285714285714285,0.05714285714285714,0.04285714285714286,0.14285714285714285,0.7857142857142857,0.014285714285714285,0.05714285714285714,J. Gustavo Rivera RECAP,0.7857142857142857
81001,81001,100,12,165,8,0,5,2,192,14,173,0,5,0.0625,0.859375,0.041666666666666664,0.0,0.026041666666666668,0.010416666666666666,0.07291666666666667,0.9010416666666666,0.0,0.026041666666666668,J. Gustavo Rivera RECAP,0.9010416666666666
81002,81002,100,23,142,11,0,7,2,185,25,153,0,7,0.12432432432432433,0.7675675675675676,0.05945945945945946,0.0,0.03783783783783784,0.010810810810810811,0.13513513513513514,0.827027027027027,0.0,0.03783783783783784,J. Gustavo Rivera RECAP,0.827027027027027
81003,81003,100,2,39,2,0,3,1,47,3,41,0,3,0.0425531914893617,0.8297872340425532,0.0425531914893617,0.0,0.06382978723404255,0.02127659574468085,0.06382978723404255,0.8723404255319149,0.0,0.06382978723404255,J. Gustavo Rivera RECAP,0.8723404255319149
81004,81004,100,9,170,7,1,6,4,197,13,177,1,6,0.04568527918781726,0.8629441624365483,0.03553299492385787,0.005076142131979695,0.030456852791878174,0.02030456852791878,0.06598984771573604,0.8984771573604061,0.005076142131979695,0.030456852791878174,J. Gustavo Rivera RECAP,0.8984771573604061
81005,81005,100,12,146,4,0,6,4,172,16,150,0,6,0.06976744186046512,0.8488372093023255,0.023255813953488372,0.0,0.03488372093023256,0.023255813953488372,0.09302325581395349,0.872093023255814,0.0,0.03488372093023256,J. Gustavo Rivera RECAP,0.872093023255814
81006,81006,100,8,146,9,0,5,2,170,10,155,0,5,0.047058823529411764,0.8588235294117647,0.052941176470588235,0.0,0.029411764705882353,0.011764705882352941,0.058823529411764705,0.9117647058823529,0.0,0.029411764705882353,J. Gustavo Rivera RECAP,0.9117647058823529
81007,81007,100,11,128,15,1,2,3,160,14,143,1,2,0.06875,0.8,0.09375,0.00625,0.0125,0.01875,0.0875,0.89375,0.00625,0.0125,J. Gustavo Rivera RECAP,0.89375
81008,81008,100,2,102,5,0,1,0,110,2,107,0,1,0.01818181818181818,0.9272727272727272,0.045454545454545456,0.0,0.00909090909090909,0.0,0.01818181818181818,0.9727272727272728,0.0,0.00909090909090909,J. Gustavo Rivera RECAP,0.9727272727272728
81009,81009,100,5,116,2,0,2,0,125,5,118,0,2,0.04,0.928,0.016,0.0,0.016,0.0,0.04,0.944,0.0,0.016,J. Gustavo Rivera RECAP,0.944
81038,81038,100,10,171,5,0,4,0,190,10,176,0,4,0.05263157894736842,0.9,0.02631578947368421,0.0,0.021052631578947368,0.0,0.05263157894736842,0.9263157894736842,0.0,0.021052631578947368,J. Gustavo Rivera RECAP,0.9263157894736842
81039,81039,100,8,81,6,0,1,5,101,13,87,0,1,0.07920792079207921,0.801980198019802,0.0594059405940594,0.0,0.009900990099009901,0.04950495049504951,0.12871287128712872,0.8613861386138614,0.0,0.009900990099009901,J. Gustavo Rivera RECAP,0.8613861386138614
81040,81040,100,11,147,11,0,4,2,175,13,158,0,4,0.06285714285714286,0.84,0.06285714285714286,0.0,0.022857142857142857,0.011428571428571429,0.07428571428571429,0.9028571428571428,0.0,0.022857142857142857,J. Gustavo Rivera RECAP,0.9028571428571428
81042,81042,100,7,33,5,0,2,1,48,8,38,0,2,0.14583333333333334,0.6875,0.10416666666666667,0.0,0.041666666666666664,0.020833333333333332,0.16666666666666666,0.7916666666666666,0.0,0.041666666666666664,J. Gustavo Rivera RECAP,0.7916666666666666
81045,81045,100,2,34,0,0,0,1,37,3,34,0,0,0.05405405405405406,0.918918918918919,0.0,0.0,0.0,0.02702702702702703,0.08108108108108109,0.918918918918919,0.0,0.0,J. Gustavo Rivera RECAP,0.918918918918919
81046,81046,100,11,60,6,0,1,0,78,11,66,0,1,0.14102564102564102,0.7692307692307693,0.07692307692307693,0.0,0.01282051282051282,0.0,0.14102564102564102,0.8461538461538461,0.0,0.01282051282051282,J. Gustavo Rivera RECAP,0.8461538461538461
86008,86008,100,11,164,5,0,4,2,186,13,169,0,4,0.05913978494623656,0.8817204301075269,0.026881720430107527,0.0,0.021505376344086023,0.010752688172043012,0.06989247311827956,0.9086021505376344,0.0,0.021505376344086023,J. Gustavo Rivera RECAP,0.9086021505376344
86009,86009,100,4,110,9,0,1,0,124,4,119,0,1,0.03225806451612903,0.8870967741935484,0.07258064516129033,0.0,0.008064516129032258,0.0,0.03225806451612903,0.9596774193548387,0.0,0.008064516129032258,J. Gustavo Rivera RECAP,0.9596774193548387
86010,86010,100,0,84,5,1,0,0,90,0,89,1,0,0.0,0.9333333333333333,0.05555555555555555,0.011111111111111112,0.0,0.0,0.0,0.9888888888888889,0.011111111111111112,0.0,J. Gustavo Rivera RECAP,0.9888888888888889
86011,86011,100,11,197,3,0,1,0,212,11,200,0,1,0.05188679245283019,0.9292452830188679,0.014150943396226415,0.0,0.0047169811320754715,0.0,0.05188679245283019,0.9433962264150944,0.0,0.0047169811320754715,J. Gustavo Rivera RECAP,0.9433962264150944
86012,86012,100,9,135,4,1,5,3,157,12,139,1,5,0.05732484076433121,0.8598726114649682,0.025477707006369428,0.006369426751592357,0.03184713375796178,0.01910828025477707,0.07643312101910828,0.8853503184713376,0.006369426751592357,0.03184713375796178,J. Gustavo Rivera RECAP,0.8853503184713376
86013,86013,100,7,121,4,0,1,0,133,7,125,0,1,0.05263157894736842,0.9097744360902256,0.03007518796992481,0.0,0.007518796992481203,0.0,0.05263157894736842,0.9398496240601504,0.0,0.007518796992481203,J. Gustavo Rivera RECAP,0.9398496240601504
86014,86014,100,4,186,4,0,3,2,199,6,190,0,3,0.020100502512562814,0.9346733668341709,0.020100502512562814,0.0,0.01507537688442211,0.010050251256281407,0.03015075376884422,0.9547738693467337,0.0,0.01507537688442211,J. Gustavo Rivera RECAP,0.9547738693467337
86015,86015,100,5,124,4,0,3,0,136,5,128,0,3,0.03676470588235294,0.9117647058823529,0.029411764705882353,0.0,0.022058823529411766,0.0,0.03676470588235294,0.9411764705882353,0.0,0.022058823529411766,J. Gustavo Rivera RECAP,0.9411764705882353
86016,86016,100,5,143,5,0,1,3,157,8,148,0,1,0.03184713375796178,0.910828025477707,0.03184713375796178,0.0,0.006369426751592357,0.01910828025477707,0.050955414012738856,0.9426751592356688,0.0,0.006369426751592357,J. Gustavo Rivera RECAP,0.9426751592356688
86017,86017,100,5,148,9,0,1,2,165,7,157,0,1,0.030303030303030304,0.896969696969697,0.05454545454545454,0.0,0.006060606060606061,0.012121212121212121,0.04242424242424243,0.9515151515151515,0.0,0.006060606060606061,J. Gustavo Rivera RECAP,0.9515151515151515
86018,86018,100,7,124,5,0,1,1,138,8,129,0,1,0.050724637681159424,0.8985507246376812,0.036231884057971016,0.0,0.007246376811594203,0.007246376811594203,0.057971014492753624,0.9347826086956522,0.0,0.007246376811594203,J. Gustavo Rivera RECAP,0.9347826086956522
86019,86019,100,10,196,5,1,8,1,221,11,201,1,8,0.04524886877828054,0.8868778280542986,0.02262443438914027,0.004524886877828055,0.03619909502262444,0.004524886877828055,0.049773755656108594,0.9095022624434389,0.004524886877828055,0.03619909502262444,J. Gustavo Rivera RECAP,0.9095022624434389
86020,86020,100,8,180,9,0,2,2,201,10,189,0,2,0.03980099502487562,0.8955223880597015,0.04477611940298507,0.0,0.009950248756218905,0.009950248756218905,0.04975124378109453,0.9402985074626866,0.0,0.009950248756218905,J. Gustavo Rivera RECAP,0.9402985074626866
86021,86021,100,0,15,0,0,0,0,15,0,15,0,0,0.0,1.0,0.0,0.0,0.0,0.0,0.0,1.0,0.0,0.0,J. Gustavo Rivera RECAP,1.0
86022,86022,100,6,154,9,2,2,3,176,9,163,2,2,0.03409090909090909,0.875,0.05113636363636364,0.011363636363636364,0.011363636363636364,0.017045454545454544,0.05113636363636364,0.9261363636363636,0.011363636363636364,0.011363636363636364,J. Gustavo Rivera RECAP,0.9261363636363636
86023,86023,100,7,152,7,0,1,3,170,10,159,0,1,0.041176470588235294,0.8941176470588236,0.041176470588235294,0.0,0.0058823529411764705,0.01764705882352941,0.058823529411764705,0.9352941176470588,0.0,0.0058823529411764705,J. Gustavo Rivera RECAP,0.9352941176470588
86024,86024,100,4,130,6,0,4,0,144,4,136,0,4,0.027777777777777776,0.9027777777777778,0.041666666666666664,0.0,0.027777777777777776,0.0,0.027777777777777776,0.9444444444444444,0.0,0.027777777777777776,J. Gustavo Rivera RECAP,0.9444444444444444
86025,86025,100,4,147,2,0,2,0,155,4,149,0,2,0.025806451612903226,0.9483870967741935,0.012903225806451613,0.0,0.012903225806451613,0.0,0.025806451612903226,0.9612903225806452,0.0,0.012903225806451613,J. Gustavo Rivera RECAP,0.9612903225806452
86026,86026,100,11,182,5,1,2,1,202,12,187,1,2,0.054455445544554455,0.900990099009901,0.024752475247524754,0.0049504950495049506,0.009900990099009901,0.0049504950495049506,0.0594059405940594,0.9257425742574258,0.0049504950495049506,0.009900990099009901,J. Gustavo Rivera RECAP,0.9257425742574258
86027,86027,100,9,205,6,0,2,0,222,9,211,0,2,0.04054054054054054,0.9234234234234234,0.02702702702702703,0.0,0.009009009009009009,0.0,0.04054054054054054,0.9504504504504504,0.0,0.009009009009009009,J. Gustavo Rivera RECAP,0.9504504504504504
86028,86028,100,10,166,3,0,3,1,183,11,169,0,3,0.0546448087431694,0.907103825136612,0.01639344262295082,0.0,0.01639344262295082,0.00546448087431694,0.060109289617486336,0.9234972677595629,0.0,0.01639344262295082,J. Gustavo Rivera RECAP,0.9234972677595629
86029,86029,100,3,155,2,0,1,2,163,5,157,0,1,0.018404907975460124,0.950920245398773,0.012269938650306749,0.0,0.006134969325153374,0.012269938650306749,0.03067484662576687,0.9631901840490797,0.0,0.006134969325153374,J. Gustavo Rivera RECAP,0.9631901840490797
86030,86030,100,11,221,1,0,3,1,237,12,222,0,3,0.046413502109704644,0.9324894514767933,0.004219409282700422,0.0,0.012658227848101266,0.004219409282700422,0.05063291139240506,0.9367088607594937,0.0,0.012658227848101266,J. Gustavo Rivera RECAP,0.9367088607594937
86031,86031,100,9,171,1,0,1,0,182,9,172,0,1,0.04945054945054945,0.9395604395604396,0.005494505494505495,0.0,0.005494505494505495,0.0,0.04945054945054945,0.945054945054945,0.0,0.005494505494505495,J. Gustavo Rivera RECAP,0.945054945054945
86032,86032,100,5,144,5,1,1,0,156,5,149,1,1,0.03205128205128205,0.9230769230769231,0.03205128205128205,0.00641025641025641,0.00641025641025641,0.0,0.03205128205128205,0.9551282051282052,0.00641025641025641,0.00641025641025641,J. Gustavo Rivera RECAP,0.9551282051282052
86033,86033,100,5,233,1,0,1,1,241,6,234,0,1,0.02074688796680498,0.966804979253112,0.004149377593360996,0.0,0.004149377593360996,0.004149377593360996,0.024896265560165973,0.970954356846473,0.0,0.004149377593360996,J. Gustavo Rivera RECAP,0.970954356846473
86034,86034,100,2,164,4,1,1,1,173,3,168,1,1,0.011560693641618497,0.9479768786127167,0.023121387283236993,0.005780346820809248,0.005780346820809248,0.005780346820809248,0.017341040462427744,0.9710982658959537,0.005780346820809248,0.005780346820809248,J. Gustavo Rivera RECAP,0.9710982658959537
86035,86035,100,4,188,2,0,2,1,197,5,190,0,2,0.02030456852791878,0.9543147208121827,0.01015228426395939,0.0,0.01015228426395939,0.005076142131979695,0.025380710659898477,0.9644670050761421,0.0,0.01015228426395939,J. Gustavo Rivera RECAP,0.9644670050761421
86036,86036,100,2,190,12,0,2,0,206,2,202,0,2,0.009708737864077669,0.9223300970873787,0.05825242718446602,0.0,0.009708737864077669,0.0,0.009708737864077669,0.9805825242718447,0.0,0.009708737864077669,J. Gustavo Rivera RECAP,0.9805825242718447
86037,86037,100,8,122,4,0,1,3,138,11,126,0,1,0.057971014492753624,0.8840579710144928,0.028985507246376812,0.0,0.007246376811594203,0.021739130434782608,0.07971014492753623,0.9130434782608695,0.0,0.007246376811594203,J. Gustavo Rivera RECAP,0.9130434782608695
86038,86038,100,3,62,4,0,0,1,70,4,66,0,0,0.04285714285714286,0.8857142857142857,0.05714285714285714,0.0,0.0,0.014285714285714285,0.05714285714285714,0.9428571428571428,0.0,0.0,J. Gustavo Rivera RECAP,0.9428571428571428
86039,86039,100,1,91,1,0,2,2,97,3,92,0,2,0.010309278350515464,0.9381443298969072,0.010309278350515464,0.0,0.020618556701030927,0.020618556701030927,0.030927835051546393,0.9484536082474226,0.0,0.020618556701030927,J. Gustavo Rivera RECAP,0.9484536082474226
86040,86040,100,4,146,6,0,0,0,156,4,152,0,0,0.02564102564102564,0.9358974358974359,0.038461538461538464,0.0,0.0,0.0,0.02564102564102564,0.9743589743589743,0.0,0.0,J. Gustavo Rivera RECAP,0.9743589743589743
86041,86041,100,0,90,1,0,2,0,93,0,91,0,2,0.0,0.967741935483871,0.010752688172043012,0.0,0.021505376344086023,0.0,0.0,0.978494623655914,0.0,0.021505376344086023,J. Gustavo Rivera RECAP,0.978494623655914
86042,86042,100,0,0,0,0,0,0,0,0,0,0,0,0,0,0,0,0,0,0,0,0,0,n/a,0
86043,86043,100,0,16,0,0,0,0,16,0,16,0,0,0.0,1.0,0.0,0.0,0.0,0.0,0.0,1.0,0.0,0.0,J. Gustavo Rivera RECAP,1.0
86044,86044,100,2,36,1,0,1,0,40,2,37,0,1,0.05,0.9,0.025,0.0,0.025,0.0,0.05,0.925,0.0,0.025,J. Gustavo Rivera RECAP,0.925
86045,86045,100,7,104,4,0,3,1,119,8,108,0,3,0.058823529411764705,0.8739495798319328,0.03361344537815126,0.0,0.025210084033613446,0.008403361344537815,0.06722689075630252,0.907563025210084,0.0,0.025210084033613446,J. Gustavo Rivera RECAP,0.907563025210084
86046,86046,100,0,80,2,0,0,2,84,2,82,0,0,0.0,0.9523809523809523,0.023809523809523808,0.0,0.0,0.023809523809523808,0.023809523809523808,0.9761904761904762,0.0,0.0,J. Gustavo Rivera RECAP,0.9761904761904762
86047,86047,100,2,208,4,0,1,1,216,3,212,0,1,0.009259259259259259,0.9629629629629629,0.018518518518518517,0.0,0.004629629629629629,0.004629629629629629,0.013888888888888888,0.9814814814814815,0.0,0.004629629629629629,J. Gustavo Rivera RECAP,0.9814814814814815
86048,86048,100,2,105,3,0,1,0,111,2,108,0,1,0.018018018018018018,0.9459459459459459,0.02702702702702703,0.0,0.009009009009009009,0.0,0.018018018018018018,0.972972972972973,0.0,0.009009009009009009,J. Gustavo Rivera RECAP,0.972972972972973
86049,86049,100,4,144,3,0,1,0,152,4,147,0,1,0.02631578947368421,0.9473684210526315,0.019736842105263157,0.0,0.006578947368421052,0.0,0.02631578947368421,0.9671052631578947,0.0,0.006578947368421052,J. Gustavo Rivera RECAP,0.9671052631578947
86050,86050,100,13,186,4,0,2,1,206,14,190,0,2,0.06310679611650485,0.9029126213592233,0.019417475728155338,0.0,0.009708737864077669,0.0048543689320388345,0.06796116504854369,0.9223300970873787,0.0,0.009708737864077669,J. Gustavo Rivera RECAP,0.9223300970873787
86051,86051,100,0,91,1,0,3,0,95,0,92,0,3,0.0,0.9578947368421052,0.010526315789473684,0.0,0.031578947368421054,0.0,0.0,0.968421052631579,0.0,0.031578947368421054,J. Gustavo Rivera RECAP,0.968421052631579
86052,86052,100,8,155,4,0,0,3,170,11,159,0,0,0.047058823529411764,0.9117647058823529,0.023529411764705882,0.0,0.0,0.01764705882352941,0.06470588235294118,0.9352941176470588,0.0,0.0,J. Gustavo Rivera RECAP,0.9352941176470588
86053,86053,100,5,108,3,0,3,0,119,5,111,0,3,0.04201680672268908,0.907563025210084,0.025210084033613446,0.0,0.025210084033613446,0.0,0.04201680672268908,0.9327731092436975,0.0,0.025210084033613446,J. Gustavo Rivera RECAP,0.9327731092436975
86054,86054,100,5,158,5,1,2,0,171,5,163,1,2,0.029239766081871343,0.9239766081871345,0.029239766081871343,0.005847953216374269,0.011695906432748537,0.0,0.029239766081871343,0.9532163742690059,0.005847953216374269,0.011695906432748537,J. Gustavo Rivera RECAP,0.9532163742690059
86055,86055,100,8,172,5,0,2,2,189,10,177,0,2,0.042328042328042326,0.91005291005291,0.026455026455026454,0.0,0.010582010582010581,0.010582010582010581,0.05291005291005291,0.9365079365079365,0.0,0.010582010582010581,J. Gustavo Rivera RECAP,0.9365079365079365
86056,86056,100,2,90,3,0,2,0,97,2,93,0,2,0.020618556701030927,0.9278350515463918,0.030927835051546393,0.0,0.020618556701030927,0.0,0.020618556701030927,0.9587628865979382,0.0,0.020618556701030927,J. Gustavo Rivera RECAP,0.9587628865979382
86057,86057,100,2,106,4,0,2,0,114,2,110,0,2,0.017543859649122806,0.9298245614035088,0.03508771929824561,0.0,0.017543859649122806,0.0,0.017543859649122806,0.9649122807017544,0.0,0.017543859649122806,J. Gustavo Rivera RECAP,0.9649122807017544
86058,86058,100,0,44,1,0,1,0,46,0,45,0,1,0.0,0.9565217391304348,0.021739130434782608,0.0,0.021739130434782608,0.0,0.0,0.9782608695652174,0.0,0.021739130434782608,J. Gustavo Rivera RECAP,0.9782608695652174
86059,86059,100,1,56,0,0,1,0,58,1,56,0,1,0.017241379310344827,0.9655172413793104,0.0,0.0,0.017241379310344827,0.0,0.017241379310344827,0.9655172413793104,0.0,0.017241379310344827,J. Gustavo Rivera RECAP,0.9655172413793104
86060,86060,100,0,9,0,0,0,0,9,0,9,0,0,0.0,1.0,0.0,0.0,0.0,0.0,0.0,1.0,0.0,0.0,J. Gustavo Rivera RECAP,1.0
87001,87001,100,0,19,0,0,1,0,20,0,19,0,1,0.0,0.95,0.0,0.0,0.05,0.0,0.0,0.95,0.0,0.05,J. Gustavo Rivera RECAP,0.95
87003,87003,100,5,59,2,0,2,0,68,5,61,0,2,0.07352941176470588,0.8676470588235294,0.029411764705882353,0.0,0.029411764705882353,0.0,0.07352941176470588,0.8970588235294118,0.0,0.029411764705882353,J. Gustavo Rivera RECAP,0.8970588235294118
87015,87015,100,3,41,1,0,0,0,45,3,42,0,0,0.06666666666666667,0.9111111111111111,0.022222222222222223,0.0,0.0,0.0,0.06666666666666667,0.9333333333333333,0.0,0.0,J. Gustavo Rivera RECAP,0.9333333333333333
87016,87016,100,1,39,1,0,0,0,41,1,40,0,0,0.024390243902439025,0.9512195121951219,0.024390243902439025,0.0,0.0,0.0,0.024390243902439025,0.975609756097561,0.0,0.0,J. Gustavo Rivera RECAP,0.975609756097561
87017,87017,100,0,35,1,0,2,0,38,0,36,0,2,0.0,0.9210526315789473,0.02631578947368421,0.0,0.05263157894736842,0.0,0.0,0.9473684210526315,0.0,0.05263157894736842,J. Gustavo Rivera RECAP,0.9473684210526315
87018,87018,100,6,80,4,0,2,1,93,7,84,0,2,0.06451612903225806,0.8602150537634409,0.043010752688172046,0.0,0.021505376344086023,0.010752688172043012,0.07526881720430108,0.9032258064516129,0.0,0.021505376344086023,J. Gustavo Rivera RECAP,0.9032258064516129
87019,87019,100,6,73,4,0,2,1,86,7,77,0,2,0.06976744186046512,0.8488372093023255,0.046511627906976744,0.0,0.023255813953488372,0.011627906976744186,0.08139534883720931,0.8953488372093024,0.0,0.023255813953488372,J. Gustavo Rivera RECAP,0.8953488372093024
87020,87020,100,8,85,5,0,2,4,104,12,90,0,2,0.07692307692307693,0.8173076923076923,0.04807692307692308,0.0,0.019230769230769232,0.038461538461538464,0.11538461538461539,0.8653846153846154,0.0,0.019230769230769232,J. Gustavo Rivera RECAP,0.8653846153846154
87021,87021,100,1,28,1,0,0,0,30,1,29,0,0,0.03333333333333333,0.9333333333333333,0.03333333333333333,0.0,0.0,0.0,0.03333333333333333,0.9666666666666667,0.0,0.0,J. Gustavo Rivera RECAP,0.9666666666666667
87023,87023,100,9,141,3,0,3,4,160,13,144,0,3,0.05625,0.88125,0.01875,0.0,0.01875,0.025,0.08125,0.9,0.0,0.01875,J. Gustavo Rivera RECAP,0.9
87024,87024,100,6,66,0,0,0,1,73,7,66,0,0,0.0821917808219178,0.9041095890410958,0.0,0.0,0.0,0.0136986301369863,0.0958904109589041,0.9041095890410958,0.0,0.0,J. Gustavo Rivera RECAP,0.9041095890410958
87025,87025,100,1,51,3,0,0,1,56,2,54,0,0,0.017857142857142856,0.9107142857142857,0.05357142857142857,0.0,0.0,0.017857142857142856,0.03571428571428571,0.9642857142857143,0.0,0.0,J. Gustavo Rivera RECAP,0.9642857142857143
87043,87043,100,0,0,0,0,0,0,0,0,0,0,0,0,0,0,0,0,0,0,0,0,0,n/a,0
87090,87090,100,0,0,0,0,0,0,0,0,0,0,0,0,0,0,0,0,0,0,0,0,0,n/a,0
87091,87091,100,0,0,0,0,0,0,0,0,0,0,0,0,0,0,0,0,0,0,0,0,0,n/a,0
