ED,Reported As,Reporting,Brenda Rivera (Democratic),Harry Hertzberg (Conservative),Scattered,Harry Hertzberg (Republican),Total Votes,Brenda Rivera RECAP,Harry Hertzberg RECAP,Scattered RECAP,p_Brenda Rivera (Democratic),p_Harry Hertzberg (Conservative),p_Scattered,p_Harry Hertzberg (Republican),p_Brenda Rivera RECAP,p_Harry Hertzberg RECAP,p_Scattered RECAP,winner,winner_p
77001,77001,100,32,1,0,4,37,32,5,0,0.8648648648648649,0.02702702702702703,0.0,0.10810810810810811,0.8648648648648649,0.13513513513513514,0.0,Brenda Rivera RECAP,0.8648648648648649
77002,77002,100,60,0,0,3,63,60,3,0,0.9523809523809523,0.0,0.0,0.047619047619047616,0.9523809523809523,0.047619047619047616,0.0,Brenda Rivera RECAP,0.9523809523809523
77003,77003,100,215,2,0,6,223,215,8,0,0.9641255605381166,0.008968609865470852,0.0,0.026905829596412557,0.9641255605381166,0.03587443946188341,0.0,Brenda Rivera RECAP,0.9641255605381166
77004,77004,100,62,0,0,5,67,62,5,0,0.9253731343283582,0.0,0.0,0.07462686567164178,0.9253731343283582,0.07462686567164178,0.0,Brenda Rivera RECAP,0.9253731343283582
77005,77005,100,210,1,0,3,214,210,4,0,0.9813084112149533,0.004672897196261682,0.0,0.014018691588785047,0.9813084112149533,0.018691588785046728,0.0,Brenda Rivera RECAP,0.9813084112149533
77006,77006,100,177,1,0,3,181,177,4,0,0.9779005524861878,0.0055248618784530384,0.0,0.016574585635359115,0.9779005524861878,0.022099447513812154,0.0,Brenda Rivera RECAP,0.9779005524861878
77007,77007,100,254,1,0,9,264,254,10,0,0.9621212121212122,0.003787878787878788,0.0,0.03409090909090909,0.9621212121212122,0.03787878787878788,0.0,Brenda Rivera RECAP,0.9621212121212122
77008,77008,100,222,0,0,5,227,222,5,0,0.9779735682819384,0.0,0.0,0.022026431718061675,0.9779735682819384,0.022026431718061675,0.0,Brenda Rivera RECAP,0.9779735682819384
77009,77009,100,217,3,0,8,228,217,11,0,0.9517543859649122,0.013157894736842105,0.0,0.03508771929824561,0.9517543859649122,0.04824561403508772,0.0,Brenda Rivera RECAP,0.9517543859649122
77010,77010,100,311,0,0,17,328,311,17,0,0.948170731707317,0.0,0.0,0.051829268292682924,0.948170731707317,0.051829268292682924,0.0,Brenda Rivera RECAP,0.948170731707317
77011,77011,100,206,1,1,5,213,206,6,1,0.9671361502347418,0.004694835680751174,0.004694835680751174,0.023474178403755867,0.9671361502347418,0.028169014084507043,0.004694835680751174,Brenda Rivera RECAP,0.9671361502347418
77012,77012,100,162,0,0,2,164,162,2,0,0.9878048780487805,0.0,0.0,0.012195121951219513,0.9878048780487805,0.012195121951219513,0.0,Brenda Rivera RECAP,0.9878048780487805
77013,77013,100,123,1,0,2,126,123,3,0,0.9761904761904762,0.007936507936507936,0.0,0.015873015873015872,0.9761904761904762,0.023809523809523808,0.0,Brenda Rivera RECAP,0.9761904761904762
77014,77014,100,202,4,1,14,221,202,18,1,0.9140271493212669,0.01809954751131222,0.004524886877828055,0.06334841628959276,0.9140271493212669,0.08144796380090498,0.004524886877828055,Brenda Rivera RECAP,0.9140271493212669
77015,77015,100,160,1,0,5,166,160,6,0,0.963855421686747,0.006024096385542169,0.0,0.030120481927710843,0.963855421686747,0.03614457831325301,0.0,Brenda Rivera RECAP,0.963855421686747
77016,77016,100,229,1,0,5,235,229,6,0,0.9744680851063829,0.00425531914893617,0.0,0.02127659574468085,0.9744680851063829,0.02553191489361702,0.0,Brenda Rivera RECAP,0.9744680851063829
77017,77017,100,56,0,0,1,57,56,1,0,0.9824561403508771,0.0,0.0,0.017543859649122806,0.9824561403508771,0.017543859649122806,0.0,Brenda Rivera RECAP,0.9824561403508771
77018,77018,100,129,1,0,4,134,129,5,0,0.9626865671641791,0.007462686567164179,0.0,0.029850746268656716,0.9626865671641791,0.03731343283582089,0.0,Brenda Rivera RECAP,0.9626865671641791
77019,77019,100,128,1,0,3,132,128,4,0,0.9696969696969697,0.007575757575757576,0.0,0.022727272727272728,0.9696969696969697,0.030303030303030304,0.0,Brenda Rivera RECAP,0.9696969696969697
77020,77020,100,151,2,0,5,158,151,7,0,0.9556962025316456,0.012658227848101266,0.0,0.03164556962025317,0.9556962025316456,0.04430379746835443,0.0,Brenda Rivera RECAP,0.9556962025316456
77021,77021,100,198,0,0,5,203,198,5,0,0.9753694581280788,0.0,0.0,0.024630541871921183,0.9753694581280788,0.024630541871921183,0.0,Brenda Rivera RECAP,0.9753694581280788
77022,77022,100,124,0,0,4,128,124,4,0,0.96875,0.0,0.0,0.03125,0.96875,0.03125,0.0,Brenda Rivera RECAP,0.96875
77023,77023,100,261,0,0,7,268,261,7,0,0.9738805970149254,0.0,0.0,0.026119402985074626,0.9738805970149254,0.026119402985074626,0.0,Brenda Rivera RECAP,0.9738805970149254
77024,77024,100,165,3,0,4,172,165,7,0,0.9593023255813954,0.01744186046511628,0.0,0.023255813953488372,0.9593023255813954,0.040697674418604654,0.0,Brenda Rivera RECAP,0.9593023255813954
77025,77025,100,235,4,0,5,244,235,9,0,0.9631147540983607,0.01639344262295082,0.0,0.020491803278688523,0.9631147540983607,0.036885245901639344,0.0,Brenda Rivera RECAP,0.9631147540983607
77026,77026,100,88,0,1,4,93,88,4,1,0.946236559139785,0.0,0.010752688172043012,0.043010752688172046,0.946236559139785,0.043010752688172046,0.010752688172043012,Brenda Rivera RECAP,0.946236559139785
77027,77027,100,147,1,0,6,154,147,7,0,0.9545454545454546,0.006493506493506494,0.0,0.03896103896103896,0.9545454545454546,0.045454545454545456,0.0,Brenda Rivera RECAP,0.9545454545454546
77028,77028,100,147,0,0,7,154,147,7,0,0.9545454545454546,0.0,0.0,0.045454545454545456,0.9545454545454546,0.045454545454545456,0.0,Brenda Rivera RECAP,0.9545454545454546
77029,77029,100,54,2,0,0,56,54,2,0,0.9642857142857143,0.03571428571428571,0.0,0.0,0.9642857142857143,0.03571428571428571,0.0,Brenda Rivera RECAP,0.9642857142857143
77030,77030,100,118,1,0,2,121,118,3,0,0.9752066115702479,0.008264462809917356,0.0,0.01652892561983471,0.9752066115702479,0.024793388429752067,0.0,Brenda Rivera RECAP,0.9752066115702479
77031,77031,100,23,0,0,1,24,23,1,0,0.9583333333333334,0.0,0.0,0.041666666666666664,0.9583333333333334,0.041666666666666664,0.0,Brenda Rivera RECAP,0.9583333333333334
77032,77032,100,21,0,0,1,22,21,1,0,0.9545454545454546,0.0,0.0,0.045454545454545456,0.9545454545454546,0.045454545454545456,0.0,Brenda Rivera RECAP,0.9545454545454546
77033,77033,100,29,0,0,0,29,29,0,0,1.0,0.0,0.0,0.0,1.0,0.0,0.0,Brenda Rivera RECAP,1.0
77034,77034,100,147,6,0,4,157,147,10,0,0.9363057324840764,0.03821656050955414,0.0,0.025477707006369428,0.9363057324840764,0.06369426751592357,0.0,Brenda Rivera RECAP,0.9363057324840764
77035,77035,100,134,0,0,3,137,134,3,0,0.9781021897810219,0.0,0.0,0.021897810218978103,0.9781021897810219,0.021897810218978103,0.0,Brenda Rivera RECAP,0.9781021897810219
77036,77036,100,89,6,0,3,98,89,9,0,0.9081632653061225,0.061224489795918366,0.0,0.030612244897959183,0.9081632653061225,0.09183673469387756,0.0,Brenda Rivera RECAP,0.9081632653061225
77037,77037,100,191,1,0,3,195,191,4,0,0.9794871794871794,0.005128205128205128,0.0,0.015384615384615385,0.9794871794871794,0.020512820512820513,0.0,Brenda Rivera RECAP,0.9794871794871794
77038,77038,100,81,1,0,2,84,81,3,0,0.9642857142857143,0.011904761904761904,0.0,0.023809523809523808,0.9642857142857143,0.03571428571428571,0.0,Brenda Rivera RECAP,0.9642857142857143
77039,77039,100,159,1,0,8,168,159,9,0,0.9464285714285714,0.005952380952380952,0.0,0.047619047619047616,0.9464285714285714,0.05357142857142857,0.0,Brenda Rivera RECAP,0.9464285714285714
77040,77040,100,104,0,0,4,108,104,4,0,0.9629629629629629,0.0,0.0,0.037037037037037035,0.9629629629629629,0.037037037037037035,0.0,Brenda Rivera RECAP,0.9629629629629629
77041,77041,100,115,0,0,4,119,115,4,0,0.9663865546218487,0.0,0.0,0.03361344537815126,0.9663865546218487,0.03361344537815126,0.0,Brenda Rivera RECAP,0.9663865546218487
77042,77042,100,110,0,0,4,114,110,4,0,0.9649122807017544,0.0,0.0,0.03508771929824561,0.9649122807017544,0.03508771929824561,0.0,Brenda Rivera RECAP,0.9649122807017544
77043,77043,100,199,0,0,5,204,199,5,0,0.9754901960784313,0.0,0.0,0.024509803921568627,0.9754901960784313,0.024509803921568627,0.0,Brenda Rivera RECAP,0.9754901960784313
77044,77044,100,139,0,2,3,144,139,3,2,0.9652777777777778,0.0,0.013888888888888888,0.020833333333333332,0.9652777777777778,0.020833333333333332,0.013888888888888888,Brenda Rivera RECAP,0.9652777777777778
77045,77045,100,245,1,1,7,254,245,8,1,0.9645669291338582,0.003937007874015748,0.003937007874015748,0.027559055118110236,0.9645669291338582,0.031496062992125984,0.003937007874015748,Brenda Rivera RECAP,0.9645669291338582
77046,77046,100,149,2,0,8,159,149,10,0,0.9371069182389937,0.012578616352201259,0.0,0.050314465408805034,0.9371069182389937,0.06289308176100629,0.0,Brenda Rivera RECAP,0.9371069182389937
77047,77047,100,209,1,0,9,219,209,10,0,0.954337899543379,0.0045662100456621,0.0,0.0410958904109589,0.954337899543379,0.045662100456621,0.0,Brenda Rivera RECAP,0.954337899543379
77048,77048,100,178,2,1,3,184,178,5,1,0.967391304347826,0.010869565217391304,0.005434782608695652,0.016304347826086956,0.967391304347826,0.02717391304347826,0.005434782608695652,Brenda Rivera RECAP,0.967391304347826
77049,77049,100,68,1,0,4,73,68,5,0,0.9315068493150684,0.0136986301369863,0.0,0.0547945205479452,0.9315068493150684,0.0684931506849315,0.0,Brenda Rivera RECAP,0.9315068493150684
77050,77050,100,151,2,0,6,159,151,8,0,0.949685534591195,0.012578616352201259,0.0,0.03773584905660377,0.949685534591195,0.050314465408805034,0.0,Brenda Rivera RECAP,0.949685534591195
77051,77051,100,158,2,0,5,165,158,7,0,0.9575757575757575,0.012121212121212121,0.0,0.030303030303030304,0.9575757575757575,0.04242424242424243,0.0,Brenda Rivera RECAP,0.9575757575757575
77052,77052,100,17,0,0,0,17,17,0,0,1.0,0.0,0.0,0.0,1.0,0.0,0.0,Brenda Rivera RECAP,1.0
77053,77053,100,157,0,0,6,163,157,6,0,0.9631901840490797,0.0,0.0,0.03680981595092025,0.9631901840490797,0.03680981595092025,0.0,Brenda Rivera RECAP,0.9631901840490797
77054,77054,100,140,0,0,3,143,140,3,0,0.9790209790209791,0.0,0.0,0.02097902097902098,0.9790209790209791,0.02097902097902098,0.0,Brenda Rivera RECAP,0.9790209790209791
77055,77055,100,143,2,0,3,148,143,5,0,0.9662162162162162,0.013513513513513514,0.0,0.02027027027027027,0.9662162162162162,0.033783783783783786,0.0,Brenda Rivera RECAP,0.9662162162162162
77056,77056,100,166,0,0,4,170,166,4,0,0.9764705882352941,0.0,0.0,0.023529411764705882,0.9764705882352941,0.023529411764705882,0.0,Brenda Rivera RECAP,0.9764705882352941
77057,77057,100,151,1,0,3,155,151,4,0,0.9741935483870968,0.0064516129032258064,0.0,0.01935483870967742,0.9741935483870968,0.025806451612903226,0.0,Brenda Rivera RECAP,0.9741935483870968
77058,77058,100,246,3,0,12,261,246,15,0,0.9425287356321839,0.011494252873563218,0.0,0.04597701149425287,0.9425287356321839,0.05747126436781609,0.0,Brenda Rivera RECAP,0.9425287356321839
77059,77059,100,111,0,0,3,114,111,3,0,0.9736842105263158,0.0,0.0,0.02631578947368421,0.9736842105263158,0.02631578947368421,0.0,Brenda Rivera RECAP,0.9736842105263158
77060,77060,100,303,1,1,7,312,303,8,1,0.9711538461538461,0.003205128205128205,0.003205128205128205,0.022435897435897436,0.9711538461538461,0.02564102564102564,0.003205128205128205,Brenda Rivera RECAP,0.9711538461538461
77061,77061,100,56,1,0,3,60,56,4,0,0.9333333333333333,0.016666666666666666,0.0,0.05,0.9333333333333333,0.06666666666666667,0.0,Brenda Rivera RECAP,0.9333333333333333
77062,77062,100,129,4,0,4,137,129,8,0,0.9416058394160584,0.029197080291970802,0.0,0.029197080291970802,0.9416058394160584,0.058394160583941604,0.0,Brenda Rivera RECAP,0.9416058394160584
77063,77063,100,140,1,0,4,145,140,5,0,0.9655172413793104,0.006896551724137931,0.0,0.027586206896551724,0.9655172413793104,0.034482758620689655,0.0,Brenda Rivera RECAP,0.9655172413793104
77064,77064,100,39,0,0,0,39,39,0,0,1.0,0.0,0.0,0.0,1.0,0.0,0.0,Brenda Rivera RECAP,1.0
77065,77065,100,172,3,0,5,180,172,8,0,0.9555555555555556,0.016666666666666666,0.0,0.027777777777777776,0.9555555555555556,0.044444444444444446,0.0,Brenda Rivera RECAP,0.9555555555555556
77066,77066,100,21,0,0,2,23,21,2,0,0.9130434782608695,0.0,0.0,0.08695652173913043,0.9130434782608695,0.08695652173913043,0.0,Brenda Rivera RECAP,0.9130434782608695
77067,77067,100,80,0,1,3,84,80,3,1,0.9523809523809523,0.0,0.011904761904761904,0.03571428571428571,0.9523809523809523,0.03571428571428571,0.011904761904761904,Brenda Rivera RECAP,0.9523809523809523
77068,77068,100,83,1,0,5,89,83,6,0,0.9325842696629213,0.011235955056179775,0.0,0.056179775280898875,0.9325842696629213,0.06741573033707865,0.0,Brenda Rivera RECAP,0.9325842696629213
77069,77069,100,0,0,0,0,0,0,0,0,0,0,0,0,0,0,0,n/a,0
77070,77070,100,0,0,0,0,0,0,0,0,0,0,0,0,0,0,0,n/a,0
78001,78001,100,146,1,0,4,151,146,5,0,0.9668874172185431,0.006622516556291391,0.0,0.026490066225165563,0.9668874172185431,0.033112582781456956,0.0,Brenda Rivera RECAP,0.9668874172185431
78002,78002,100,199,0,0,6,205,199,6,0,0.9707317073170731,0.0,0.0,0.02926829268292683,0.9707317073170731,0.02926829268292683,0.0,Brenda Rivera RECAP,0.9707317073170731
78003,78003,100,71,4,0,10,85,71,14,0,0.8352941176470589,0.047058823529411764,0.0,0.11764705882352941,0.8352941176470589,0.16470588235294117,0.0,Brenda Rivera RECAP,0.8352941176470589
78004,78004,100,166,6,0,13,185,166,19,0,0.8972972972972973,0.032432432432432434,0.0,0.07027027027027027,0.8972972972972973,0.10270270270270271,0.0,Brenda Rivera RECAP,0.8972972972972973
78005,78005,100,144,5,0,11,160,144,16,0,0.9,0.03125,0.0,0.06875,0.9,0.1,0.0,Brenda Rivera RECAP,0.9
78006,78006,100,191,6,0,19,216,191,25,0,0.8842592592592593,0.027777777777777776,0.0,0.08796296296296297,0.8842592592592593,0.11574074074074074,0.0,Brenda Rivera RECAP,0.8842592592592593
78007,78007,100,36,0,0,7,43,36,7,0,0.8372093023255814,0.0,0.0,0.16279069767441862,0.8372093023255814,0.16279069767441862,0.0,Brenda Rivera RECAP,0.8372093023255814
78008,78008,100,75,4,0,13,92,75,17,0,0.8152173913043478,0.043478260869565216,0.0,0.14130434782608695,0.8152173913043478,0.18478260869565216,0.0,Brenda Rivera RECAP,0.8152173913043478
78009,78009,100,184,2,1,9,196,184,11,1,0.9387755102040817,0.01020408163265306,0.00510204081632653,0.04591836734693878,0.9387755102040817,0.05612244897959184,0.00510204081632653,Brenda Rivera RECAP,0.9387755102040817
78010,78010,100,152,2,0,4,158,152,6,0,0.9620253164556962,0.012658227848101266,0.0,0.02531645569620253,0.9620253164556962,0.0379746835443038,0.0,Brenda Rivera RECAP,0.9620253164556962
78011,78011,100,130,0,0,7,137,130,7,0,0.948905109489051,0.0,0.0,0.051094890510948905,0.948905109489051,0.051094890510948905,0.0,Brenda Rivera RECAP,0.948905109489051
78012,78012,100,183,3,0,4,190,183,7,0,0.9631578947368421,0.015789473684210527,0.0,0.021052631578947368,0.9631578947368421,0.03684210526315789,0.0,Brenda Rivera RECAP,0.9631578947368421
78013,78013,100,161,2,0,10,173,161,12,0,0.930635838150289,0.011560693641618497,0.0,0.057803468208092484,0.930635838150289,0.06936416184971098,0.0,Brenda Rivera RECAP,0.930635838150289
78014,78014,100,117,0,0,7,124,117,7,0,0.9435483870967742,0.0,0.0,0.056451612903225805,0.9435483870967742,0.056451612903225805,0.0,Brenda Rivera RECAP,0.9435483870967742
78015,78015,100,57,2,0,4,63,57,6,0,0.9047619047619048,0.031746031746031744,0.0,0.06349206349206349,0.9047619047619048,0.09523809523809523,0.0,Brenda Rivera RECAP,0.9047619047619048
78016,78016,100,110,3,0,2,115,110,5,0,0.9565217391304348,0.02608695652173913,0.0,0.017391304347826087,0.9565217391304348,0.043478260869565216,0.0,Brenda Rivera RECAP,0.9565217391304348
78017,78017,100,49,2,0,2,53,49,4,0,0.9245283018867925,0.03773584905660377,0.0,0.03773584905660377,0.9245283018867925,0.07547169811320754,0.0,Brenda Rivera RECAP,0.9245283018867925
78018,78018,100,105,1,0,6,112,105,7,0,0.9375,0.008928571428571428,0.0,0.05357142857142857,0.9375,0.0625,0.0,Brenda Rivera RECAP,0.9375
78019,78019,100,97,0,0,7,104,97,7,0,0.9326923076923077,0.0,0.0,0.0673076923076923,0.9326923076923077,0.0673076923076923,0.0,Brenda Rivera RECAP,0.9326923076923077
78020,78020,100,113,2,0,4,119,113,6,0,0.9495798319327731,0.01680672268907563,0.0,0.03361344537815126,0.9495798319327731,0.05042016806722689,0.0,Brenda Rivera RECAP,0.9495798319327731
78021,78021,100,138,1,0,7,146,138,8,0,0.9452054794520548,0.00684931506849315,0.0,0.04794520547945205,0.9452054794520548,0.0547945205479452,0.0,Brenda Rivera RECAP,0.9452054794520548
78022,78022,100,133,4,0,5,142,133,9,0,0.9366197183098591,0.028169014084507043,0.0,0.035211267605633804,0.9366197183098591,0.06338028169014084,0.0,Brenda Rivera RECAP,0.9366197183098591
78023,78023,100,150,1,0,7,158,150,8,0,0.9493670886075949,0.006329113924050633,0.0,0.04430379746835443,0.9493670886075949,0.05063291139240506,0.0,Brenda Rivera RECAP,0.9493670886075949
78024,78024,100,138,1,0,12,151,138,13,0,0.9139072847682119,0.006622516556291391,0.0,0.07947019867549669,0.9139072847682119,0.08609271523178808,0.0,Brenda Rivera RECAP,0.9139072847682119
78025,78025,100,96,0,0,5,101,96,5,0,0.9504950495049505,0.0,0.0,0.04950495049504951,0.9504950495049505,0.04950495049504951,0.0,Brenda Rivera RECAP,0.9504950495049505
78026,78026,100,100,2,1,2,105,100,4,1,0.9523809523809523,0.01904761904761905,0.009523809523809525,0.01904761904761905,0.9523809523809523,0.0380952380952381,0.009523809523809525,Brenda Rivera RECAP,0.9523809523809523
78027,78027,100,85,0,0,6,91,85,6,0,0.9340659340659341,0.0,0.0,0.06593406593406594,0.9340659340659341,0.06593406593406594,0.0,Brenda Rivera RECAP,0.9340659340659341
78028,78028,100,175,4,0,17,196,175,21,0,0.8928571428571429,0.02040816326530612,0.0,0.08673469387755102,0.8928571428571429,0.10714285714285714,0.0,Brenda Rivera RECAP,0.8928571428571429
78029,78029,100,122,0,0,5,127,122,5,0,0.9606299212598425,0.0,0.0,0.03937007874015748,0.9606299212598425,0.03937007874015748,0.0,Brenda Rivera RECAP,0.9606299212598425
78030,78030,100,127,8,2,20,157,127,28,2,0.8089171974522293,0.050955414012738856,0.012738853503184714,0.12738853503184713,0.8089171974522293,0.17834394904458598,0.012738853503184714,Brenda Rivera RECAP,0.8089171974522293
78031,78031,100,115,4,0,9,128,115,13,0,0.8984375,0.03125,0.0,0.0703125,0.8984375,0.1015625,0.0,Brenda Rivera RECAP,0.8984375
78032,78032,100,201,9,0,22,232,201,31,0,0.8663793103448276,0.03879310344827586,0.0,0.09482758620689655,0.8663793103448276,0.1336206896551724,0.0,Brenda Rivera RECAP,0.8663793103448276
78033,78033,100,164,8,1,18,191,164,26,1,0.8586387434554974,0.041884816753926704,0.005235602094240838,0.09424083769633508,0.8586387434554974,0.13612565445026178,0.005235602094240838,Brenda Rivera RECAP,0.8586387434554974
78034,78034,100,93,4,0,10,107,93,14,0,0.8691588785046729,0.037383177570093455,0.0,0.09345794392523364,0.8691588785046729,0.1308411214953271,0.0,Brenda Rivera RECAP,0.8691588785046729
78035,78035,100,39,3,0,8,50,39,11,0,0.78,0.06,0.0,0.16,0.78,0.22,0.0,Brenda Rivera RECAP,0.78
78036,78036,100,106,2,0,5,113,106,7,0,0.9380530973451328,0.017699115044247787,0.0,0.04424778761061947,0.9380530973451328,0.061946902654867256,0.0,Brenda Rivera RECAP,0.9380530973451328
78037,78037,100,25,0,0,2,27,25,2,0,0.9259259259259259,0.0,0.0,0.07407407407407407,0.9259259259259259,0.07407407407407407,0.0,Brenda Rivera RECAP,0.9259259259259259
78038,78038,100,128,8,0,15,151,128,23,0,0.847682119205298,0.052980132450331126,0.0,0.09933774834437085,0.847682119205298,0.152317880794702,0.0,Brenda Rivera RECAP,0.847682119205298
78039,78039,100,42,2,0,13,57,42,15,0,0.7368421052631579,0.03508771929824561,0.0,0.22807017543859648,0.7368421052631579,0.2631578947368421,0.0,Brenda Rivera RECAP,0.7368421052631579
78040,78040,100,241,11,0,41,293,241,52,0,0.8225255972696246,0.03754266211604096,0.0,0.13993174061433447,0.8225255972696246,0.17747440273037543,0.0,Brenda Rivera RECAP,0.8225255972696246
78041,78041,100,124,7,0,37,168,124,44,0,0.7380952380952381,0.041666666666666664,0.0,0.22023809523809523,0.7380952380952381,0.2619047619047619,0.0,Brenda Rivera RECAP,0.7380952380952381
78042,78042,100,0,0,0,0,0,0,0,0,0,0,0,0,0,0,0,n/a,0
78043,78043,100,63,1,0,1,65,63,2,0,0.9692307692307692,0.015384615384615385,0.0,0.015384615384615385,0.9692307692307692,0.03076923076923077,0.0,Brenda Rivera RECAP,0.9692307692307692
78044,78044,100,180,2,0,14,196,180,16,0,0.9183673469387755,0.01020408163265306,0.0,0.07142857142857142,0.9183673469387755,0.08163265306122448,0.0,Brenda Rivera RECAP,0.9183673469387755
78045,78045,100,172,1,0,11,184,172,12,0,0.9347826086956522,0.005434782608695652,0.0,0.059782608695652176,0.9347826086956522,0.06521739130434782,0.0,Brenda Rivera RECAP,0.9347826086956522
78046,78046,100,154,2,0,10,166,154,12,0,0.927710843373494,0.012048192771084338,0.0,0.060240963855421686,0.927710843373494,0.07228915662650602,0.0,Brenda Rivera RECAP,0.927710843373494
78047,78047,100,106,0,0,5,111,106,5,0,0.954954954954955,0.0,0.0,0.04504504504504504,0.954954954954955,0.04504504504504504,0.0,Brenda Rivera RECAP,0.954954954954955
78048,78048,100,263,4,0,23,290,263,27,0,0.906896551724138,0.013793103448275862,0.0,0.07931034482758621,0.906896551724138,0.09310344827586207,0.0,Brenda Rivera RECAP,0.906896551724138
78049,78049,100,175,0,0,11,186,175,11,0,0.9408602150537635,0.0,0.0,0.05913978494623656,0.9408602150537635,0.05913978494623656,0.0,Brenda Rivera RECAP,0.9408602150537635
78050,78050,100,177,4,0,11,192,177,15,0,0.921875,0.020833333333333332,0.0,0.057291666666666664,0.921875,0.078125,0.0,Brenda Rivera RECAP,0.921875
78051,78051,100,192,3,0,5,200,192,8,0,0.96,0.015,0.0,0.025,0.96,0.04,0.0,Brenda Rivera RECAP,0.96
78052,78052,100,144,1,0,12,157,144,13,0,0.9171974522292994,0.006369426751592357,0.0,0.07643312101910828,0.9171974522292994,0.08280254777070063,0.0,Brenda Rivera RECAP,0.9171974522292994
78053,78053,100,96,1,0,6,103,96,7,0,0.9320388349514563,0.009708737864077669,0.0,0.05825242718446602,0.9320388349514563,0.06796116504854369,0.0,Brenda Rivera RECAP,0.9320388349514563
78054,78054,100,89,0,0,4,93,89,4,0,0.956989247311828,0.0,0.0,0.043010752688172046,0.956989247311828,0.043010752688172046,0.0,Brenda Rivera RECAP,0.956989247311828
78055,78055,100,0,0,0,0,0,0,0,0,0,0,0,0,0,0,0,n/a,0
78056,78056,100,0,0,0,0,0,0,0,0,0,0,0,0,0,0,0,n/a,0
78057,78057,100,0,0,0,0,0,0,0,0,0,0,0,0,0,0,0,n/a,0
78058,78037,100,0,0,0,0,0,0,0,0,0,0,0,0,0,0,0,n/a,0
79001,79001,100,118,0,0,2,120,118,2,0,0.9833333333333333,0.0,0.0,0.016666666666666666,0.9833333333333333,0.016666666666666666,0.0,Brenda Rivera RECAP,0.9833333333333333
79002,79002,100,131,2,0,5,138,131,7,0,0.9492753623188406,0.014492753623188406,0.0,0.036231884057971016,0.9492753623188406,0.050724637681159424,0.0,Brenda Rivera RECAP,0.9492753623188406
79003,79003,100,149,1,0,1,151,149,2,0,0.9867549668874173,0.006622516556291391,0.0,0.006622516556291391,0.9867549668874173,0.013245033112582781,0.0,Brenda Rivera RECAP,0.9867549668874173
79004,79004,100,101,0,0,5,106,101,5,0,0.9528301886792453,0.0,0.0,0.04716981132075472,0.9528301886792453,0.04716981132075472,0.0,Brenda Rivera RECAP,0.9528301886792453
79005,79005,100,143,1,0,1,145,143,2,0,0.9862068965517241,0.006896551724137931,0.0,0.006896551724137931,0.9862068965517241,0.013793103448275862,0.0,Brenda Rivera RECAP,0.9862068965517241
79006,79006,100,85,1,0,2,88,85,3,0,0.9659090909090909,0.011363636363636364,0.0,0.022727272727272728,0.9659090909090909,0.03409090909090909,0.0,Brenda Rivera RECAP,0.9659090909090909
79007,79007,100,106,0,0,0,106,106,0,0,1.0,0.0,0.0,0.0,1.0,0.0,0.0,Brenda Rivera RECAP,1.0
79008,79008,100,73,0,0,6,79,73,6,0,0.9240506329113924,0.0,0.0,0.0759493670886076,0.9240506329113924,0.0759493670886076,0.0,Brenda Rivera RECAP,0.9240506329113924
79009,79009,100,67,1,0,2,70,67,3,0,0.9571428571428572,0.014285714285714285,0.0,0.02857142857142857,0.9571428571428572,0.04285714285714286,0.0,Brenda Rivera RECAP,0.9571428571428572
79010,79010,100,176,3,0,6,185,176,9,0,0.9513513513513514,0.016216216216216217,0.0,0.032432432432432434,0.9513513513513514,0.04864864864864865,0.0,Brenda Rivera RECAP,0.9513513513513514
79011,79011,100,46,2,0,1,49,46,3,0,0.9387755102040817,0.04081632653061224,0.0,0.02040816326530612,0.9387755102040817,0.061224489795918366,0.0,Brenda Rivera RECAP,0.9387755102040817
79012,79012,100,36,0,0,1,37,36,1,0,0.972972972972973,0.0,0.0,0.02702702702702703,0.972972972972973,0.02702702702702703,0.0,Brenda Rivera RECAP,0.972972972972973
79013,79013,100,153,0,1,11,165,153,11,1,0.9272727272727272,0.0,0.006060606060606061,0.06666666666666667,0.9272727272727272,0.06666666666666667,0.006060606060606061,Brenda Rivera RECAP,0.9272727272727272
79014,79014,100,36,0,0,1,37,36,1,0,0.972972972972973,0.0,0.0,0.02702702702702703,0.972972972972973,0.02702702702702703,0.0,Brenda Rivera RECAP,0.972972972972973
79015,79015,100,95,0,1,3,99,95,3,1,0.9595959595959596,0.0,0.010101010101010102,0.030303030303030304,0.9595959595959596,0.030303030303030304,0.010101010101010102,Brenda Rivera RECAP,0.9595959595959596
79016,79016,100,107,0,0,2,109,107,2,0,0.981651376146789,0.0,0.0,0.01834862385321101,0.981651376146789,0.01834862385321101,0.0,Brenda Rivera RECAP,0.981651376146789
79017,79017,100,132,1,0,6,139,132,7,0,0.9496402877697842,0.007194244604316547,0.0,0.04316546762589928,0.9496402877697842,0.050359712230215826,0.0,Brenda Rivera RECAP,0.9496402877697842
79018,79018,100,29,0,0,5,34,29,5,0,0.8529411764705882,0.0,0.0,0.14705882352941177,0.8529411764705882,0.14705882352941177,0.0,Brenda Rivera RECAP,0.8529411764705882
79019,79019,100,101,1,0,6,108,101,7,0,0.9351851851851852,0.009259259259259259,0.0,0.05555555555555555,0.9351851851851852,0.06481481481481481,0.0,Brenda Rivera RECAP,0.9351851851851852
79020,79020,100,85,0,0,7,92,85,7,0,0.9239130434782609,0.0,0.0,0.07608695652173914,0.9239130434782609,0.07608695652173914,0.0,Brenda Rivera RECAP,0.9239130434782609
79021,79021,100,77,2,0,6,85,77,8,0,0.9058823529411765,0.023529411764705882,0.0,0.07058823529411765,0.9058823529411765,0.09411764705882353,0.0,Brenda Rivera RECAP,0.9058823529411765
79022,79022,100,71,0,0,3,74,71,3,0,0.9594594594594594,0.0,0.0,0.04054054054054054,0.9594594594594594,0.04054054054054054,0.0,Brenda Rivera RECAP,0.9594594594594594
79023,79023,100,110,2,0,2,114,110,4,0,0.9649122807017544,0.017543859649122806,0.0,0.017543859649122806,0.9649122807017544,0.03508771929824561,0.0,Brenda Rivera RECAP,0.9649122807017544
79024,79024,100,128,3,0,8,139,128,11,0,0.920863309352518,0.02158273381294964,0.0,0.05755395683453238,0.920863309352518,0.07913669064748201,0.0,Brenda Rivera RECAP,0.920863309352518
79025,79025,100,138,0,0,2,140,138,2,0,0.9857142857142858,0.0,0.0,0.014285714285714285,0.9857142857142858,0.014285714285714285,0.0,Brenda Rivera RECAP,0.9857142857142858
79026,79026,100,104,0,0,6,110,104,6,0,0.9454545454545454,0.0,0.0,0.05454545454545454,0.9454545454545454,0.05454545454545454,0.0,Brenda Rivera RECAP,0.9454545454545454
79027,79027,100,164,1,0,0,165,164,1,0,0.9939393939393939,0.006060606060606061,0.0,0.0,0.9939393939393939,0.006060606060606061,0.0,Brenda Rivera RECAP,0.9939393939393939
79028,79028,100,157,1,0,5,163,157,6,0,0.9631901840490797,0.006134969325153374,0.0,0.03067484662576687,0.9631901840490797,0.03680981595092025,0.0,Brenda Rivera RECAP,0.9631901840490797
79074,79074,100,19,0,0,0,19,19,0,0,1.0,0.0,0.0,0.0,1.0,0.0,0.0,Brenda Rivera RECAP,1.0
79029,79074,100,0,0,0,0,0,0,0,0,0,0,0,0,0,0,0,n/a,0
79030,79030,100,228,2,0,7,237,228,9,0,0.9620253164556962,0.008438818565400843,0.0,0.029535864978902954,0.9620253164556962,0.0379746835443038,0.0,Brenda Rivera RECAP,0.9620253164556962
79031,79031,100,167,0,0,5,172,167,5,0,0.9709302325581395,0.0,0.0,0.029069767441860465,0.9709302325581395,0.029069767441860465,0.0,Brenda Rivera RECAP,0.9709302325581395
79032,79032,100,125,1,0,9,135,125,10,0,0.9259259259259259,0.007407407407407408,0.0,0.06666666666666667,0.9259259259259259,0.07407407407407407,0.0,Brenda Rivera RECAP,0.9259259259259259
79033,79033,100,95,0,0,2,97,95,2,0,0.979381443298969,0.0,0.0,0.020618556701030927,0.979381443298969,0.020618556701030927,0.0,Brenda Rivera RECAP,0.979381443298969
79034,79034,100,245,2,0,10,257,245,12,0,0.953307392996109,0.007782101167315175,0.0,0.038910505836575876,0.953307392996109,0.04669260700389105,0.0,Brenda Rivera RECAP,0.953307392996109
79035,79035,100,141,1,0,8,150,141,9,0,0.94,0.006666666666666667,0.0,0.05333333333333334,0.94,0.06,0.0,Brenda Rivera RECAP,0.94
79036,79036,100,145,0,0,1,146,145,1,0,0.9931506849315068,0.0,0.0,0.00684931506849315,0.9931506849315068,0.00684931506849315,0.0,Brenda Rivera RECAP,0.9931506849315068
79037,79037,100,208,3,0,8,219,208,11,0,0.9497716894977168,0.0136986301369863,0.0,0.0365296803652968,0.9497716894977168,0.0502283105022831,0.0,Brenda Rivera RECAP,0.9497716894977168
79038,79038,100,137,2,0,4,143,137,6,0,0.958041958041958,0.013986013986013986,0.0,0.027972027972027972,0.958041958041958,0.04195804195804196,0.0,Brenda Rivera RECAP,0.958041958041958
79039,79039,100,148,2,0,4,154,148,6,0,0.961038961038961,0.012987012987012988,0.0,0.025974025974025976,0.961038961038961,0.03896103896103896,0.0,Brenda Rivera RECAP,0.961038961038961
79040,79040,100,167,2,0,2,171,167,4,0,0.9766081871345029,0.011695906432748537,0.0,0.011695906432748537,0.9766081871345029,0.023391812865497075,0.0,Brenda Rivera RECAP,0.9766081871345029
79041,79041,100,112,1,1,4,118,112,5,1,0.9491525423728814,0.00847457627118644,0.00847457627118644,0.03389830508474576,0.9491525423728814,0.0423728813559322,0.00847457627118644,Brenda Rivera RECAP,0.9491525423728814
79042,79042,100,126,2,0,4,132,126,6,0,0.9545454545454546,0.015151515151515152,0.0,0.030303030303030304,0.9545454545454546,0.045454545454545456,0.0,Brenda Rivera RECAP,0.9545454545454546
79043,79043,100,99,2,0,9,110,99,11,0,0.9,0.01818181818181818,0.0,0.08181818181818182,0.9,0.1,0.0,Brenda Rivera RECAP,0.9
79044,79044,100,107,4,0,8,119,107,12,0,0.8991596638655462,0.03361344537815126,0.0,0.06722689075630252,0.8991596638655462,0.10084033613445378,0.0,Brenda Rivera RECAP,0.8991596638655462
79045,79045,100,101,0,0,2,103,101,2,0,0.9805825242718447,0.0,0.0,0.019417475728155338,0.9805825242718447,0.019417475728155338,0.0,Brenda Rivera RECAP,0.9805825242718447
79046,79046,100,153,0,0,1,154,153,1,0,0.9935064935064936,0.0,0.0,0.006493506493506494,0.9935064935064936,0.006493506493506494,0.0,Brenda Rivera RECAP,0.9935064935064936
79047,79047,100,170,0,0,2,172,170,2,0,0.9883720930232558,0.0,0.0,0.011627906976744186,0.9883720930232558,0.011627906976744186,0.0,Brenda Rivera RECAP,0.9883720930232558
79048,79048,100,131,1,0,3,135,131,4,0,0.9703703703703703,0.007407407407407408,0.0,0.022222222222222223,0.9703703703703703,0.02962962962962963,0.0,Brenda Rivera RECAP,0.9703703703703703
79049,79049,100,86,0,0,1,87,86,1,0,0.9885057471264368,0.0,0.0,0.011494252873563218,0.9885057471264368,0.011494252873563218,0.0,Brenda Rivera RECAP,0.9885057471264368
79050,79050,100,113,0,0,2,115,113,2,0,0.9826086956521739,0.0,0.0,0.017391304347826087,0.9826086956521739,0.017391304347826087,0.0,Brenda Rivera RECAP,0.9826086956521739
79051,79051,100,191,1,0,4,196,191,5,0,0.9744897959183674,0.00510204081632653,0.0,0.02040816326530612,0.9744897959183674,0.025510204081632654,0.0,Brenda Rivera RECAP,0.9744897959183674
79052,79052,100,174,2,0,6,182,174,8,0,0.9560439560439561,0.01098901098901099,0.0,0.03296703296703297,0.9560439560439561,0.04395604395604396,0.0,Brenda Rivera RECAP,0.9560439560439561
79053,79053,100,135,1,0,2,138,135,3,0,0.9782608695652174,0.007246376811594203,0.0,0.014492753623188406,0.9782608695652174,0.021739130434782608,0.0,Brenda Rivera RECAP,0.9782608695652174
79054,79054,100,86,0,0,3,89,86,3,0,0.9662921348314607,0.0,0.0,0.033707865168539325,0.9662921348314607,0.033707865168539325,0.0,Brenda Rivera RECAP,0.9662921348314607
79055,79055,100,38,0,0,2,40,38,2,0,0.95,0.0,0.0,0.05,0.95,0.05,0.0,Brenda Rivera RECAP,0.95
79056,79056,100,191,1,0,8,200,191,9,0,0.955,0.005,0.0,0.04,0.955,0.045,0.0,Brenda Rivera RECAP,0.955
79057,79057,100,226,4,0,9,239,226,13,0,0.9456066945606695,0.016736401673640166,0.0,0.03765690376569038,0.9456066945606695,0.05439330543933055,0.0,Brenda Rivera RECAP,0.9456066945606695
79058,79058,100,115,0,0,6,121,115,6,0,0.9504132231404959,0.0,0.0,0.049586776859504134,0.9504132231404959,0.049586776859504134,0.0,Brenda Rivera RECAP,0.9504132231404959
79059,79059,100,118,1,0,5,124,118,6,0,0.9516129032258065,0.008064516129032258,0.0,0.04032258064516129,0.9516129032258065,0.04838709677419355,0.0,Brenda Rivera RECAP,0.9516129032258065
79060,79060,100,78,0,0,0,78,78,0,0,1.0,0.0,0.0,0.0,1.0,0.0,0.0,Brenda Rivera RECAP,1.0
79061,79061,100,181,1,0,4,186,181,5,0,0.9731182795698925,0.005376344086021506,0.0,0.021505376344086023,0.9731182795698925,0.026881720430107527,0.0,Brenda Rivera RECAP,0.9731182795698925
79062,79062,100,111,1,0,5,117,111,6,0,0.9487179487179487,0.008547008547008548,0.0,0.042735042735042736,0.9487179487179487,0.05128205128205128,0.0,Brenda Rivera RECAP,0.9487179487179487
79063,79063,100,128,3,0,8,139,128,11,0,0.920863309352518,0.02158273381294964,0.0,0.05755395683453238,0.920863309352518,0.07913669064748201,0.0,Brenda Rivera RECAP,0.920863309352518
79064,79064,100,69,1,0,0,70,69,1,0,0.9857142857142858,0.014285714285714285,0.0,0.0,0.9857142857142858,0.014285714285714285,0.0,Brenda Rivera RECAP,0.9857142857142858
79065,79065,100,116,0,0,1,117,116,1,0,0.9914529914529915,0.0,0.0,0.008547008547008548,0.9914529914529915,0.008547008547008548,0.0,Brenda Rivera RECAP,0.9914529914529915
79066,79066,100,133,0,0,4,137,133,4,0,0.9708029197080292,0.0,0.0,0.029197080291970802,0.9708029197080292,0.029197080291970802,0.0,Brenda Rivera RECAP,0.9708029197080292
79067,79067,100,85,0,0,2,87,85,2,0,0.9770114942528736,0.0,0.0,0.022988505747126436,0.9770114942528736,0.022988505747126436,0.0,Brenda Rivera RECAP,0.9770114942528736
79068,79068,100,284,4,0,5,293,284,9,0,0.9692832764505119,0.013651877133105802,0.0,0.017064846416382253,0.9692832764505119,0.030716723549488054,0.0,Brenda Rivera RECAP,0.9692832764505119
79069,79069,100,338,6,0,8,352,338,14,0,0.9602272727272727,0.017045454545454544,0.0,0.022727272727272728,0.9602272727272727,0.03977272727272727,0.0,Brenda Rivera RECAP,0.9602272727272727
79070,79070,100,306,4,0,3,313,306,7,0,0.9776357827476039,0.012779552715654952,0.0,0.009584664536741214,0.9776357827476039,0.022364217252396165,0.0,Brenda Rivera RECAP,0.9776357827476039
79071,79071,100,132,0,0,4,136,132,4,0,0.9705882352941176,0.0,0.0,0.029411764705882353,0.9705882352941176,0.029411764705882353,0.0,Brenda Rivera RECAP,0.9705882352941176
79072,79072,100,139,1,0,5,145,139,6,0,0.9586206896551724,0.006896551724137931,0.0,0.034482758620689655,0.9586206896551724,0.041379310344827586,0.0,Brenda Rivera RECAP,0.9586206896551724
79073,79073,100,102,1,0,3,106,102,4,0,0.9622641509433962,0.009433962264150943,0.0,0.02830188679245283,0.9622641509433962,0.03773584905660377,0.0,Brenda Rivera RECAP,0.9622641509433962
79075,79075,100,159,1,0,9,169,159,10,0,0.9408284023668639,0.005917159763313609,0.0,0.05325443786982249,0.9408284023668639,0.05917159763313609,0.0,Brenda Rivera RECAP,0.9408284023668639
79076,79076,100,120,0,0,8,128,120,8,0,0.9375,0.0,0.0,0.0625,0.9375,0.0625,0.0,Brenda Rivera RECAP,0.9375
79077,79077,100,66,0,0,3,69,66,3,0,0.9565217391304348,0.0,0.0,0.043478260869565216,0.9565217391304348,0.043478260869565216,0.0,Brenda Rivera RECAP,0.9565217391304348
79078,79078,100,39,0,0,0,39,39,0,0,1.0,0.0,0.0,0.0,1.0,0.0,0.0,Brenda Rivera RECAP,1.0
79079,79079,100,180,3,0,4,187,180,7,0,0.9625668449197861,0.016042780748663103,0.0,0.0213903743315508,0.9625668449197861,0.0374331550802139,0.0,Brenda Rivera RECAP,0.9625668449197861
79080,79080,100,0,0,0,0,0,0,0,0,0,0,0,0,0,0,0,n/a,0
79081,79081,100,0,0,0,0,0,0,0,0,0,0,0,0,0,0,0,n/a,0
80001,80001,100,72,8,0,15,95,72,23,0,0.7578947368421053,0.08421052631578947,0.0,0.15789473684210525,0.7578947368421053,0.24210526315789474,0.0,Brenda Rivera RECAP,0.7578947368421053
80002,80002,100,41,1,0,11,53,41,12,0,0.7735849056603774,0.018867924528301886,0.0,0.20754716981132076,0.7735849056603774,0.22641509433962265,0.0,Brenda Rivera RECAP,0.7735849056603774
80003,80003,100,60,22,1,110,193,60,132,1,0.31088082901554404,0.11398963730569948,0.0051813471502590676,0.5699481865284974,0.31088082901554404,0.6839378238341969,0.0051813471502590676,Harry Hertzberg RECAP,0.6839378238341969
80004,80004,100,60,6,1,49,116,60,55,1,0.5172413793103449,0.05172413793103448,0.008620689655172414,0.4224137931034483,0.5172413793103449,0.47413793103448276,0.008620689655172414,Brenda Rivera RECAP,0.5172413793103449
80005,80005,100,37,11,1,22,71,37,33,1,0.5211267605633803,0.15492957746478872,0.014084507042253521,0.30985915492957744,0.5211267605633803,0.4647887323943662,0.014084507042253521,Brenda Rivera RECAP,0.5211267605633803
80006,80006,100,64,13,0,31,108,64,44,0,0.5925925925925926,0.12037037037037036,0.0,0.28703703703703703,0.5925925925925926,0.4074074074074074,0.0,Brenda Rivera RECAP,0.5925925925925926
80007,80007,100,79,7,0,27,113,79,34,0,0.6991150442477876,0.061946902654867256,0.0,0.23893805309734514,0.6991150442477876,0.3008849557522124,0.0,Brenda Rivera RECAP,0.6991150442477876
80008,80008,100,68,2,0,18,88,68,20,0,0.7727272727272727,0.022727272727272728,0.0,0.20454545454545456,0.7727272727272727,0.22727272727272727,0.0,Brenda Rivera RECAP,0.7727272727272727
80009,80009,100,55,4,0,8,67,55,12,0,0.8208955223880597,0.05970149253731343,0.0,0.11940298507462686,0.8208955223880597,0.1791044776119403,0.0,Brenda Rivera RECAP,0.8208955223880597
80010,80010,100,86,8,0,23,117,86,31,0,0.7350427350427351,0.06837606837606838,0.0,0.19658119658119658,0.7350427350427351,0.26495726495726496,0.0,Brenda Rivera RECAP,0.7350427350427351
80011,80011,100,27,1,0,7,35,27,8,0,0.7714285714285715,0.02857142857142857,0.0,0.2,0.7714285714285715,0.22857142857142856,0.0,Brenda Rivera RECAP,0.7714285714285715
80012,80012,100,38,2,1,7,48,38,9,1,0.7916666666666666,0.041666666666666664,0.020833333333333332,0.14583333333333334,0.7916666666666666,0.1875,0.020833333333333332,Brenda Rivera RECAP,0.7916666666666666
80013,80013,100,71,3,0,21,95,71,24,0,0.7473684210526316,0.031578947368421054,0.0,0.22105263157894736,0.7473684210526316,0.25263157894736843,0.0,Brenda Rivera RECAP,0.7473684210526316
80014,80014,100,156,1,0,6,163,156,7,0,0.9570552147239264,0.006134969325153374,0.0,0.03680981595092025,0.9570552147239264,0.04294478527607362,0.0,Brenda Rivera RECAP,0.9570552147239264
80015,80015,100,59,1,1,8,69,59,9,1,0.855072463768116,0.014492753623188406,0.014492753623188406,0.11594202898550725,0.855072463768116,0.13043478260869565,0.014492753623188406,Brenda Rivera RECAP,0.855072463768116
80016,80016,100,205,9,0,28,242,205,37,0,0.8471074380165289,0.0371900826446281,0.0,0.11570247933884298,0.8471074380165289,0.15289256198347106,0.0,Brenda Rivera RECAP,0.8471074380165289
80017,80017,100,161,1,0,12,174,161,13,0,0.9252873563218391,0.005747126436781609,0.0,0.06896551724137931,0.9252873563218391,0.07471264367816093,0.0,Brenda Rivera RECAP,0.9252873563218391
80018,80018,100,84,9,0,47,140,84,56,0,0.6,0.06428571428571428,0.0,0.3357142857142857,0.6,0.4,0.0,Brenda Rivera RECAP,0.6
80019,80019,100,41,8,2,49,100,41,57,2,0.41,0.08,0.02,0.49,0.41,0.57,0.02,Harry Hertzberg RECAP,0.57
80020,80020,100,109,7,0,47,163,109,54,0,0.6687116564417178,0.04294478527607362,0.0,0.2883435582822086,0.6687116564417178,0.3312883435582822,0.0,Brenda Rivera RECAP,0.6687116564417178
80021,80021,100,192,5,0,17,214,192,22,0,0.897196261682243,0.02336448598130841,0.0,0.0794392523364486,0.897196261682243,0.102803738317757,0.0,Brenda Rivera RECAP,0.897196261682243
80022,80022,100,109,3,0,14,126,109,17,0,0.8650793650793651,0.023809523809523808,0.0,0.1111111111111111,0.8650793650793651,0.1349206349206349,0.0,Brenda Rivera RECAP,0.8650793650793651
80023,80023,100,169,3,0,34,206,169,37,0,0.8203883495145631,0.014563106796116505,0.0,0.1650485436893204,0.8203883495145631,0.1796116504854369,0.0,Brenda Rivera RECAP,0.8203883495145631
80024,80024,100,224,5,0,31,260,224,36,0,0.8615384615384616,0.019230769230769232,0.0,0.11923076923076924,0.8615384615384616,0.13846153846153847,0.0,Brenda Rivera RECAP,0.8615384615384616
80025,80025,100,114,3,0,29,146,114,32,0,0.7808219178082192,0.02054794520547945,0.0,0.19863013698630136,0.7808219178082192,0.2191780821917808,0.0,Brenda Rivera RECAP,0.7808219178082192
80026,80026,100,124,4,0,15,143,124,19,0,0.8671328671328671,0.027972027972027972,0.0,0.1048951048951049,0.8671328671328671,0.13286713286713286,0.0,Brenda Rivera RECAP,0.8671328671328671
80027,80027,100,80,7,1,33,121,80,40,1,0.6611570247933884,0.05785123966942149,0.008264462809917356,0.2727272727272727,0.6611570247933884,0.3305785123966942,0.008264462809917356,Brenda Rivera RECAP,0.6611570247933884
80028,80028,100,96,6,1,29,132,96,35,1,0.7272727272727273,0.045454545454545456,0.007575757575757576,0.2196969696969697,0.7272727272727273,0.26515151515151514,0.007575757575757576,Brenda Rivera RECAP,0.7272727272727273
80029,80029,100,31,6,0,23,60,31,29,0,0.5166666666666667,0.1,0.0,0.38333333333333336,0.5166666666666667,0.48333333333333334,0.0,Brenda Rivera RECAP,0.5166666666666667
80030,80030,100,100,12,0,55,167,100,67,0,0.5988023952095808,0.0718562874251497,0.0,0.32934131736526945,0.5988023952095808,0.40119760479041916,0.0,Brenda Rivera RECAP,0.5988023952095808
80031,80031,100,139,7,0,78,224,139,85,0,0.6205357142857143,0.03125,0.0,0.3482142857142857,0.6205357142857143,0.3794642857142857,0.0,Brenda Rivera RECAP,0.6205357142857143
80032,80032,100,67,12,0,47,126,67,59,0,0.5317460317460317,0.09523809523809523,0.0,0.373015873015873,0.5317460317460317,0.46825396825396826,0.0,Brenda Rivera RECAP,0.5317460317460317
80033,80033,100,62,10,0,31,103,62,41,0,0.6019417475728155,0.0970873786407767,0.0,0.30097087378640774,0.6019417475728155,0.39805825242718446,0.0,Brenda Rivera RECAP,0.6019417475728155
80034,80034,100,89,13,0,38,140,89,51,0,0.6357142857142857,0.09285714285714286,0.0,0.2714285714285714,0.6357142857142857,0.36428571428571427,0.0,Brenda Rivera RECAP,0.6357142857142857
80035,80035,100,66,18,0,31,115,66,49,0,0.5739130434782609,0.1565217391304348,0.0,0.26956521739130435,0.5739130434782609,0.4260869565217391,0.0,Brenda Rivera RECAP,0.5739130434782609
80036,80036,100,127,7,0,39,173,127,46,0,0.7341040462427746,0.04046242774566474,0.0,0.2254335260115607,0.7341040462427746,0.2658959537572254,0.0,Brenda Rivera RECAP,0.7341040462427746
80037,80037,100,47,9,0,26,82,47,35,0,0.573170731707317,0.10975609756097561,0.0,0.3170731707317073,0.573170731707317,0.4268292682926829,0.0,Brenda Rivera RECAP,0.573170731707317
80038,80038,100,74,6,0,20,100,74,26,0,0.74,0.06,0.0,0.2,0.74,0.26,0.0,Brenda Rivera RECAP,0.74
80039,80039,100,104,8,0,25,137,104,33,0,0.7591240875912408,0.058394160583941604,0.0,0.18248175182481752,0.7591240875912408,0.24087591240875914,0.0,Brenda Rivera RECAP,0.7591240875912408
80040,80040,100,116,1,0,10,127,116,11,0,0.9133858267716536,0.007874015748031496,0.0,0.07874015748031496,0.9133858267716536,0.08661417322834646,0.0,Brenda Rivera RECAP,0.9133858267716536
80041,80041,100,203,3,0,24,230,203,27,0,0.8826086956521739,0.013043478260869565,0.0,0.10434782608695652,0.8826086956521739,0.11739130434782609,0.0,Brenda Rivera RECAP,0.8826086956521739
80042,80042,100,142,2,0,5,149,142,7,0,0.9530201342281879,0.013422818791946308,0.0,0.03355704697986577,0.9530201342281879,0.04697986577181208,0.0,Brenda Rivera RECAP,0.9530201342281879
80043,80043,100,103,2,0,12,117,103,14,0,0.8803418803418803,0.017094017094017096,0.0,0.10256410256410256,0.8803418803418803,0.11965811965811966,0.0,Brenda Rivera RECAP,0.8803418803418803
80044,80044,100,74,3,0,15,92,74,18,0,0.8043478260869565,0.03260869565217391,0.0,0.16304347826086957,0.8043478260869565,0.1956521739130435,0.0,Brenda Rivera RECAP,0.8043478260869565
80045,80045,100,170,4,0,19,193,170,23,0,0.8808290155440415,0.02072538860103627,0.0,0.09844559585492228,0.8808290155440415,0.11917098445595854,0.0,Brenda Rivera RECAP,0.8808290155440415
80046,80046,100,63,2,0,3,68,63,5,0,0.9264705882352942,0.029411764705882353,0.0,0.04411764705882353,0.9264705882352942,0.07352941176470588,0.0,Brenda Rivera RECAP,0.9264705882352942
80047,80047,100,107,4,0,26,137,107,30,0,0.781021897810219,0.029197080291970802,0.0,0.1897810218978102,0.781021897810219,0.21897810218978103,0.0,Brenda Rivera RECAP,0.781021897810219
80048,80048,100,95,0,0,20,115,95,20,0,0.8260869565217391,0.0,0.0,0.17391304347826086,0.8260869565217391,0.17391304347826086,0.0,Brenda Rivera RECAP,0.8260869565217391
80049,80049,100,31,1,0,2,34,31,3,0,0.9117647058823529,0.029411764705882353,0.0,0.058823529411764705,0.9117647058823529,0.08823529411764706,0.0,Brenda Rivera RECAP,0.9117647058823529
80050,80050,100,156,4,0,15,175,156,19,0,0.8914285714285715,0.022857142857142857,0.0,0.08571428571428572,0.8914285714285715,0.10857142857142857,0.0,Brenda Rivera RECAP,0.8914285714285715
80051,80051,100,50,3,0,9,62,50,12,0,0.8064516129032258,0.04838709677419355,0.0,0.14516129032258066,0.8064516129032258,0.1935483870967742,0.0,Brenda Rivera RECAP,0.8064516129032258
80052,80052,100,76,2,0,4,82,76,6,0,0.926829268292683,0.024390243902439025,0.0,0.04878048780487805,0.926829268292683,0.07317073170731707,0.0,Brenda Rivera RECAP,0.926829268292683
80053,80053,100,65,1,0,3,69,65,4,0,0.9420289855072463,0.014492753623188406,0.0,0.043478260869565216,0.9420289855072463,0.057971014492753624,0.0,Brenda Rivera RECAP,0.9420289855072463
80054,80054,100,21,0,0,4,25,21,4,0,0.84,0.0,0.0,0.16,0.84,0.16,0.0,Brenda Rivera RECAP,0.84
80055,80055,100,161,0,2,19,182,161,19,2,0.8846153846153846,0.0,0.01098901098901099,0.1043956043956044,0.8846153846153846,0.1043956043956044,0.01098901098901099,Brenda Rivera RECAP,0.8846153846153846
80056,80056,100,281,2,0,3,286,281,5,0,0.9825174825174825,0.006993006993006993,0.0,0.01048951048951049,0.9825174825174825,0.017482517482517484,0.0,Brenda Rivera RECAP,0.9825174825174825
80057,80057,100,62,1,0,7,70,62,8,0,0.8857142857142857,0.014285714285714285,0.0,0.1,0.8857142857142857,0.11428571428571428,0.0,Brenda Rivera RECAP,0.8857142857142857
80058,80058,100,113,1,0,17,131,113,18,0,0.8625954198473282,0.007633587786259542,0.0,0.1297709923664122,0.8625954198473282,0.13740458015267176,0.0,Brenda Rivera RECAP,0.8625954198473282
80059,80059,100,33,0,0,3,36,33,3,0,0.9166666666666666,0.0,0.0,0.08333333333333333,0.9166666666666666,0.08333333333333333,0.0,Brenda Rivera RECAP,0.9166666666666666
80060,80060,100,202,0,0,11,213,202,11,0,0.9483568075117371,0.0,0.0,0.051643192488262914,0.9483568075117371,0.051643192488262914,0.0,Brenda Rivera RECAP,0.9483568075117371
80061,80061,100,31,0,0,2,33,31,2,0,0.9393939393939394,0.0,0.0,0.06060606060606061,0.9393939393939394,0.06060606060606061,0.0,Brenda Rivera RECAP,0.9393939393939394
80062,80062,100,142,5,0,14,161,142,19,0,0.8819875776397516,0.031055900621118012,0.0,0.08695652173913043,0.8819875776397516,0.11801242236024845,0.0,Brenda Rivera RECAP,0.8819875776397516
80063,80063,100,174,2,0,8,184,174,10,0,0.9456521739130435,0.010869565217391304,0.0,0.043478260869565216,0.9456521739130435,0.05434782608695652,0.0,Brenda Rivera RECAP,0.9456521739130435
80064,80064,100,124,4,0,13,141,124,17,0,0.8794326241134752,0.028368794326241134,0.0,0.09219858156028368,0.8794326241134752,0.12056737588652482,0.0,Brenda Rivera RECAP,0.8794326241134752
80065,80065,100,231,5,0,6,242,231,11,0,0.9545454545454546,0.02066115702479339,0.0,0.024793388429752067,0.9545454545454546,0.045454545454545456,0.0,Brenda Rivera RECAP,0.9545454545454546
80066,80066,100,73,8,0,48,129,73,56,0,0.5658914728682171,0.06201550387596899,0.0,0.37209302325581395,0.5658914728682171,0.43410852713178294,0.0,Brenda Rivera RECAP,0.5658914728682171
80067,80067,100,127,8,0,38,173,127,46,0,0.7341040462427746,0.046242774566473986,0.0,0.21965317919075145,0.7341040462427746,0.2658959537572254,0.0,Brenda Rivera RECAP,0.7341040462427746
80068,80068,100,105,8,0,29,142,105,37,0,0.7394366197183099,0.056338028169014086,0.0,0.20422535211267606,0.7394366197183099,0.2605633802816901,0.0,Brenda Rivera RECAP,0.7394366197183099
80069,80069,100,45,2,0,7,54,45,9,0,0.8333333333333334,0.037037037037037035,0.0,0.12962962962962962,0.8333333333333334,0.16666666666666666,0.0,Brenda Rivera RECAP,0.8333333333333334
80070,80070,100,122,2,0,14,138,122,16,0,0.8840579710144928,0.014492753623188406,0.0,0.10144927536231885,0.8840579710144928,0.11594202898550725,0.0,Brenda Rivera RECAP,0.8840579710144928
80071,80071,100,104,2,0,18,124,104,20,0,0.8387096774193549,0.016129032258064516,0.0,0.14516129032258066,0.8387096774193549,0.16129032258064516,0.0,Brenda Rivera RECAP,0.8387096774193549
80073,80073,100,97,1,0,10,108,97,11,0,0.8981481481481481,0.009259259259259259,0.0,0.09259259259259259,0.8981481481481481,0.10185185185185185,0.0,Brenda Rivera RECAP,0.8981481481481481
80072,80073,100,0,0,0,0,0,0,0,0,0,0,0,0,0,0,0,n/a,0
80074,80074,100,258,1,0,7,266,258,8,0,0.9699248120300752,0.0037593984962406013,0.0,0.02631578947368421,0.9699248120300752,0.03007518796992481,0.0,Brenda Rivera RECAP,0.9699248120300752
80075,80075,100,2,0,0,0,2,2,0,0,1.0,0.0,0.0,0.0,1.0,0.0,0.0,Brenda Rivera RECAP,1.0
80076,80076,100,120,6,0,23,149,120,29,0,0.8053691275167785,0.040268456375838924,0.0,0.15436241610738255,0.8053691275167785,0.19463087248322147,0.0,Brenda Rivera RECAP,0.8053691275167785
80077,80077,100,209,7,0,16,232,209,23,0,0.9008620689655172,0.03017241379310345,0.0,0.06896551724137931,0.9008620689655172,0.09913793103448276,0.0,Brenda Rivera RECAP,0.9008620689655172
80078,80078,100,162,5,0,21,188,162,26,0,0.8617021276595744,0.026595744680851064,0.0,0.11170212765957446,0.8617021276595744,0.13829787234042554,0.0,Brenda Rivera RECAP,0.8617021276595744
80079,80079,100,142,4,0,19,165,142,23,0,0.8606060606060606,0.024242424242424242,0.0,0.11515151515151516,0.8606060606060606,0.1393939393939394,0.0,Brenda Rivera RECAP,0.8606060606060606
80080,80080,100,124,2,0,9,135,124,11,0,0.9185185185185185,0.014814814814814815,0.0,0.06666666666666667,0.9185185185185185,0.08148148148148149,0.0,Brenda Rivera RECAP,0.9185185185185185
80081,80081,100,132,5,0,15,152,132,20,0,0.868421052631579,0.03289473684210526,0.0,0.09868421052631579,0.868421052631579,0.13157894736842105,0.0,Brenda Rivera RECAP,0.868421052631579
80082,80082,100,84,5,0,11,100,84,16,0,0.84,0.05,0.0,0.11,0.84,0.16,0.0,Brenda Rivera RECAP,0.84
80083,80083,100,198,2,0,25,225,198,27,0,0.88,0.008888888888888889,0.0,0.1111111111111111,0.88,0.12,0.0,Brenda Rivera RECAP,0.88
80084,80084,100,71,4,0,6,81,71,10,0,0.8765432098765432,0.04938271604938271,0.0,0.07407407407407407,0.8765432098765432,0.12345679012345678,0.0,Brenda Rivera RECAP,0.8765432098765432
80085,80085,100,158,3,0,19,180,158,22,0,0.8777777777777778,0.016666666666666666,0.0,0.10555555555555556,0.8777777777777778,0.12222222222222222,0.0,Brenda Rivera RECAP,0.8777777777777778
80086,80086,100,129,3,0,7,139,129,10,0,0.9280575539568345,0.02158273381294964,0.0,0.050359712230215826,0.9280575539568345,0.07194244604316546,0.0,Brenda Rivera RECAP,0.9280575539568345
80087,80087,100,63,3,0,2,68,63,5,0,0.9264705882352942,0.04411764705882353,0.0,0.029411764705882353,0.9264705882352942,0.07352941176470588,0.0,Brenda Rivera RECAP,0.9264705882352942
80088,80088,100,0,0,0,0,0,0,0,0,0,0,0,0,0,0,0,n/a,0
80089,80089,100,0,0,0,0,0,0,0,0,0,0,0,0,0,0,0,n/a,0
80090,80073,100,0,0,0,0,0,0,0,0,0,0,0,0,0,0,0,n/a,0
80091,80075,100,0,0,0,0,0,0,0,0,0,0,0,0,0,0,0,n/a,0
80092,80092,100,0,0,0,0,0,0,0,0,0,0,0,0,0,0,0,n/a,0
81001,81001,100,164,2,0,13,179,164,15,0,0.9162011173184358,0.0111731843575419,0.0,0.07262569832402235,0.9162011173184358,0.08379888268156424,0.0,Brenda Rivera RECAP,0.9162011173184358
81002,81002,100,148,1,0,19,168,148,20,0,0.8809523809523809,0.005952380952380952,0.0,0.1130952380952381,0.8809523809523809,0.11904761904761904,0.0,Brenda Rivera RECAP,0.8809523809523809
81003,81003,100,35,4,0,0,39,35,4,0,0.8974358974358975,0.10256410256410256,0.0,0.0,0.8974358974358975,0.10256410256410256,0.0,Brenda Rivera RECAP,0.8974358974358975
81004,81004,100,168,4,1,12,185,168,16,1,0.9081081081081082,0.021621621621621623,0.005405405405405406,0.06486486486486487,0.9081081081081082,0.08648648648648649,0.005405405405405406,Brenda Rivera RECAP,0.9081081081081082
81005,81005,100,146,5,0,13,164,146,18,0,0.8902439024390244,0.03048780487804878,0.0,0.07926829268292683,0.8902439024390244,0.10975609756097561,0.0,Brenda Rivera RECAP,0.8902439024390244
81006,81006,100,142,0,0,10,152,142,10,0,0.9342105263157895,0.0,0.0,0.06578947368421052,0.9342105263157895,0.06578947368421052,0.0,Brenda Rivera RECAP,0.9342105263157895
81007,81007,100,128,2,0,13,143,128,15,0,0.8951048951048951,0.013986013986013986,0.0,0.09090909090909091,0.8951048951048951,0.1048951048951049,0.0,Brenda Rivera RECAP,0.8951048951048951
81008,81008,100,101,0,0,4,105,101,4,0,0.9619047619047619,0.0,0.0,0.0380952380952381,0.9619047619047619,0.0380952380952381,0.0,Brenda Rivera RECAP,0.9619047619047619
81009,81009,100,113,0,0,4,117,113,4,0,0.9658119658119658,0.0,0.0,0.03418803418803419,0.9658119658119658,0.03418803418803419,0.0,Brenda Rivera RECAP,0.9658119658119658
81010,81010,100,24,1,0,7,32,24,8,0,0.75,0.03125,0.0,0.21875,0.75,0.25,0.0,Brenda Rivera RECAP,0.75
81011,81011,100,30,0,0,1,31,30,1,0,0.967741935483871,0.0,0.0,0.03225806451612903,0.967741935483871,0.03225806451612903,0.0,Brenda Rivera RECAP,0.967741935483871
81012,81012,100,183,7,0,15,205,183,22,0,0.8926829268292683,0.03414634146341464,0.0,0.07317073170731707,0.8926829268292683,0.1073170731707317,0.0,Brenda Rivera RECAP,0.8926829268292683
81013,81013,100,73,2,0,9,84,73,11,0,0.8690476190476191,0.023809523809523808,0.0,0.10714285714285714,0.8690476190476191,0.13095238095238096,0.0,Brenda Rivera RECAP,0.8690476190476191
81014,81014,100,133,12,0,27,172,133,39,0,0.7732558139534884,0.06976744186046512,0.0,0.1569767441860465,0.7732558139534884,0.22674418604651161,0.0,Brenda Rivera RECAP,0.7732558139534884
81015,81015,100,171,12,0,28,211,171,40,0,0.8104265402843602,0.05687203791469194,0.0,0.13270142180094788,0.8104265402843602,0.1895734597156398,0.0,Brenda Rivera RECAP,0.8104265402843602
81016,81016,100,13,1,0,6,20,13,7,0,0.65,0.05,0.0,0.3,0.65,0.35,0.0,Brenda Rivera RECAP,0.65
81017,81017,100,147,1,0,13,161,147,14,0,0.9130434782608695,0.006211180124223602,0.0,0.08074534161490683,0.9130434782608695,0.08695652173913043,0.0,Brenda Rivera RECAP,0.9130434782608695
81018,81018,100,111,0,0,4,115,111,4,0,0.9652173913043478,0.0,0.0,0.034782608695652174,0.9652173913043478,0.034782608695652174,0.0,Brenda Rivera RECAP,0.9652173913043478
81019,81019,100,138,1,0,9,148,138,10,0,0.9324324324324325,0.006756756756756757,0.0,0.060810810810810814,0.9324324324324325,0.06756756756756757,0.0,Brenda Rivera RECAP,0.9324324324324325
81020,81020,100,185,10,1,19,215,185,29,1,0.8604651162790697,0.046511627906976744,0.004651162790697674,0.08837209302325581,0.8604651162790697,0.13488372093023257,0.004651162790697674,Brenda Rivera RECAP,0.8604651162790697
81021,81021,100,149,2,0,4,155,149,6,0,0.9612903225806452,0.012903225806451613,0.0,0.025806451612903226,0.9612903225806452,0.03870967741935484,0.0,Brenda Rivera RECAP,0.9612903225806452
81022,81022,100,130,0,0,5,135,130,5,0,0.9629629629629629,0.0,0.0,0.037037037037037035,0.9629629629629629,0.037037037037037035,0.0,Brenda Rivera RECAP,0.9629629629629629
81023,81023,100,219,4,0,8,231,219,12,0,0.948051948051948,0.017316017316017316,0.0,0.03463203463203463,0.948051948051948,0.05194805194805195,0.0,Brenda Rivera RECAP,0.948051948051948
81024,81024,100,143,0,0,8,151,143,8,0,0.9470198675496688,0.0,0.0,0.052980132450331126,0.9470198675496688,0.052980132450331126,0.0,Brenda Rivera RECAP,0.9470198675496688
81025,81025,100,73,12,0,58,143,73,70,0,0.5104895104895105,0.08391608391608392,0.0,0.40559440559440557,0.5104895104895105,0.48951048951048953,0.0,Brenda Rivera RECAP,0.5104895104895105
81026,81026,100,49,12,0,29,90,49,41,0,0.5444444444444444,0.13333333333333333,0.0,0.32222222222222224,0.5444444444444444,0.45555555555555555,0.0,Brenda Rivera RECAP,0.5444444444444444
81027,81027,100,54,21,0,53,128,54,74,0,0.421875,0.1640625,0.0,0.4140625,0.421875,0.578125,0.0,Harry Hertzberg RECAP,0.578125
81028,81028,100,49,27,1,62,139,49,89,1,0.35251798561151076,0.19424460431654678,0.007194244604316547,0.4460431654676259,0.35251798561151076,0.6402877697841727,0.007194244604316547,Harry Hertzberg RECAP,0.6402877697841727
81029,81029,100,51,11,0,49,111,51,60,0,0.4594594594594595,0.0990990990990991,0.0,0.44144144144144143,0.4594594594594595,0.5405405405405406,0.0,Harry Hertzberg RECAP,0.5405405405405406
81030,81030,100,77,24,0,79,180,77,103,0,0.42777777777777776,0.13333333333333333,0.0,0.4388888888888889,0.42777777777777776,0.5722222222222222,0.0,Harry Hertzberg RECAP,0.5722222222222222
81031,81031,100,57,22,0,66,145,57,88,0,0.3931034482758621,0.15172413793103448,0.0,0.45517241379310347,0.3931034482758621,0.6068965517241379,0.0,Harry Hertzberg RECAP,0.6068965517241379
81032,81032,100,48,25,2,65,140,48,90,2,0.34285714285714286,0.17857142857142858,0.014285714285714285,0.4642857142857143,0.34285714285714286,0.6428571428571429,0.014285714285714285,Harry Hertzberg RECAP,0.6428571428571429
81033,81033,100,186,10,1,29,226,186,39,1,0.8230088495575221,0.04424778761061947,0.004424778761061947,0.12831858407079647,0.8230088495575221,0.17256637168141592,0.004424778761061947,Brenda Rivera RECAP,0.8230088495575221
81034,81034,100,156,8,0,42,206,156,50,0,0.7572815533980582,0.038834951456310676,0.0,0.20388349514563106,0.7572815533980582,0.24271844660194175,0.0,Brenda Rivera RECAP,0.7572815533980582
81035,81035,100,108,9,1,27,145,108,36,1,0.7448275862068966,0.06206896551724138,0.006896551724137931,0.18620689655172415,0.7448275862068966,0.2482758620689655,0.006896551724137931,Brenda Rivera RECAP,0.7448275862068966
81036,81036,100,166,6,1,34,207,166,40,1,0.8019323671497585,0.028985507246376812,0.004830917874396135,0.1642512077294686,0.8019323671497585,0.1932367149758454,0.004830917874396135,Brenda Rivera RECAP,0.8019323671497585
81037,81037,100,128,9,1,20,158,128,29,1,0.810126582278481,0.056962025316455694,0.006329113924050633,0.12658227848101267,0.810126582278481,0.18354430379746836,0.006329113924050633,Brenda Rivera RECAP,0.810126582278481
81038,81038,100,166,1,0,10,177,166,11,0,0.9378531073446328,0.005649717514124294,0.0,0.05649717514124294,0.9378531073446328,0.062146892655367235,0.0,Brenda Rivera RECAP,0.9378531073446328
81039,81039,100,84,6,0,9,99,84,15,0,0.8484848484848485,0.06060606060606061,0.0,0.09090909090909091,0.8484848484848485,0.15151515151515152,0.0,Brenda Rivera RECAP,0.8484848484848485
81040,81040,100,143,3,0,13,159,143,16,0,0.89937106918239,0.018867924528301886,0.0,0.08176100628930817,0.89937106918239,0.10062893081761007,0.0,Brenda Rivera RECAP,0.89937106918239
81041,81041,100,135,10,2,44,191,135,54,2,0.7068062827225131,0.05235602094240838,0.010471204188481676,0.23036649214659685,0.7068062827225131,0.28272251308900526,0.010471204188481676,Brenda Rivera RECAP,0.7068062827225131
81042,81042,100,34,2,0,8,44,34,10,0,0.7727272727272727,0.045454545454545456,0.0,0.18181818181818182,0.7727272727272727,0.22727272727272727,0.0,Brenda Rivera RECAP,0.7727272727272727
81043,81043,100,127,8,0,31,166,127,39,0,0.7650602409638554,0.04819277108433735,0.0,0.18674698795180722,0.7650602409638554,0.23493975903614459,0.0,Brenda Rivera RECAP,0.7650602409638554
81044,81044,100,70,3,0,31,104,70,34,0,0.6730769230769231,0.028846153846153848,0.0,0.2980769230769231,0.6730769230769231,0.3269230769230769,0.0,Brenda Rivera RECAP,0.6730769230769231
81045,81045,100,31,0,0,3,34,31,3,0,0.9117647058823529,0.0,0.0,0.08823529411764706,0.9117647058823529,0.08823529411764706,0.0,Brenda Rivera RECAP,0.9117647058823529
81046,81046,100,59,0,0,10,69,59,10,0,0.855072463768116,0.0,0.0,0.14492753623188406,0.855072463768116,0.14492753623188406,0.0,Brenda Rivera RECAP,0.855072463768116
81047,81047,100,31,5,0,20,56,31,25,0,0.5535714285714286,0.08928571428571429,0.0,0.35714285714285715,0.5535714285714286,0.44642857142857145,0.0,Brenda Rivera RECAP,0.5535714285714286
81048,81048,100,119,4,0,34,157,119,38,0,0.7579617834394905,0.025477707006369428,0.0,0.21656050955414013,0.7579617834394905,0.24203821656050956,0.0,Brenda Rivera RECAP,0.7579617834394905
81049,81049,100,132,9,2,42,185,132,51,2,0.7135135135135136,0.04864864864864865,0.010810810810810811,0.22702702702702704,0.7135135135135136,0.2756756756756757,0.010810810810810811,Brenda Rivera RECAP,0.7135135135135136
81050,81050,100,124,6,0,26,156,124,32,0,0.7948717948717948,0.038461538461538464,0.0,0.16666666666666666,0.7948717948717948,0.20512820512820512,0.0,Brenda Rivera RECAP,0.7948717948717948
81051,81051,100,111,4,0,34,149,111,38,0,0.7449664429530202,0.026845637583892617,0.0,0.22818791946308725,0.7449664429530202,0.2550335570469799,0.0,Brenda Rivera RECAP,0.7449664429530202
81052,81052,100,69,5,0,28,102,69,33,0,0.6764705882352942,0.049019607843137254,0.0,0.27450980392156865,0.6764705882352942,0.3235294117647059,0.0,Brenda Rivera RECAP,0.6764705882352942
81053,81053,100,43,6,0,54,103,43,60,0,0.4174757281553398,0.05825242718446602,0.0,0.5242718446601942,0.4174757281553398,0.5825242718446602,0.0,Harry Hertzberg RECAP,0.5825242718446602
81054,81054,100,136,17,0,24,177,136,41,0,0.768361581920904,0.096045197740113,0.0,0.13559322033898305,0.768361581920904,0.23163841807909605,0.0,Brenda Rivera RECAP,0.768361581920904
81055,81055,100,198,26,0,52,276,198,78,0,0.717391304347826,0.09420289855072464,0.0,0.18840579710144928,0.717391304347826,0.2826086956521739,0.0,Brenda Rivera RECAP,0.717391304347826
81056,81056,100,141,16,0,42,199,141,58,0,0.7085427135678392,0.08040201005025126,0.0,0.21105527638190955,0.7085427135678392,0.2914572864321608,0.0,Brenda Rivera RECAP,0.7085427135678392
81057,81057,100,65,10,0,55,130,65,65,0,0.5,0.07692307692307693,0.0,0.4230769230769231,0.5,0.5,0.0,Tie,0.5
81058,81058,100,133,7,1,24,165,133,31,1,0.806060606060606,0.04242424242424243,0.006060606060606061,0.14545454545454545,0.806060606060606,0.18787878787878787,0.006060606060606061,Brenda Rivera RECAP,0.806060606060606
81059,81059,100,98,17,2,55,172,98,72,2,0.5697674418604651,0.09883720930232558,0.011627906976744186,0.31976744186046513,0.5697674418604651,0.4186046511627907,0.011627906976744186,Brenda Rivera RECAP,0.5697674418604651
81060,81060,100,116,18,0,62,196,116,80,0,0.5918367346938775,0.09183673469387756,0.0,0.3163265306122449,0.5918367346938775,0.40816326530612246,0.0,Brenda Rivera RECAP,0.5918367346938775
81061,81061,100,84,5,0,35,124,84,40,0,0.6774193548387096,0.04032258064516129,0.0,0.28225806451612906,0.6774193548387096,0.3225806451612903,0.0,Brenda Rivera RECAP,0.6774193548387096
81062,81062,100,173,8,3,37,221,173,45,3,0.7828054298642534,0.03619909502262444,0.013574660633484163,0.167420814479638,0.7828054298642534,0.20361990950226244,0.013574660633484163,Brenda Rivera RECAP,0.7828054298642534
81063,81063,100,135,12,0,85,232,135,97,0,0.5818965517241379,0.05172413793103448,0.0,0.36637931034482757,0.5818965517241379,0.41810344827586204,0.0,Brenda Rivera RECAP,0.5818965517241379
81064,81064,100,314,9,3,44,370,314,53,3,0.8486486486486486,0.024324324324324326,0.008108108108108109,0.11891891891891893,0.8486486486486486,0.14324324324324325,0.008108108108108109,Brenda Rivera RECAP,0.8486486486486486
81065,81065,100,179,18,0,68,265,179,86,0,0.6754716981132075,0.06792452830188679,0.0,0.25660377358490566,0.6754716981132075,0.32452830188679244,0.0,Brenda Rivera RECAP,0.6754716981132075
81066,81066,100,98,9,0,41,148,98,50,0,0.6621621621621622,0.060810810810810814,0.0,0.27702702702702703,0.6621621621621622,0.33783783783783783,0.0,Brenda Rivera RECAP,0.6621621621621622
81067,81067,100,109,3,0,27,139,109,30,0,0.7841726618705036,0.02158273381294964,0.0,0.19424460431654678,0.7841726618705036,0.2158273381294964,0.0,Brenda Rivera RECAP,0.7841726618705036
81068,81068,100,214,19,0,98,331,214,117,0,0.6465256797583081,0.05740181268882175,0.0,0.29607250755287007,0.6465256797583081,0.35347432024169184,0.0,Brenda Rivera RECAP,0.6465256797583081
81069,81069,100,201,15,0,78,294,201,93,0,0.6836734693877551,0.05102040816326531,0.0,0.2653061224489796,0.6836734693877551,0.3163265306122449,0.0,Brenda Rivera RECAP,0.6836734693877551
81070,81070,100,111,6,0,44,161,111,50,0,0.6894409937888198,0.037267080745341616,0.0,0.2732919254658385,0.6894409937888198,0.3105590062111801,0.0,Brenda Rivera RECAP,0.6894409937888198
81071,81071,100,214,10,0,81,305,214,91,0,0.7016393442622951,0.03278688524590164,0.0,0.26557377049180325,0.7016393442622951,0.2983606557377049,0.0,Brenda Rivera RECAP,0.7016393442622951
81072,81072,100,162,11,0,56,229,162,67,0,0.7074235807860262,0.048034934497816595,0.0,0.2445414847161572,0.7074235807860262,0.2925764192139738,0.0,Brenda Rivera RECAP,0.7074235807860262
81073,81073,100,160,10,0,56,226,160,66,0,0.7079646017699115,0.04424778761061947,0.0,0.24778761061946902,0.7079646017699115,0.2920353982300885,0.0,Brenda Rivera RECAP,0.7079646017699115
81074,81074,100,171,10,0,48,229,171,58,0,0.7467248908296943,0.043668122270742356,0.0,0.2096069868995633,0.7467248908296943,0.25327510917030566,0.0,Brenda Rivera RECAP,0.7467248908296943
81075,81075,100,150,10,1,44,205,150,54,1,0.7317073170731707,0.04878048780487805,0.004878048780487805,0.2146341463414634,0.7317073170731707,0.2634146341463415,0.004878048780487805,Brenda Rivera RECAP,0.7317073170731707
81076,81076,100,170,6,0,54,230,170,60,0,0.7391304347826086,0.02608695652173913,0.0,0.23478260869565218,0.7391304347826086,0.2608695652173913,0.0,Brenda Rivera RECAP,0.7391304347826086
81077,81077,100,152,6,0,48,206,152,54,0,0.7378640776699029,0.02912621359223301,0.0,0.23300970873786409,0.7378640776699029,0.2621359223300971,0.0,Brenda Rivera RECAP,0.7378640776699029
81078,81078,100,259,16,0,59,334,259,75,0,0.7754491017964071,0.04790419161676647,0.0,0.17664670658682635,0.7754491017964071,0.2245508982035928,0.0,Brenda Rivera RECAP,0.7754491017964071
81079,81079,100,140,12,0,78,230,140,90,0,0.6086956521739131,0.05217391304347826,0.0,0.3391304347826087,0.6086956521739131,0.391304347826087,0.0,Brenda Rivera RECAP,0.6086956521739131
81080,81080,100,222,11,0,73,306,222,84,0,0.7254901960784313,0.03594771241830065,0.0,0.238562091503268,0.7254901960784313,0.27450980392156865,0.0,Brenda Rivera RECAP,0.7254901960784313
81081,81081,100,154,6,1,25,186,154,31,1,0.8279569892473119,0.03225806451612903,0.005376344086021506,0.13440860215053763,0.8279569892473119,0.16666666666666666,0.005376344086021506,Brenda Rivera RECAP,0.8279569892473119
81082,81082,100,120,12,0,54,186,120,66,0,0.6451612903225806,0.06451612903225806,0.0,0.2903225806451613,0.6451612903225806,0.3548387096774194,0.0,Brenda Rivera RECAP,0.6451612903225806
81083,81083,100,180,4,0,43,227,180,47,0,0.7929515418502202,0.01762114537444934,0.0,0.1894273127753304,0.7929515418502202,0.20704845814977973,0.0,Brenda Rivera RECAP,0.7929515418502202
81084,81084,100,232,12,0,60,304,232,72,0,0.7631578947368421,0.039473684210526314,0.0,0.19736842105263158,0.7631578947368421,0.23684210526315788,0.0,Brenda Rivera RECAP,0.7631578947368421
81085,81085,100,101,6,1,35,143,101,41,1,0.7062937062937062,0.04195804195804196,0.006993006993006993,0.24475524475524477,0.7062937062937062,0.2867132867132867,0.006993006993006993,Brenda Rivera RECAP,0.7062937062937062
81086,81086,100,176,17,2,50,245,176,67,2,0.7183673469387755,0.06938775510204082,0.00816326530612245,0.20408163265306123,0.7183673469387755,0.27346938775510204,0.00816326530612245,Brenda Rivera RECAP,0.7183673469387755
81087,81087,100,140,4,0,39,183,140,43,0,0.7650273224043715,0.02185792349726776,0.0,0.21311475409836064,0.7650273224043715,0.23497267759562843,0.0,Brenda Rivera RECAP,0.7650273224043715
81088,81088,100,104,26,0,72,202,104,98,0,0.5148514851485149,0.12871287128712872,0.0,0.3564356435643564,0.5148514851485149,0.48514851485148514,0.0,Brenda Rivera RECAP,0.5148514851485149
81089,81089,100,167,5,0,39,211,167,44,0,0.7914691943127962,0.023696682464454975,0.0,0.1848341232227488,0.7914691943127962,0.20853080568720378,0.0,Brenda Rivera RECAP,0.7914691943127962
81090,81090,100,170,2,1,28,201,170,30,1,0.845771144278607,0.009950248756218905,0.004975124378109453,0.13930348258706468,0.845771144278607,0.14925373134328357,0.004975124378109453,Brenda Rivera RECAP,0.845771144278607
81091,81091,100,144,1,0,18,163,144,19,0,0.8834355828220859,0.006134969325153374,0.0,0.11042944785276074,0.8834355828220859,0.1165644171779141,0.0,Brenda Rivera RECAP,0.8834355828220859
81092,81092,100,76,0,0,5,81,76,5,0,0.9382716049382716,0.0,0.0,0.06172839506172839,0.9382716049382716,0.06172839506172839,0.0,Brenda Rivera RECAP,0.9382716049382716
81093,81093,100,135,1,0,9,145,135,10,0,0.9310344827586207,0.006896551724137931,0.0,0.06206896551724138,0.9310344827586207,0.06896551724137931,0.0,Brenda Rivera RECAP,0.9310344827586207
81094,81094,100,129,9,0,12,150,129,21,0,0.86,0.06,0.0,0.08,0.86,0.14,0.0,Brenda Rivera RECAP,0.86
81095,81095,100,65,2,0,13,80,65,15,0,0.8125,0.025,0.0,0.1625,0.8125,0.1875,0.0,Brenda Rivera RECAP,0.8125
81096,81096,100,89,1,0,14,104,89,15,0,0.8557692307692307,0.009615384615384616,0.0,0.1346153846153846,0.8557692307692307,0.14423076923076922,0.0,Brenda Rivera RECAP,0.8557692307692307
81097,81097,100,159,2,0,6,167,159,8,0,0.9520958083832335,0.011976047904191617,0.0,0.03592814371257485,0.9520958083832335,0.04790419161676647,0.0,Brenda Rivera RECAP,0.9520958083832335
81098,81098,100,110,4,1,11,126,110,15,1,0.873015873015873,0.031746031746031744,0.007936507936507936,0.0873015873015873,0.873015873015873,0.11904761904761904,0.007936507936507936,Brenda Rivera RECAP,0.873015873015873
81099,81099,100,168,4,1,31,204,168,35,1,0.8235294117647058,0.0196078431372549,0.004901960784313725,0.15196078431372548,0.8235294117647058,0.1715686274509804,0.004901960784313725,Brenda Rivera RECAP,0.8235294117647058
81100,81100,100,95,0,0,7,102,95,7,0,0.9313725490196079,0.0,0.0,0.06862745098039216,0.9313725490196079,0.06862745098039216,0.0,Brenda Rivera RECAP,0.9313725490196079
81107,81107,100,14,0,0,0,14,14,0,0,1.0,0.0,0.0,0.0,1.0,0.0,0.0,Brenda Rivera RECAP,1.0
81101,81107,100,0,0,0,0,0,0,0,0,0,0,0,0,0,0,0,n/a,0
81102,81102,100,0,0,0,0,0,0,0,0,0,0,0,0,0,0,0,n/a,0
81103,81103,100,0,0,0,0,0,0,0,0,0,0,0,0,0,0,0,n/a,0
81104,81104,100,0,0,0,0,0,0,0,0,0,0,0,0,0,0,0,n/a,0
81105,81105,100,0,0,0,0,0,0,0,0,0,0,0,0,0,0,0,n/a,0
81106,81106,100,0,0,0,0,0,0,0,0,0,0,0,0,0,0,0,n/a,0
81108,81010,100,0,0,0,0,0,0,0,0,0,0,0,0,0,0,0,n/a,0
82001,82001,100,73,36,0,117,226,73,153,0,0.3230088495575221,0.1592920353982301,0.0,0.5176991150442478,0.3230088495575221,0.6769911504424779,0.0,Harry Hertzberg RECAP,0.6769911504424779
82002,82002,100,71,24,1,101,197,71,125,1,0.3604060913705584,0.1218274111675127,0.005076142131979695,0.5126903553299492,0.3604060913705584,0.6345177664974619,0.005076142131979695,Harry Hertzberg RECAP,0.6345177664974619
82003,82003,100,57,23,0,60,140,57,83,0,0.40714285714285714,0.16428571428571428,0.0,0.42857142857142855,0.40714285714285714,0.5928571428571429,0.0,Harry Hertzberg RECAP,0.5928571428571429
82004,82004,100,81,21,0,94,196,81,115,0,0.413265306122449,0.10714285714285714,0.0,0.47959183673469385,0.413265306122449,0.5867346938775511,0.0,Harry Hertzberg RECAP,0.5867346938775511
82005,82005,100,113,19,0,88,220,113,107,0,0.5136363636363637,0.08636363636363636,0.0,0.4,0.5136363636363637,0.4863636363636364,0.0,Brenda Rivera RECAP,0.5136363636363637
82006,82006,100,70,17,1,40,128,70,57,1,0.546875,0.1328125,0.0078125,0.3125,0.546875,0.4453125,0.0078125,Brenda Rivera RECAP,0.546875
82007,82007,100,93,25,0,71,189,93,96,0,0.49206349206349204,0.13227513227513227,0.0,0.37566137566137564,0.49206349206349204,0.5079365079365079,0.0,Harry Hertzberg RECAP,0.5079365079365079
82008,82008,100,124,13,0,31,168,124,44,0,0.7380952380952381,0.07738095238095238,0.0,0.18452380952380953,0.7380952380952381,0.2619047619047619,0.0,Brenda Rivera RECAP,0.7380952380952381
82009,82009,100,95,9,0,37,141,95,46,0,0.6737588652482269,0.06382978723404255,0.0,0.2624113475177305,0.6737588652482269,0.3262411347517731,0.0,Brenda Rivera RECAP,0.6737588652482269
82010,82010,100,154,14,0,58,226,154,72,0,0.6814159292035398,0.061946902654867256,0.0,0.25663716814159293,0.6814159292035398,0.3185840707964602,0.0,Brenda Rivera RECAP,0.6814159292035398
82011,82011,100,97,8,0,39,144,97,47,0,0.6736111111111112,0.05555555555555555,0.0,0.2708333333333333,0.6736111111111112,0.3263888888888889,0.0,Brenda Rivera RECAP,0.6736111111111112
82012,82012,100,97,0,0,2,99,97,2,0,0.9797979797979798,0.0,0.0,0.020202020202020204,0.9797979797979798,0.020202020202020204,0.0,Brenda Rivera RECAP,0.9797979797979798
82013,82013,100,118,2,0,4,124,118,6,0,0.9516129032258065,0.016129032258064516,0.0,0.03225806451612903,0.9516129032258065,0.04838709677419355,0.0,Brenda Rivera RECAP,0.9516129032258065
82014,82014,100,56,1,0,4,61,56,5,0,0.9180327868852459,0.01639344262295082,0.0,0.06557377049180328,0.9180327868852459,0.08196721311475409,0.0,Brenda Rivera RECAP,0.9180327868852459
82015,82015,100,194,1,0,7,202,194,8,0,0.9603960396039604,0.0049504950495049506,0.0,0.034653465346534656,0.9603960396039604,0.039603960396039604,0.0,Brenda Rivera RECAP,0.9603960396039604
82016,82016,100,92,12,0,32,136,92,44,0,0.6764705882352942,0.08823529411764706,0.0,0.23529411764705882,0.6764705882352942,0.3235294117647059,0.0,Brenda Rivera RECAP,0.6764705882352942
82017,82017,100,95,11,0,58,164,95,69,0,0.5792682926829268,0.06707317073170732,0.0,0.35365853658536583,0.5792682926829268,0.42073170731707316,0.0,Brenda Rivera RECAP,0.5792682926829268
82018,82018,100,56,4,0,18,78,56,22,0,0.717948717948718,0.05128205128205128,0.0,0.23076923076923078,0.717948717948718,0.28205128205128205,0.0,Brenda Rivera RECAP,0.717948717948718
82019,82019,100,61,10,0,46,117,61,56,0,0.5213675213675214,0.08547008547008547,0.0,0.39316239316239315,0.5213675213675214,0.47863247863247865,0.0,Brenda Rivera RECAP,0.5213675213675214
82020,82020,100,72,21,0,62,155,72,83,0,0.4645161290322581,0.13548387096774195,0.0,0.4,0.4645161290322581,0.535483870967742,0.0,Harry Hertzberg RECAP,0.535483870967742
82021,82021,100,61,12,0,28,101,61,40,0,0.6039603960396039,0.1188118811881188,0.0,0.27722772277227725,0.6039603960396039,0.39603960396039606,0.0,Brenda Rivera RECAP,0.6039603960396039
82022,82022,100,128,11,0,42,181,128,53,0,0.7071823204419889,0.06077348066298342,0.0,0.23204419889502761,0.7071823204419889,0.292817679558011,0.0,Brenda Rivera RECAP,0.7071823204419889
82023,82023,100,113,2,0,9,124,113,11,0,0.9112903225806451,0.016129032258064516,0.0,0.07258064516129033,0.9112903225806451,0.08870967741935484,0.0,Brenda Rivera RECAP,0.9112903225806451
82024,82024,100,93,11,0,36,140,93,47,0,0.6642857142857143,0.07857142857142857,0.0,0.2571428571428571,0.6642857142857143,0.3357142857142857,0.0,Brenda Rivera RECAP,0.6642857142857143
82025,82025,100,80,12,1,41,134,80,53,1,0.5970149253731343,0.08955223880597014,0.007462686567164179,0.30597014925373134,0.5970149253731343,0.39552238805970147,0.007462686567164179,Brenda Rivera RECAP,0.5970149253731343
82026,82026,100,19,0,0,3,22,19,3,0,0.8636363636363636,0.0,0.0,0.13636363636363635,0.8636363636363636,0.13636363636363635,0.0,Brenda Rivera RECAP,0.8636363636363636
82027,82027,100,62,3,0,5,70,62,8,0,0.8857142857142857,0.04285714285714286,0.0,0.07142857142857142,0.8857142857142857,0.11428571428571428,0.0,Brenda Rivera RECAP,0.8857142857142857
82028,82028,100,86,8,0,18,112,86,26,0,0.7678571428571429,0.07142857142857142,0.0,0.16071428571428573,0.7678571428571429,0.23214285714285715,0.0,Brenda Rivera RECAP,0.7678571428571429
82029,82029,100,19,1,0,3,23,19,4,0,0.8260869565217391,0.043478260869565216,0.0,0.13043478260869565,0.8260869565217391,0.17391304347826086,0.0,Brenda Rivera RECAP,0.8260869565217391
82030,82030,100,119,4,0,29,152,119,33,0,0.7828947368421053,0.02631578947368421,0.0,0.19078947368421054,0.7828947368421053,0.21710526315789475,0.0,Brenda Rivera RECAP,0.7828947368421053
82031,82031,100,218,3,1,25,247,218,28,1,0.8825910931174089,0.012145748987854251,0.004048582995951417,0.10121457489878542,0.8825910931174089,0.11336032388663968,0.004048582995951417,Brenda Rivera RECAP,0.8825910931174089
82032,82032,100,85,11,0,57,153,85,68,0,0.5555555555555556,0.0718954248366013,0.0,0.37254901960784315,0.5555555555555556,0.4444444444444444,0.0,Brenda Rivera RECAP,0.5555555555555556
82033,82033,100,84,18,0,52,154,84,70,0,0.5454545454545454,0.11688311688311688,0.0,0.33766233766233766,0.5454545454545454,0.45454545454545453,0.0,Brenda Rivera RECAP,0.5454545454545454
82034,82034,100,60,8,0,40,108,60,48,0,0.5555555555555556,0.07407407407407407,0.0,0.37037037037037035,0.5555555555555556,0.4444444444444444,0.0,Brenda Rivera RECAP,0.5555555555555556
82035,82035,100,90,11,0,69,170,90,80,0,0.5294117647058824,0.06470588235294118,0.0,0.40588235294117647,0.5294117647058824,0.47058823529411764,0.0,Brenda Rivera RECAP,0.5294117647058824
82036,82036,100,108,18,0,85,211,108,103,0,0.5118483412322274,0.08530805687203792,0.0,0.4028436018957346,0.5118483412322274,0.4881516587677725,0.0,Brenda Rivera RECAP,0.5118483412322274
82037,82037,100,123,11,0,30,164,123,41,0,0.75,0.06707317073170732,0.0,0.18292682926829268,0.75,0.25,0.0,Brenda Rivera RECAP,0.75
82038,82038,100,110,7,0,32,149,110,39,0,0.738255033557047,0.04697986577181208,0.0,0.21476510067114093,0.738255033557047,0.26174496644295303,0.0,Brenda Rivera RECAP,0.738255033557047
82039,82039,100,120,9,0,42,171,120,51,0,0.7017543859649122,0.05263157894736842,0.0,0.24561403508771928,0.7017543859649122,0.2982456140350877,0.0,Brenda Rivera RECAP,0.7017543859649122
82040,82040,100,70,16,0,60,146,70,76,0,0.4794520547945205,0.1095890410958904,0.0,0.410958904109589,0.4794520547945205,0.5205479452054794,0.0,Harry Hertzberg RECAP,0.5205479452054794
82041,82041,100,85,19,0,70,174,85,89,0,0.4885057471264368,0.10919540229885058,0.0,0.40229885057471265,0.4885057471264368,0.5114942528735632,0.0,Harry Hertzberg RECAP,0.5114942528735632
82042,82042,100,46,10,0,33,89,46,43,0,0.5168539325842697,0.11235955056179775,0.0,0.3707865168539326,0.5168539325842697,0.48314606741573035,0.0,Brenda Rivera RECAP,0.5168539325842697
82043,82043,100,53,19,0,64,136,53,83,0,0.3897058823529412,0.13970588235294118,0.0,0.47058823529411764,0.3897058823529412,0.6102941176470589,0.0,Harry Hertzberg RECAP,0.6102941176470589
82044,82044,100,67,13,0,72,152,67,85,0,0.4407894736842105,0.08552631578947369,0.0,0.47368421052631576,0.4407894736842105,0.5592105263157895,0.0,Harry Hertzberg RECAP,0.5592105263157895
82045,82045,100,59,27,0,63,149,59,90,0,0.3959731543624161,0.18120805369127516,0.0,0.4228187919463087,0.3959731543624161,0.6040268456375839,0.0,Harry Hertzberg RECAP,0.6040268456375839
82046,82046,100,74,22,0,80,176,74,102,0,0.42045454545454547,0.125,0.0,0.45454545454545453,0.42045454545454547,0.5795454545454546,0.0,Harry Hertzberg RECAP,0.5795454545454546
82047,82047,100,55,9,0,63,127,55,72,0,0.4330708661417323,0.07086614173228346,0.0,0.49606299212598426,0.4330708661417323,0.5669291338582677,0.0,Harry Hertzberg RECAP,0.5669291338582677
82048,82048,100,84,24,0,68,176,84,92,0,0.4772727272727273,0.13636363636363635,0.0,0.38636363636363635,0.4772727272727273,0.5227272727272727,0.0,Harry Hertzberg RECAP,0.5227272727272727
82049,82049,100,87,25,1,115,228,87,140,1,0.3815789473684211,0.10964912280701754,0.0043859649122807015,0.5043859649122807,0.3815789473684211,0.6140350877192983,0.0043859649122807015,Harry Hertzberg RECAP,0.6140350877192983
82050,82050,100,72,2,0,25,99,72,27,0,0.7272727272727273,0.020202020202020204,0.0,0.25252525252525254,0.7272727272727273,0.2727272727272727,0.0,Brenda Rivera RECAP,0.7272727272727273
82051,82051,100,113,8,0,32,153,113,40,0,0.738562091503268,0.05228758169934641,0.0,0.20915032679738563,0.738562091503268,0.26143790849673204,0.0,Brenda Rivera RECAP,0.738562091503268
82052,82052,100,112,13,0,60,185,112,73,0,0.6054054054054054,0.07027027027027027,0.0,0.32432432432432434,0.6054054054054054,0.3945945945945946,0.0,Brenda Rivera RECAP,0.6054054054054054
82053,82053,100,76,13,0,30,119,76,43,0,0.6386554621848739,0.1092436974789916,0.0,0.25210084033613445,0.6386554621848739,0.36134453781512604,0.0,Brenda Rivera RECAP,0.6386554621848739
82054,82054,100,19,0,0,0,19,19,0,0,1.0,0.0,0.0,0.0,1.0,0.0,0.0,Brenda Rivera RECAP,1.0
82055,82055,100,70,13,0,55,138,70,68,0,0.5072463768115942,0.09420289855072464,0.0,0.39855072463768115,0.5072463768115942,0.4927536231884058,0.0,Brenda Rivera RECAP,0.5072463768115942
82056,82056,100,105,29,0,85,219,105,114,0,0.4794520547945205,0.1324200913242009,0.0,0.3881278538812785,0.4794520547945205,0.5205479452054794,0.0,Harry Hertzberg RECAP,0.5205479452054794
82057,82057,100,100,28,1,71,200,100,99,1,0.5,0.14,0.005,0.355,0.5,0.495,0.005,Brenda Rivera RECAP,0.5
82058,82058,100,58,13,1,71,143,58,84,1,0.40559440559440557,0.09090909090909091,0.006993006993006993,0.4965034965034965,0.40559440559440557,0.5874125874125874,0.006993006993006993,Harry Hertzberg RECAP,0.5874125874125874
82059,82059,100,12,0,0,3,15,12,3,0,0.8,0.0,0.0,0.2,0.8,0.2,0.0,Brenda Rivera RECAP,0.8
82060,82060,100,128,28,1,88,245,128,116,1,0.5224489795918368,0.11428571428571428,0.004081632653061225,0.35918367346938773,0.5224489795918368,0.47346938775510206,0.004081632653061225,Brenda Rivera RECAP,0.5224489795918368
82061,82061,100,164,28,0,118,310,164,146,0,0.5290322580645161,0.09032258064516129,0.0,0.38064516129032255,0.5290322580645161,0.47096774193548385,0.0,Brenda Rivera RECAP,0.5290322580645161
82062,82062,100,116,37,0,75,228,116,112,0,0.5087719298245614,0.16228070175438597,0.0,0.32894736842105265,0.5087719298245614,0.49122807017543857,0.0,Brenda Rivera RECAP,0.5087719298245614
82063,82063,100,119,24,0,66,209,119,90,0,0.569377990430622,0.11483253588516747,0.0,0.3157894736842105,0.569377990430622,0.430622009569378,0.0,Brenda Rivera RECAP,0.569377990430622
82064,82064,100,44,2,0,20,66,44,22,0,0.6666666666666666,0.030303030303030304,0.0,0.30303030303030304,0.6666666666666666,0.3333333333333333,0.0,Brenda Rivera RECAP,0.6666666666666666
82065,82065,100,178,5,0,18,201,178,23,0,0.8855721393034826,0.024875621890547265,0.0,0.08955223880597014,0.8855721393034826,0.11442786069651742,0.0,Brenda Rivera RECAP,0.8855721393034826
82066,82066,100,176,3,1,12,192,176,15,1,0.9166666666666666,0.015625,0.005208333333333333,0.0625,0.9166666666666666,0.078125,0.005208333333333333,Brenda Rivera RECAP,0.9166666666666666
82067,82067,100,201,3,0,11,215,201,14,0,0.9348837209302325,0.013953488372093023,0.0,0.05116279069767442,0.9348837209302325,0.06511627906976744,0.0,Brenda Rivera RECAP,0.9348837209302325
82068,82068,100,186,3,0,11,200,186,14,0,0.93,0.015,0.0,0.055,0.93,0.07,0.0,Brenda Rivera RECAP,0.93
82069,82069,100,192,0,0,9,201,192,9,0,0.9552238805970149,0.0,0.0,0.04477611940298507,0.9552238805970149,0.04477611940298507,0.0,Brenda Rivera RECAP,0.9552238805970149
82070,82070,100,135,4,0,8,147,135,12,0,0.9183673469387755,0.027210884353741496,0.0,0.05442176870748299,0.9183673469387755,0.08163265306122448,0.0,Brenda Rivera RECAP,0.9183673469387755
82071,82071,100,177,2,0,2,181,177,4,0,0.9779005524861878,0.011049723756906077,0.0,0.011049723756906077,0.9779005524861878,0.022099447513812154,0.0,Brenda Rivera RECAP,0.9779005524861878
82072,82072,100,208,1,0,9,218,208,10,0,0.9541284403669725,0.0045871559633027525,0.0,0.04128440366972477,0.9541284403669725,0.045871559633027525,0.0,Brenda Rivera RECAP,0.9541284403669725
82073,82073,100,203,2,0,7,212,203,9,0,0.9575471698113207,0.009433962264150943,0.0,0.0330188679245283,0.9575471698113207,0.04245283018867924,0.0,Brenda Rivera RECAP,0.9575471698113207
82074,82074,100,161,4,0,6,171,161,10,0,0.9415204678362573,0.023391812865497075,0.0,0.03508771929824561,0.9415204678362573,0.05847953216374269,0.0,Brenda Rivera RECAP,0.9415204678362573
82075,82075,100,165,2,0,8,175,165,10,0,0.9428571428571428,0.011428571428571429,0.0,0.045714285714285714,0.9428571428571428,0.05714285714285714,0.0,Brenda Rivera RECAP,0.9428571428571428
82076,82076,100,164,3,0,6,173,164,9,0,0.9479768786127167,0.017341040462427744,0.0,0.03468208092485549,0.9479768786127167,0.05202312138728324,0.0,Brenda Rivera RECAP,0.9479768786127167
82077,82077,100,190,3,0,12,205,190,15,0,0.926829268292683,0.014634146341463415,0.0,0.05853658536585366,0.926829268292683,0.07317073170731707,0.0,Brenda Rivera RECAP,0.926829268292683
82078,82078,100,203,2,0,7,212,203,9,0,0.9575471698113207,0.009433962264150943,0.0,0.0330188679245283,0.9575471698113207,0.04245283018867924,0.0,Brenda Rivera RECAP,0.9575471698113207
82079,82079,100,202,5,0,12,219,202,17,0,0.9223744292237442,0.0228310502283105,0.0,0.0547945205479452,0.9223744292237442,0.0776255707762557,0.0,Brenda Rivera RECAP,0.9223744292237442
82080,82080,100,177,2,1,8,188,177,10,1,0.9414893617021277,0.010638297872340425,0.005319148936170213,0.0425531914893617,0.9414893617021277,0.05319148936170213,0.005319148936170213,Brenda Rivera RECAP,0.9414893617021277
82081,82081,100,143,3,0,13,159,143,16,0,0.89937106918239,0.018867924528301886,0.0,0.08176100628930817,0.89937106918239,0.10062893081761007,0.0,Brenda Rivera RECAP,0.89937106918239
82082,82082,100,131,4,0,14,149,131,18,0,0.8791946308724832,0.026845637583892617,0.0,0.09395973154362416,0.8791946308724832,0.12080536912751678,0.0,Brenda Rivera RECAP,0.8791946308724832
82083,82083,100,139,2,0,6,147,139,8,0,0.9455782312925171,0.013605442176870748,0.0,0.04081632653061224,0.9455782312925171,0.05442176870748299,0.0,Brenda Rivera RECAP,0.9455782312925171
82084,82084,100,151,2,0,4,157,151,6,0,0.9617834394904459,0.012738853503184714,0.0,0.025477707006369428,0.9617834394904459,0.03821656050955414,0.0,Brenda Rivera RECAP,0.9617834394904459
82085,82085,100,175,3,0,11,189,175,14,0,0.9259259259259259,0.015873015873015872,0.0,0.0582010582010582,0.9259259259259259,0.07407407407407407,0.0,Brenda Rivera RECAP,0.9259259259259259
82086,82086,100,134,1,0,5,140,134,6,0,0.9571428571428572,0.007142857142857143,0.0,0.03571428571428571,0.9571428571428572,0.04285714285714286,0.0,Brenda Rivera RECAP,0.9571428571428572
82087,82087,100,159,1,0,11,171,159,12,0,0.9298245614035088,0.005847953216374269,0.0,0.06432748538011696,0.9298245614035088,0.07017543859649122,0.0,Brenda Rivera RECAP,0.9298245614035088
82088,82088,100,179,3,0,5,187,179,8,0,0.9572192513368984,0.016042780748663103,0.0,0.026737967914438502,0.9572192513368984,0.0427807486631016,0.0,Brenda Rivera RECAP,0.9572192513368984
82089,82089,100,198,2,0,12,212,198,14,0,0.9339622641509434,0.009433962264150943,0.0,0.05660377358490566,0.9339622641509434,0.0660377358490566,0.0,Brenda Rivera RECAP,0.9339622641509434
82090,82090,100,178,1,0,10,189,178,11,0,0.9417989417989417,0.005291005291005291,0.0,0.05291005291005291,0.9417989417989417,0.0582010582010582,0.0,Brenda Rivera RECAP,0.9417989417989417
82091,82091,100,180,6,0,10,196,180,16,0,0.9183673469387755,0.030612244897959183,0.0,0.05102040816326531,0.9183673469387755,0.08163265306122448,0.0,Brenda Rivera RECAP,0.9183673469387755
82092,82092,100,213,4,0,20,237,213,24,0,0.8987341772151899,0.016877637130801686,0.0,0.08438818565400844,0.8987341772151899,0.10126582278481013,0.0,Brenda Rivera RECAP,0.8987341772151899
82093,82093,100,134,4,0,5,143,134,9,0,0.9370629370629371,0.027972027972027972,0.0,0.03496503496503497,0.9370629370629371,0.06293706293706294,0.0,Brenda Rivera RECAP,0.9370629370629371
82094,82094,100,161,1,0,8,170,161,9,0,0.9470588235294117,0.0058823529411764705,0.0,0.047058823529411764,0.9470588235294117,0.052941176470588235,0.0,Brenda Rivera RECAP,0.9470588235294117
82095,82095,100,143,5,0,9,157,143,14,0,0.910828025477707,0.03184713375796178,0.0,0.05732484076433121,0.910828025477707,0.08917197452229299,0.0,Brenda Rivera RECAP,0.910828025477707
82096,82096,100,155,1,0,3,159,155,4,0,0.9748427672955975,0.006289308176100629,0.0,0.018867924528301886,0.9748427672955975,0.025157232704402517,0.0,Brenda Rivera RECAP,0.9748427672955975
82097,82097,100,177,2,1,16,196,177,18,1,0.9030612244897959,0.01020408163265306,0.00510204081632653,0.08163265306122448,0.9030612244897959,0.09183673469387756,0.00510204081632653,Brenda Rivera RECAP,0.9030612244897959
82098,82098,100,220,8,0,17,245,220,25,0,0.8979591836734694,0.0326530612244898,0.0,0.06938775510204082,0.8979591836734694,0.10204081632653061,0.0,Brenda Rivera RECAP,0.8979591836734694
82099,82099,100,224,3,0,6,233,224,9,0,0.9613733905579399,0.012875536480686695,0.0,0.02575107296137339,0.9613733905579399,0.03862660944206009,0.0,Brenda Rivera RECAP,0.9613733905579399
82100,82100,100,185,0,0,9,194,185,9,0,0.9536082474226805,0.0,0.0,0.04639175257731959,0.9536082474226805,0.04639175257731959,0.0,Brenda Rivera RECAP,0.9536082474226805
82101,82101,100,185,5,0,4,194,185,9,0,0.9536082474226805,0.02577319587628866,0.0,0.020618556701030927,0.9536082474226805,0.04639175257731959,0.0,Brenda Rivera RECAP,0.9536082474226805
82102,82102,100,161,1,0,4,166,161,5,0,0.9698795180722891,0.006024096385542169,0.0,0.024096385542168676,0.9698795180722891,0.030120481927710843,0.0,Brenda Rivera RECAP,0.9698795180722891
82103,82103,100,143,1,0,4,148,143,5,0,0.9662162162162162,0.006756756756756757,0.0,0.02702702702702703,0.9662162162162162,0.033783783783783786,0.0,Brenda Rivera RECAP,0.9662162162162162
82104,82104,100,209,2,0,9,220,209,11,0,0.95,0.00909090909090909,0.0,0.04090909090909091,0.95,0.05,0.0,Brenda Rivera RECAP,0.95
82105,82105,100,210,0,0,7,217,210,7,0,0.967741935483871,0.0,0.0,0.03225806451612903,0.967741935483871,0.03225806451612903,0.0,Brenda Rivera RECAP,0.967741935483871
82106,82106,100,1,0,0,0,1,1,0,0,1.0,0.0,0.0,0.0,1.0,0.0,0.0,Brenda Rivera RECAP,1.0
82107,82107,100,44,7,0,17,68,44,24,0,0.6470588235294118,0.10294117647058823,0.0,0.25,0.6470588235294118,0.35294117647058826,0.0,Brenda Rivera RECAP,0.6470588235294118
82108,82108,100,0,0,0,0,0,0,0,0,0,0,0,0,0,0,0,n/a,0
82109,82109,100,66,1,0,8,75,66,9,0,0.88,0.013333333333333334,0.0,0.10666666666666667,0.88,0.12,0.0,Brenda Rivera RECAP,0.88
82110,82054,100,0,0,0,0,0,0,0,0,0,0,0,0,0,0,0,n/a,0
82111,82111,100,0,0,0,0,0,0,0,0,0,0,0,0,0,0,0,n/a,0
82112,82108,100,0,0,0,0,0,0,0,0,0,0,0,0,0,0,0,n/a,0
82113,82111,100,0,0,0,0,0,0,0,0,0,0,0,0,0,0,0,n/a,0
82114,82108,100,0,0,0,0,0,0,0,0,0,0,0,0,0,0,0,n/a,0
82115,82108,100,0,0,0,0,0,0,0,0,0,0,0,0,0,0,0,n/a,0
82116,82111,100,0,0,0,0,0,0,0,0,0,0,0,0,0,0,0,n/a,0
82117,82117,100,0,0,0,0,0,0,0,0,0,0,0,0,0,0,0,n/a,0
82118,82117,100,0,0,0,0,0,0,0,0,0,0,0,0,0,0,0,n/a,0
83001,83001,100,226,6,1,11,244,226,17,1,0.9262295081967213,0.02459016393442623,0.004098360655737705,0.045081967213114756,0.9262295081967213,0.06967213114754098,0.004098360655737705,Brenda Rivera RECAP,0.9262295081967213
83002,83002,100,20,0,0,3,23,20,3,0,0.8695652173913043,0.0,0.0,0.13043478260869565,0.8695652173913043,0.13043478260869565,0.0,Brenda Rivera RECAP,0.8695652173913043
83003,83003,100,137,1,0,4,142,137,5,0,0.9647887323943662,0.007042253521126761,0.0,0.028169014084507043,0.9647887323943662,0.035211267605633804,0.0,Brenda Rivera RECAP,0.9647887323943662
83004,83004,100,65,2,0,6,73,65,8,0,0.8904109589041096,0.0273972602739726,0.0,0.0821917808219178,0.8904109589041096,0.1095890410958904,0.0,Brenda Rivera RECAP,0.8904109589041096
83005,83005,100,31,1,0,0,32,31,1,0,0.96875,0.03125,0.0,0.0,0.96875,0.03125,0.0,Brenda Rivera RECAP,0.96875
83006,83006,100,173,1,0,3,177,173,4,0,0.9774011299435028,0.005649717514124294,0.0,0.01694915254237288,0.9774011299435028,0.022598870056497175,0.0,Brenda Rivera RECAP,0.9774011299435028
83007,83007,100,230,2,0,2,234,230,4,0,0.9829059829059829,0.008547008547008548,0.0,0.008547008547008548,0.9829059829059829,0.017094017094017096,0.0,Brenda Rivera RECAP,0.9829059829059829
83008,83008,100,139,0,0,2,141,139,2,0,0.9858156028368794,0.0,0.0,0.014184397163120567,0.9858156028368794,0.014184397163120567,0.0,Brenda Rivera RECAP,0.9858156028368794
83009,83009,100,152,2,0,1,155,152,3,0,0.9806451612903225,0.012903225806451613,0.0,0.0064516129032258064,0.9806451612903225,0.01935483870967742,0.0,Brenda Rivera RECAP,0.9806451612903225
83010,83010,100,276,0,0,7,283,276,7,0,0.9752650176678446,0.0,0.0,0.024734982332155476,0.9752650176678446,0.024734982332155476,0.0,Brenda Rivera RECAP,0.9752650176678446
83011,83011,100,184,0,0,8,192,184,8,0,0.9583333333333334,0.0,0.0,0.041666666666666664,0.9583333333333334,0.041666666666666664,0.0,Brenda Rivera RECAP,0.9583333333333334
83012,83012,100,0,0,0,0,0,0,0,0,0,0,0,0,0,0,0,n/a,0
83013,83013,100,197,1,0,6,204,197,7,0,0.9656862745098039,0.004901960784313725,0.0,0.029411764705882353,0.9656862745098039,0.03431372549019608,0.0,Brenda Rivera RECAP,0.9656862745098039
83014,83014,100,326,0,0,10,336,326,10,0,0.9702380952380952,0.0,0.0,0.02976190476190476,0.9702380952380952,0.02976190476190476,0.0,Brenda Rivera RECAP,0.9702380952380952
83015,83015,100,201,2,0,5,208,201,7,0,0.9663461538461539,0.009615384615384616,0.0,0.02403846153846154,0.9663461538461539,0.03365384615384615,0.0,Brenda Rivera RECAP,0.9663461538461539
83016,83016,100,198,2,0,6,206,198,8,0,0.9611650485436893,0.009708737864077669,0.0,0.02912621359223301,0.9611650485436893,0.038834951456310676,0.0,Brenda Rivera RECAP,0.9611650485436893
83017,83017,100,170,2,0,2,174,170,4,0,0.9770114942528736,0.011494252873563218,0.0,0.011494252873563218,0.9770114942528736,0.022988505747126436,0.0,Brenda Rivera RECAP,0.9770114942528736
83018,83018,100,189,1,0,0,190,189,1,0,0.9947368421052631,0.005263157894736842,0.0,0.0,0.9947368421052631,0.005263157894736842,0.0,Brenda Rivera RECAP,0.9947368421052631
83019,83019,100,152,1,0,4,157,152,5,0,0.9681528662420382,0.006369426751592357,0.0,0.025477707006369428,0.9681528662420382,0.03184713375796178,0.0,Brenda Rivera RECAP,0.9681528662420382
83020,83020,100,125,0,0,1,126,125,1,0,0.9920634920634921,0.0,0.0,0.007936507936507936,0.9920634920634921,0.007936507936507936,0.0,Brenda Rivera RECAP,0.9920634920634921
83021,83021,100,180,3,1,6,190,180,9,1,0.9473684210526315,0.015789473684210527,0.005263157894736842,0.031578947368421054,0.9473684210526315,0.04736842105263158,0.005263157894736842,Brenda Rivera RECAP,0.9473684210526315
83022,83022,100,150,1,0,4,155,150,5,0,0.967741935483871,0.0064516129032258064,0.0,0.025806451612903226,0.967741935483871,0.03225806451612903,0.0,Brenda Rivera RECAP,0.967741935483871
83023,83023,100,125,1,0,8,134,125,9,0,0.9328358208955224,0.007462686567164179,0.0,0.05970149253731343,0.9328358208955224,0.06716417910447761,0.0,Brenda Rivera RECAP,0.9328358208955224
83024,83024,100,80,1,0,3,84,80,4,0,0.9523809523809523,0.011904761904761904,0.0,0.03571428571428571,0.9523809523809523,0.047619047619047616,0.0,Brenda Rivera RECAP,0.9523809523809523
83025,83025,100,139,1,0,4,144,139,5,0,0.9652777777777778,0.006944444444444444,0.0,0.027777777777777776,0.9652777777777778,0.034722222222222224,0.0,Brenda Rivera RECAP,0.9652777777777778
83026,83026,100,92,1,0,6,99,92,7,0,0.9292929292929293,0.010101010101010102,0.0,0.06060606060606061,0.9292929292929293,0.0707070707070707,0.0,Brenda Rivera RECAP,0.9292929292929293
83027,83027,100,203,2,0,13,218,203,15,0,0.9311926605504587,0.009174311926605505,0.0,0.05963302752293578,0.9311926605504587,0.06880733944954129,0.0,Brenda Rivera RECAP,0.9311926605504587
83028,83028,100,251,1,0,11,263,251,12,0,0.9543726235741445,0.0038022813688212928,0.0,0.04182509505703422,0.9543726235741445,0.045627376425855515,0.0,Brenda Rivera RECAP,0.9543726235741445
83029,83029,100,124,0,0,5,129,124,5,0,0.9612403100775194,0.0,0.0,0.03875968992248062,0.9612403100775194,0.03875968992248062,0.0,Brenda Rivera RECAP,0.9612403100775194
83030,83030,100,169,0,0,8,177,169,8,0,0.9548022598870056,0.0,0.0,0.04519774011299435,0.9548022598870056,0.04519774011299435,0.0,Brenda Rivera RECAP,0.9548022598870056
83031,83031,100,222,0,1,4,227,222,4,1,0.9779735682819384,0.0,0.004405286343612335,0.01762114537444934,0.9779735682819384,0.01762114537444934,0.004405286343612335,Brenda Rivera RECAP,0.9779735682819384
83032,83032,100,165,0,0,5,170,165,5,0,0.9705882352941176,0.0,0.0,0.029411764705882353,0.9705882352941176,0.029411764705882353,0.0,Brenda Rivera RECAP,0.9705882352941176
83033,83033,100,235,1,0,3,239,235,4,0,0.9832635983263598,0.0041841004184100415,0.0,0.012552301255230125,0.9832635983263598,0.016736401673640166,0.0,Brenda Rivera RECAP,0.9832635983263598
83034,83034,100,178,2,0,3,183,178,5,0,0.9726775956284153,0.01092896174863388,0.0,0.01639344262295082,0.9726775956284153,0.0273224043715847,0.0,Brenda Rivera RECAP,0.9726775956284153
83035,83035,100,125,0,0,6,131,125,6,0,0.9541984732824428,0.0,0.0,0.04580152671755725,0.9541984732824428,0.04580152671755725,0.0,Brenda Rivera RECAP,0.9541984732824428
83036,83036,100,97,0,0,13,110,97,13,0,0.8818181818181818,0.0,0.0,0.11818181818181818,0.8818181818181818,0.11818181818181818,0.0,Brenda Rivera RECAP,0.8818181818181818
83037,83037,100,127,1,0,1,129,127,2,0,0.9844961240310077,0.007751937984496124,0.0,0.007751937984496124,0.9844961240310077,0.015503875968992248,0.0,Brenda Rivera RECAP,0.9844961240310077
83038,83038,100,142,2,0,2,146,142,4,0,0.9726027397260274,0.0136986301369863,0.0,0.0136986301369863,0.9726027397260274,0.0273972602739726,0.0,Brenda Rivera RECAP,0.9726027397260274
83039,83039,100,131,0,0,2,133,131,2,0,0.9849624060150376,0.0,0.0,0.015037593984962405,0.9849624060150376,0.015037593984962405,0.0,Brenda Rivera RECAP,0.9849624060150376
83040,83040,100,151,2,0,1,154,151,3,0,0.9805194805194806,0.012987012987012988,0.0,0.006493506493506494,0.9805194805194806,0.01948051948051948,0.0,Brenda Rivera RECAP,0.9805194805194806
83041,83041,100,159,1,0,3,163,159,4,0,0.9754601226993865,0.006134969325153374,0.0,0.018404907975460124,0.9754601226993865,0.024539877300613498,0.0,Brenda Rivera RECAP,0.9754601226993865
83042,83042,100,161,1,1,5,168,161,6,1,0.9583333333333334,0.005952380952380952,0.005952380952380952,0.02976190476190476,0.9583333333333334,0.03571428571428571,0.005952380952380952,Brenda Rivera RECAP,0.9583333333333334
83043,83043,100,157,2,0,0,159,157,2,0,0.9874213836477987,0.012578616352201259,0.0,0.0,0.9874213836477987,0.012578616352201259,0.0,Brenda Rivera RECAP,0.9874213836477987
83044,83044,100,164,0,0,3,167,164,3,0,0.9820359281437125,0.0,0.0,0.017964071856287425,0.9820359281437125,0.017964071856287425,0.0,Brenda Rivera RECAP,0.9820359281437125
83045,83045,100,169,1,0,5,175,169,6,0,0.9657142857142857,0.005714285714285714,0.0,0.02857142857142857,0.9657142857142857,0.03428571428571429,0.0,Brenda Rivera RECAP,0.9657142857142857
83046,83046,100,177,5,0,11,193,177,16,0,0.917098445595855,0.025906735751295335,0.0,0.05699481865284974,0.917098445595855,0.08290155440414508,0.0,Brenda Rivera RECAP,0.917098445595855
83047,83047,100,141,3,0,4,148,141,7,0,0.9527027027027027,0.02027027027027027,0.0,0.02702702702702703,0.9527027027027027,0.0472972972972973,0.0,Brenda Rivera RECAP,0.9527027027027027
83048,83048,100,149,2,0,2,153,149,4,0,0.9738562091503268,0.013071895424836602,0.0,0.013071895424836602,0.9738562091503268,0.026143790849673203,0.0,Brenda Rivera RECAP,0.9738562091503268
83049,83049,100,120,2,0,1,123,120,3,0,0.975609756097561,0.016260162601626018,0.0,0.008130081300813009,0.975609756097561,0.024390243902439025,0.0,Brenda Rivera RECAP,0.975609756097561
83050,83050,100,173,1,0,7,181,173,8,0,0.9558011049723757,0.0055248618784530384,0.0,0.03867403314917127,0.9558011049723757,0.04419889502762431,0.0,Brenda Rivera RECAP,0.9558011049723757
83051,83051,100,173,2,0,5,180,173,7,0,0.9611111111111111,0.011111111111111112,0.0,0.027777777777777776,0.9611111111111111,0.03888888888888889,0.0,Brenda Rivera RECAP,0.9611111111111111
83052,83052,100,183,3,0,4,190,183,7,0,0.9631578947368421,0.015789473684210527,0.0,0.021052631578947368,0.9631578947368421,0.03684210526315789,0.0,Brenda Rivera RECAP,0.9631578947368421
83053,83053,100,145,0,0,2,147,145,2,0,0.9863945578231292,0.0,0.0,0.013605442176870748,0.9863945578231292,0.013605442176870748,0.0,Brenda Rivera RECAP,0.9863945578231292
83054,83054,100,111,1,0,9,121,111,10,0,0.9173553719008265,0.008264462809917356,0.0,0.0743801652892562,0.9173553719008265,0.08264462809917356,0.0,Brenda Rivera RECAP,0.9173553719008265
83055,83055,100,198,2,0,3,203,198,5,0,0.9753694581280788,0.009852216748768473,0.0,0.014778325123152709,0.9753694581280788,0.024630541871921183,0.0,Brenda Rivera RECAP,0.9753694581280788
83056,83056,100,159,0,0,3,162,159,3,0,0.9814814814814815,0.0,0.0,0.018518518518518517,0.9814814814814815,0.018518518518518517,0.0,Brenda Rivera RECAP,0.9814814814814815
83057,83057,100,179,0,0,3,182,179,3,0,0.9835164835164835,0.0,0.0,0.016483516483516484,0.9835164835164835,0.016483516483516484,0.0,Brenda Rivera RECAP,0.9835164835164835
83058,83058,100,100,2,0,2,104,100,4,0,0.9615384615384616,0.019230769230769232,0.0,0.019230769230769232,0.9615384615384616,0.038461538461538464,0.0,Brenda Rivera RECAP,0.9615384615384616
83059,83059,100,158,0,0,2,160,158,2,0,0.9875,0.0,0.0,0.0125,0.9875,0.0125,0.0,Brenda Rivera RECAP,0.9875
83060,83060,100,77,1,0,6,84,77,7,0,0.9166666666666666,0.011904761904761904,0.0,0.07142857142857142,0.9166666666666666,0.08333333333333333,0.0,Brenda Rivera RECAP,0.9166666666666666
83061,83061,100,111,1,0,2,114,111,3,0,0.9736842105263158,0.008771929824561403,0.0,0.017543859649122806,0.9736842105263158,0.02631578947368421,0.0,Brenda Rivera RECAP,0.9736842105263158
83062,83062,100,105,0,0,4,109,105,4,0,0.963302752293578,0.0,0.0,0.03669724770642202,0.963302752293578,0.03669724770642202,0.0,Brenda Rivera RECAP,0.963302752293578
83063,83063,100,93,0,0,3,96,93,3,0,0.96875,0.0,0.0,0.03125,0.96875,0.03125,0.0,Brenda Rivera RECAP,0.96875
83064,83064,100,165,2,0,3,170,165,5,0,0.9705882352941176,0.011764705882352941,0.0,0.01764705882352941,0.9705882352941176,0.029411764705882353,0.0,Brenda Rivera RECAP,0.9705882352941176
83065,83065,100,122,0,0,3,125,122,3,0,0.976,0.0,0.0,0.024,0.976,0.024,0.0,Brenda Rivera RECAP,0.976
83066,83066,100,206,2,0,5,213,206,7,0,0.9671361502347418,0.009389671361502348,0.0,0.023474178403755867,0.9671361502347418,0.03286384976525822,0.0,Brenda Rivera RECAP,0.9671361502347418
83067,83067,100,180,1,1,4,186,180,5,1,0.967741935483871,0.005376344086021506,0.005376344086021506,0.021505376344086023,0.967741935483871,0.026881720430107527,0.005376344086021506,Brenda Rivera RECAP,0.967741935483871
83068,83068,100,0,0,0,0,0,0,0,0,0,0,0,0,0,0,0,n/a,0
83069,83069,100,283,8,0,12,303,283,20,0,0.933993399339934,0.026402640264026403,0.0,0.039603960396039604,0.933993399339934,0.066006600660066,0.0,Brenda Rivera RECAP,0.933993399339934
83070,83070,100,255,0,0,8,263,255,8,0,0.9695817490494296,0.0,0.0,0.030418250950570342,0.9695817490494296,0.030418250950570342,0.0,Brenda Rivera RECAP,0.9695817490494296
83071,83071,100,225,5,0,11,241,225,16,0,0.9336099585062241,0.02074688796680498,0.0,0.04564315352697095,0.9336099585062241,0.06639004149377593,0.0,Brenda Rivera RECAP,0.9336099585062241
83072,83072,100,162,1,0,1,164,162,2,0,0.9878048780487805,0.006097560975609756,0.0,0.006097560975609756,0.9878048780487805,0.012195121951219513,0.0,Brenda Rivera RECAP,0.9878048780487805
83073,83073,100,229,0,0,4,233,229,4,0,0.9828326180257511,0.0,0.0,0.017167381974248927,0.9828326180257511,0.017167381974248927,0.0,Brenda Rivera RECAP,0.9828326180257511
83074,83074,100,199,2,0,10,211,199,12,0,0.943127962085308,0.009478672985781991,0.0,0.04739336492890995,0.943127962085308,0.05687203791469194,0.0,Brenda Rivera RECAP,0.943127962085308
83075,83075,100,232,2,0,5,239,232,7,0,0.9707112970711297,0.008368200836820083,0.0,0.02092050209205021,0.9707112970711297,0.029288702928870293,0.0,Brenda Rivera RECAP,0.9707112970711297
83076,83076,100,210,11,0,11,232,210,22,0,0.9051724137931034,0.04741379310344827,0.0,0.04741379310344827,0.9051724137931034,0.09482758620689655,0.0,Brenda Rivera RECAP,0.9051724137931034
83077,83077,100,159,2,1,3,165,159,5,1,0.9636363636363636,0.012121212121212121,0.006060606060606061,0.01818181818181818,0.9636363636363636,0.030303030303030304,0.006060606060606061,Brenda Rivera RECAP,0.9636363636363636
83078,83078,100,141,0,0,5,146,141,5,0,0.9657534246575342,0.0,0.0,0.03424657534246575,0.9657534246575342,0.03424657534246575,0.0,Brenda Rivera RECAP,0.9657534246575342
83079,83079,100,177,0,0,4,181,177,4,0,0.9779005524861878,0.0,0.0,0.022099447513812154,0.9779005524861878,0.022099447513812154,0.0,Brenda Rivera RECAP,0.9779005524861878
83080,83080,100,182,3,0,3,188,182,6,0,0.9680851063829787,0.015957446808510637,0.0,0.015957446808510637,0.9680851063829787,0.031914893617021274,0.0,Brenda Rivera RECAP,0.9680851063829787
83081,83081,100,195,1,0,5,201,195,6,0,0.9701492537313433,0.004975124378109453,0.0,0.024875621890547265,0.9701492537313433,0.029850746268656716,0.0,Brenda Rivera RECAP,0.9701492537313433
83082,83082,100,199,1,1,7,208,199,8,1,0.9567307692307693,0.004807692307692308,0.004807692307692308,0.03365384615384615,0.9567307692307693,0.038461538461538464,0.004807692307692308,Brenda Rivera RECAP,0.9567307692307693
83083,83083,100,161,2,0,6,169,161,8,0,0.9526627218934911,0.011834319526627219,0.0,0.03550295857988166,0.9526627218934911,0.047337278106508875,0.0,Brenda Rivera RECAP,0.9526627218934911
83084,83084,100,26,0,0,1,27,26,1,0,0.9629629629629629,0.0,0.0,0.037037037037037035,0.9629629629629629,0.037037037037037035,0.0,Brenda Rivera RECAP,0.9629629629629629
83085,83085,100,99,0,0,5,104,99,5,0,0.9519230769230769,0.0,0.0,0.04807692307692308,0.9519230769230769,0.04807692307692308,0.0,Brenda Rivera RECAP,0.9519230769230769
83086,83086,100,86,2,0,3,91,86,5,0,0.945054945054945,0.02197802197802198,0.0,0.03296703296703297,0.945054945054945,0.054945054945054944,0.0,Brenda Rivera RECAP,0.945054945054945
83087,83068,100,0,0,0,0,0,0,0,0,0,0,0,0,0,0,0,n/a,0
84001,84001,100,127,2,0,6,135,127,8,0,0.9407407407407408,0.014814814814814815,0.0,0.044444444444444446,0.9407407407407408,0.05925925925925926,0.0,Brenda Rivera RECAP,0.9407407407407408
84002,84002,100,30,0,0,1,31,30,1,0,0.967741935483871,0.0,0.0,0.03225806451612903,0.967741935483871,0.03225806451612903,0.0,Brenda Rivera RECAP,0.967741935483871
84003,84003,100,162,0,1,4,167,162,4,1,0.9700598802395209,0.0,0.005988023952095809,0.023952095808383235,0.9700598802395209,0.023952095808383235,0.005988023952095809,Brenda Rivera RECAP,0.9700598802395209
84004,84004,100,153,1,0,5,159,153,6,0,0.9622641509433962,0.006289308176100629,0.0,0.031446540880503145,0.9622641509433962,0.03773584905660377,0.0,Brenda Rivera RECAP,0.9622641509433962
84005,84005,100,192,1,0,8,201,192,9,0,0.9552238805970149,0.004975124378109453,0.0,0.03980099502487562,0.9552238805970149,0.04477611940298507,0.0,Brenda Rivera RECAP,0.9552238805970149
84006,84006,100,218,0,0,13,231,218,13,0,0.9437229437229437,0.0,0.0,0.05627705627705628,0.9437229437229437,0.05627705627705628,0.0,Brenda Rivera RECAP,0.9437229437229437
84007,84007,100,144,1,0,5,150,144,6,0,0.96,0.006666666666666667,0.0,0.03333333333333333,0.96,0.04,0.0,Brenda Rivera RECAP,0.96
84008,84008,100,176,2,0,10,188,176,12,0,0.9361702127659575,0.010638297872340425,0.0,0.05319148936170213,0.9361702127659575,0.06382978723404255,0.0,Brenda Rivera RECAP,0.9361702127659575
84009,84009,100,118,3,0,4,125,118,7,0,0.944,0.024,0.0,0.032,0.944,0.056,0.0,Brenda Rivera RECAP,0.944
84010,84010,100,189,0,0,5,194,189,5,0,0.9742268041237113,0.0,0.0,0.02577319587628866,0.9742268041237113,0.02577319587628866,0.0,Brenda Rivera RECAP,0.9742268041237113
84011,84011,100,163,1,0,3,167,163,4,0,0.9760479041916168,0.005988023952095809,0.0,0.017964071856287425,0.9760479041916168,0.023952095808383235,0.0,Brenda Rivera RECAP,0.9760479041916168
84012,84012,100,60,1,0,1,62,60,2,0,0.967741935483871,0.016129032258064516,0.0,0.016129032258064516,0.967741935483871,0.03225806451612903,0.0,Brenda Rivera RECAP,0.967741935483871
84013,84013,100,197,3,0,6,206,197,9,0,0.9563106796116505,0.014563106796116505,0.0,0.02912621359223301,0.9563106796116505,0.043689320388349516,0.0,Brenda Rivera RECAP,0.9563106796116505
84014,84014,100,136,4,1,7,148,136,11,1,0.918918918918919,0.02702702702702703,0.006756756756756757,0.0472972972972973,0.918918918918919,0.07432432432432433,0.006756756756756757,Brenda Rivera RECAP,0.918918918918919
84015,84015,100,79,1,0,3,83,79,4,0,0.9518072289156626,0.012048192771084338,0.0,0.03614457831325301,0.9518072289156626,0.04819277108433735,0.0,Brenda Rivera RECAP,0.9518072289156626
84016,84016,100,174,1,0,6,181,174,7,0,0.9613259668508287,0.0055248618784530384,0.0,0.03314917127071823,0.9613259668508287,0.03867403314917127,0.0,Brenda Rivera RECAP,0.9613259668508287
84017,84017,100,56,3,0,3,62,56,6,0,0.9032258064516129,0.04838709677419355,0.0,0.04838709677419355,0.9032258064516129,0.0967741935483871,0.0,Brenda Rivera RECAP,0.9032258064516129
84018,84018,100,9,0,0,0,9,9,0,0,1.0,0.0,0.0,0.0,1.0,0.0,0.0,Brenda Rivera RECAP,1.0
84019,84019,100,193,1,0,2,196,193,3,0,0.9846938775510204,0.00510204081632653,0.0,0.01020408163265306,0.9846938775510204,0.015306122448979591,0.0,Brenda Rivera RECAP,0.9846938775510204
84020,84020,100,80,2,0,6,88,80,8,0,0.9090909090909091,0.022727272727272728,0.0,0.06818181818181818,0.9090909090909091,0.09090909090909091,0.0,Brenda Rivera RECAP,0.9090909090909091
84021,84021,100,21,0,0,0,21,21,0,0,1.0,0.0,0.0,0.0,1.0,0.0,0.0,Brenda Rivera RECAP,1.0
84022,84022,100,37,1,0,1,39,37,2,0,0.9487179487179487,0.02564102564102564,0.0,0.02564102564102564,0.9487179487179487,0.05128205128205128,0.0,Brenda Rivera RECAP,0.9487179487179487
84023,84023,100,163,1,0,6,170,163,7,0,0.9588235294117647,0.0058823529411764705,0.0,0.03529411764705882,0.9588235294117647,0.041176470588235294,0.0,Brenda Rivera RECAP,0.9588235294117647
84024,84024,100,162,3,0,10,175,162,13,0,0.9257142857142857,0.017142857142857144,0.0,0.05714285714285714,0.9257142857142857,0.07428571428571429,0.0,Brenda Rivera RECAP,0.9257142857142857
84025,84025,100,86,1,5,5,97,86,6,5,0.8865979381443299,0.010309278350515464,0.05154639175257732,0.05154639175257732,0.8865979381443299,0.061855670103092786,0.05154639175257732,Brenda Rivera RECAP,0.8865979381443299
84026,84026,100,35,0,0,2,37,35,2,0,0.9459459459459459,0.0,0.0,0.05405405405405406,0.9459459459459459,0.05405405405405406,0.0,Brenda Rivera RECAP,0.9459459459459459
84027,84027,100,99,0,0,4,103,99,4,0,0.9611650485436893,0.0,0.0,0.038834951456310676,0.9611650485436893,0.038834951456310676,0.0,Brenda Rivera RECAP,0.9611650485436893
84028,84028,100,165,0,0,11,176,165,11,0,0.9375,0.0,0.0,0.0625,0.9375,0.0625,0.0,Brenda Rivera RECAP,0.9375
84029,84029,100,90,0,0,2,92,90,2,0,0.9782608695652174,0.0,0.0,0.021739130434782608,0.9782608695652174,0.021739130434782608,0.0,Brenda Rivera RECAP,0.9782608695652174
84030,84030,100,82,1,0,1,84,82,2,0,0.9761904761904762,0.011904761904761904,0.0,0.011904761904761904,0.9761904761904762,0.023809523809523808,0.0,Brenda Rivera RECAP,0.9761904761904762
84031,84031,100,76,0,0,2,78,76,2,0,0.9743589743589743,0.0,0.0,0.02564102564102564,0.9743589743589743,0.02564102564102564,0.0,Brenda Rivera RECAP,0.9743589743589743
84032,84032,100,51,0,0,0,51,51,0,0,1.0,0.0,0.0,0.0,1.0,0.0,0.0,Brenda Rivera RECAP,1.0
84033,84033,100,85,0,0,7,92,85,7,0,0.9239130434782609,0.0,0.0,0.07608695652173914,0.9239130434782609,0.07608695652173914,0.0,Brenda Rivera RECAP,0.9239130434782609
84034,84034,100,223,6,0,5,234,223,11,0,0.9529914529914529,0.02564102564102564,0.0,0.021367521367521368,0.9529914529914529,0.04700854700854701,0.0,Brenda Rivera RECAP,0.9529914529914529
84035,84035,100,106,7,0,6,119,106,13,0,0.8907563025210085,0.058823529411764705,0.0,0.05042016806722689,0.8907563025210085,0.1092436974789916,0.0,Brenda Rivera RECAP,0.8907563025210085
84036,84036,100,36,0,0,4,40,36,4,0,0.9,0.0,0.0,0.1,0.9,0.1,0.0,Brenda Rivera RECAP,0.9
84037,84037,100,113,0,0,2,115,113,2,0,0.9826086956521739,0.0,0.0,0.017391304347826087,0.9826086956521739,0.017391304347826087,0.0,Brenda Rivera RECAP,0.9826086956521739
84038,84038,100,114,2,0,8,124,114,10,0,0.9193548387096774,0.016129032258064516,0.0,0.06451612903225806,0.9193548387096774,0.08064516129032258,0.0,Brenda Rivera RECAP,0.9193548387096774
84039,84039,100,150,3,0,4,157,150,7,0,0.9554140127388535,0.01910828025477707,0.0,0.025477707006369428,0.9554140127388535,0.044585987261146494,0.0,Brenda Rivera RECAP,0.9554140127388535
84040,84040,100,145,1,0,8,154,145,9,0,0.9415584415584416,0.006493506493506494,0.0,0.05194805194805195,0.9415584415584416,0.05844155844155844,0.0,Brenda Rivera RECAP,0.9415584415584416
84041,84041,100,125,1,0,11,137,125,12,0,0.9124087591240876,0.0072992700729927005,0.0,0.08029197080291971,0.9124087591240876,0.08759124087591241,0.0,Brenda Rivera RECAP,0.9124087591240876
84042,84042,100,159,1,0,6,166,159,7,0,0.9578313253012049,0.006024096385542169,0.0,0.03614457831325301,0.9578313253012049,0.04216867469879518,0.0,Brenda Rivera RECAP,0.9578313253012049
84043,84043,100,131,2,0,7,140,131,9,0,0.9357142857142857,0.014285714285714285,0.0,0.05,0.9357142857142857,0.06428571428571428,0.0,Brenda Rivera RECAP,0.9357142857142857
84044,84044,100,105,0,0,3,108,105,3,0,0.9722222222222222,0.0,0.0,0.027777777777777776,0.9722222222222222,0.027777777777777776,0.0,Brenda Rivera RECAP,0.9722222222222222
84045,84045,100,81,0,1,3,85,81,3,1,0.9529411764705882,0.0,0.011764705882352941,0.03529411764705882,0.9529411764705882,0.03529411764705882,0.011764705882352941,Brenda Rivera RECAP,0.9529411764705882
84046,84046,100,113,2,0,5,120,113,7,0,0.9416666666666667,0.016666666666666666,0.0,0.041666666666666664,0.9416666666666667,0.058333333333333334,0.0,Brenda Rivera RECAP,0.9416666666666667
84047,84047,100,35,0,0,3,38,35,3,0,0.9210526315789473,0.0,0.0,0.07894736842105263,0.9210526315789473,0.07894736842105263,0.0,Brenda Rivera RECAP,0.9210526315789473
84048,84048,100,113,3,0,7,123,113,10,0,0.9186991869918699,0.024390243902439025,0.0,0.056910569105691054,0.9186991869918699,0.08130081300813008,0.0,Brenda Rivera RECAP,0.9186991869918699
84049,84049,100,43,0,0,5,48,43,5,0,0.8958333333333334,0.0,0.0,0.10416666666666667,0.8958333333333334,0.10416666666666667,0.0,Brenda Rivera RECAP,0.8958333333333334
84050,84050,100,76,0,0,3,79,76,3,0,0.9620253164556962,0.0,0.0,0.0379746835443038,0.9620253164556962,0.0379746835443038,0.0,Brenda Rivera RECAP,0.9620253164556962
84051,84051,100,154,2,0,12,168,154,14,0,0.9166666666666666,0.011904761904761904,0.0,0.07142857142857142,0.9166666666666666,0.08333333333333333,0.0,Brenda Rivera RECAP,0.9166666666666666
84052,84052,100,142,4,0,7,153,142,11,0,0.9281045751633987,0.026143790849673203,0.0,0.0457516339869281,0.9281045751633987,0.0718954248366013,0.0,Brenda Rivera RECAP,0.9281045751633987
84053,84053,100,0,0,0,0,0,0,0,0,0,0,0,0,0,0,0,n/a,0
84054,84054,100,123,1,0,7,131,123,8,0,0.9389312977099237,0.007633587786259542,0.0,0.05343511450381679,0.9389312977099237,0.061068702290076333,0.0,Brenda Rivera RECAP,0.9389312977099237
84055,84055,100,126,2,0,7,135,126,9,0,0.9333333333333333,0.014814814814814815,0.0,0.05185185185185185,0.9333333333333333,0.06666666666666667,0.0,Brenda Rivera RECAP,0.9333333333333333
84056,84056,100,128,2,0,4,134,128,6,0,0.9552238805970149,0.014925373134328358,0.0,0.029850746268656716,0.9552238805970149,0.04477611940298507,0.0,Brenda Rivera RECAP,0.9552238805970149
84057,84057,100,120,2,1,3,126,120,5,1,0.9523809523809523,0.015873015873015872,0.007936507936507936,0.023809523809523808,0.9523809523809523,0.03968253968253968,0.007936507936507936,Brenda Rivera RECAP,0.9523809523809523
84058,84058,100,118,2,0,8,128,118,10,0,0.921875,0.015625,0.0,0.0625,0.921875,0.078125,0.0,Brenda Rivera RECAP,0.921875
84059,84059,100,155,2,0,6,163,155,8,0,0.950920245398773,0.012269938650306749,0.0,0.03680981595092025,0.950920245398773,0.049079754601226995,0.0,Brenda Rivera RECAP,0.950920245398773
84060,84060,100,84,1,0,2,87,84,3,0,0.9655172413793104,0.011494252873563218,0.0,0.022988505747126436,0.9655172413793104,0.034482758620689655,0.0,Brenda Rivera RECAP,0.9655172413793104
84061,84061,100,135,0,0,2,137,135,2,0,0.9854014598540146,0.0,0.0,0.014598540145985401,0.9854014598540146,0.014598540145985401,0.0,Brenda Rivera RECAP,0.9854014598540146
84062,84062,100,112,0,0,11,123,112,11,0,0.9105691056910569,0.0,0.0,0.08943089430894309,0.9105691056910569,0.08943089430894309,0.0,Brenda Rivera RECAP,0.9105691056910569
84063,84063,100,123,0,0,3,126,123,3,0,0.9761904761904762,0.0,0.0,0.023809523809523808,0.9761904761904762,0.023809523809523808,0.0,Brenda Rivera RECAP,0.9761904761904762
84064,84064,100,132,2,0,9,143,132,11,0,0.9230769230769231,0.013986013986013986,0.0,0.06293706293706294,0.9230769230769231,0.07692307692307693,0.0,Brenda Rivera RECAP,0.9230769230769231
84065,84065,100,91,0,0,4,95,91,4,0,0.9578947368421052,0.0,0.0,0.042105263157894736,0.9578947368421052,0.042105263157894736,0.0,Brenda Rivera RECAP,0.9578947368421052
84066,84066,100,106,0,0,4,110,106,4,0,0.9636363636363636,0.0,0.0,0.03636363636363636,0.9636363636363636,0.03636363636363636,0.0,Brenda Rivera RECAP,0.9636363636363636
84067,84067,100,108,0,1,4,113,108,4,1,0.9557522123893806,0.0,0.008849557522123894,0.035398230088495575,0.9557522123893806,0.035398230088495575,0.008849557522123894,Brenda Rivera RECAP,0.9557522123893806
84068,84068,100,96,0,0,2,98,96,2,0,0.9795918367346939,0.0,0.0,0.02040816326530612,0.9795918367346939,0.02040816326530612,0.0,Brenda Rivera RECAP,0.9795918367346939
84069,84069,100,49,0,0,5,54,49,5,0,0.9074074074074074,0.0,0.0,0.09259259259259259,0.9074074074074074,0.09259259259259259,0.0,Brenda Rivera RECAP,0.9074074074074074
84070,84070,100,49,0,0,3,52,49,3,0,0.9423076923076923,0.0,0.0,0.057692307692307696,0.9423076923076923,0.057692307692307696,0.0,Brenda Rivera RECAP,0.9423076923076923
84071,84071,100,130,3,0,9,142,130,12,0,0.9154929577464789,0.02112676056338028,0.0,0.06338028169014084,0.9154929577464789,0.08450704225352113,0.0,Brenda Rivera RECAP,0.9154929577464789
84072,84072,100,153,4,0,6,163,153,10,0,0.9386503067484663,0.024539877300613498,0.0,0.03680981595092025,0.9386503067484663,0.06134969325153374,0.0,Brenda Rivera RECAP,0.9386503067484663
84073,84073,100,37,0,0,1,38,37,1,0,0.9736842105263158,0.0,0.0,0.02631578947368421,0.9736842105263158,0.02631578947368421,0.0,Brenda Rivera RECAP,0.9736842105263158
84074,84074,100,119,1,0,14,134,119,15,0,0.8880597014925373,0.007462686567164179,0.0,0.1044776119402985,0.8880597014925373,0.11194029850746269,0.0,Brenda Rivera RECAP,0.8880597014925373
84075,84075,100,132,1,0,3,136,132,4,0,0.9705882352941176,0.007352941176470588,0.0,0.022058823529411766,0.9705882352941176,0.029411764705882353,0.0,Brenda Rivera RECAP,0.9705882352941176
84076,84076,100,13,0,0,0,13,13,0,0,1.0,0.0,0.0,0.0,1.0,0.0,0.0,Brenda Rivera RECAP,1.0
84077,84077,100,100,0,0,4,104,100,4,0,0.9615384615384616,0.0,0.0,0.038461538461538464,0.9615384615384616,0.038461538461538464,0.0,Brenda Rivera RECAP,0.9615384615384616
84078,84078,100,29,0,0,1,30,29,1,0,0.9666666666666667,0.0,0.0,0.03333333333333333,0.9666666666666667,0.03333333333333333,0.0,Brenda Rivera RECAP,0.9666666666666667
84079,84079,100,1,0,0,0,1,1,0,0,1.0,0.0,0.0,0.0,1.0,0.0,0.0,Brenda Rivera RECAP,1.0
84080,84080,100,180,2,0,5,187,180,7,0,0.9625668449197861,0.0106951871657754,0.0,0.026737967914438502,0.9625668449197861,0.0374331550802139,0.0,Brenda Rivera RECAP,0.9625668449197861
84081,84053,100,0,0,0,0,0,0,0,0,0,0,0,0,0,0,0,n/a,0
85001,85001,100,189,0,1,4,194,189,4,1,0.9742268041237113,0.0,0.005154639175257732,0.020618556701030927,0.9742268041237113,0.020618556701030927,0.005154639175257732,Brenda Rivera RECAP,0.9742268041237113
85002,85002,100,150,5,0,11,166,150,16,0,0.9036144578313253,0.030120481927710843,0.0,0.06626506024096386,0.9036144578313253,0.0963855421686747,0.0,Brenda Rivera RECAP,0.9036144578313253
85003,85003,100,195,4,0,16,215,195,20,0,0.9069767441860465,0.018604651162790697,0.0,0.07441860465116279,0.9069767441860465,0.09302325581395349,0.0,Brenda Rivera RECAP,0.9069767441860465
85004,85004,100,98,3,0,9,110,98,12,0,0.8909090909090909,0.02727272727272727,0.0,0.08181818181818182,0.8909090909090909,0.10909090909090909,0.0,Brenda Rivera RECAP,0.8909090909090909
85005,85005,100,172,0,1,7,180,172,7,1,0.9555555555555556,0.0,0.005555555555555556,0.03888888888888889,0.9555555555555556,0.03888888888888889,0.005555555555555556,Brenda Rivera RECAP,0.9555555555555556
85006,85006,100,71,3,0,2,76,71,5,0,0.9342105263157895,0.039473684210526314,0.0,0.02631578947368421,0.9342105263157895,0.06578947368421052,0.0,Brenda Rivera RECAP,0.9342105263157895
85007,85007,100,121,1,0,8,130,121,9,0,0.9307692307692308,0.007692307692307693,0.0,0.06153846153846154,0.9307692307692308,0.06923076923076923,0.0,Brenda Rivera RECAP,0.9307692307692308
85008,85008,100,152,1,1,16,170,152,17,1,0.8941176470588236,0.0058823529411764705,0.0058823529411764705,0.09411764705882353,0.8941176470588236,0.1,0.0058823529411764705,Brenda Rivera RECAP,0.8941176470588236
85009,85009,100,101,1,0,2,104,101,3,0,0.9711538461538461,0.009615384615384616,0.0,0.019230769230769232,0.9711538461538461,0.028846153846153848,0.0,Brenda Rivera RECAP,0.9711538461538461
85010,85010,100,122,0,0,5,127,122,5,0,0.9606299212598425,0.0,0.0,0.03937007874015748,0.9606299212598425,0.03937007874015748,0.0,Brenda Rivera RECAP,0.9606299212598425
85011,85011,100,165,1,0,1,167,165,2,0,0.9880239520958084,0.005988023952095809,0.0,0.005988023952095809,0.9880239520958084,0.011976047904191617,0.0,Brenda Rivera RECAP,0.9880239520958084
85012,85012,100,172,2,1,4,179,172,6,1,0.9608938547486033,0.0111731843575419,0.00558659217877095,0.0223463687150838,0.9608938547486033,0.0335195530726257,0.00558659217877095,Brenda Rivera RECAP,0.9608938547486033
85013,85013,100,230,2,0,1,233,230,3,0,0.9871244635193133,0.008583690987124463,0.0,0.004291845493562232,0.9871244635193133,0.012875536480686695,0.0,Brenda Rivera RECAP,0.9871244635193133
85014,85014,100,78,2,0,4,84,78,6,0,0.9285714285714286,0.023809523809523808,0.0,0.047619047619047616,0.9285714285714286,0.07142857142857142,0.0,Brenda Rivera RECAP,0.9285714285714286
85015,85015,100,100,1,0,3,104,100,4,0,0.9615384615384616,0.009615384615384616,0.0,0.028846153846153848,0.9615384615384616,0.038461538461538464,0.0,Brenda Rivera RECAP,0.9615384615384616
85016,85016,100,74,0,0,1,75,74,1,0,0.9866666666666667,0.0,0.0,0.013333333333333334,0.9866666666666667,0.013333333333333334,0.0,Brenda Rivera RECAP,0.9866666666666667
85017,85017,100,128,0,0,2,130,128,2,0,0.9846153846153847,0.0,0.0,0.015384615384615385,0.9846153846153847,0.015384615384615385,0.0,Brenda Rivera RECAP,0.9846153846153847
85018,85018,100,12,1,0,1,14,12,2,0,0.8571428571428571,0.07142857142857142,0.0,0.07142857142857142,0.8571428571428571,0.14285714285714285,0.0,Brenda Rivera RECAP,0.8571428571428571
85019,85019,100,303,2,0,3,308,303,5,0,0.9837662337662337,0.006493506493506494,0.0,0.00974025974025974,0.9837662337662337,0.016233766233766232,0.0,Brenda Rivera RECAP,0.9837662337662337
85020,85020,100,234,2,0,5,241,234,7,0,0.970954356846473,0.008298755186721992,0.0,0.02074688796680498,0.970954356846473,0.029045643153526972,0.0,Brenda Rivera RECAP,0.970954356846473
85021,85021,100,203,0,0,4,207,203,4,0,0.9806763285024155,0.0,0.0,0.01932367149758454,0.9806763285024155,0.01932367149758454,0.0,Brenda Rivera RECAP,0.9806763285024155
85022,85022,100,90,1,0,5,96,90,6,0,0.9375,0.010416666666666666,0.0,0.052083333333333336,0.9375,0.0625,0.0,Brenda Rivera RECAP,0.9375
85023,85023,100,90,0,0,2,92,90,2,0,0.9782608695652174,0.0,0.0,0.021739130434782608,0.9782608695652174,0.021739130434782608,0.0,Brenda Rivera RECAP,0.9782608695652174
85024,85024,100,213,1,0,4,218,213,5,0,0.9770642201834863,0.0045871559633027525,0.0,0.01834862385321101,0.9770642201834863,0.022935779816513763,0.0,Brenda Rivera RECAP,0.9770642201834863
85025,85025,100,218,2,0,1,221,218,3,0,0.9864253393665159,0.00904977375565611,0.0,0.004524886877828055,0.9864253393665159,0.013574660633484163,0.0,Brenda Rivera RECAP,0.9864253393665159
85026,85026,100,152,1,0,5,158,152,6,0,0.9620253164556962,0.006329113924050633,0.0,0.03164556962025317,0.9620253164556962,0.0379746835443038,0.0,Brenda Rivera RECAP,0.9620253164556962
85027,85027,100,58,1,0,0,59,58,1,0,0.9830508474576272,0.01694915254237288,0.0,0.0,0.9830508474576272,0.01694915254237288,0.0,Brenda Rivera RECAP,0.9830508474576272
85028,85028,100,10,0,0,0,10,10,0,0,1.0,0.0,0.0,0.0,1.0,0.0,0.0,Brenda Rivera RECAP,1.0
85029,85029,100,90,1,0,2,93,90,3,0,0.967741935483871,0.010752688172043012,0.0,0.021505376344086023,0.967741935483871,0.03225806451612903,0.0,Brenda Rivera RECAP,0.967741935483871
85030,85030,100,132,1,0,4,137,132,5,0,0.9635036496350365,0.0072992700729927005,0.0,0.029197080291970802,0.9635036496350365,0.0364963503649635,0.0,Brenda Rivera RECAP,0.9635036496350365
85031,85031,100,152,1,0,5,158,152,6,0,0.9620253164556962,0.006329113924050633,0.0,0.03164556962025317,0.9620253164556962,0.0379746835443038,0.0,Brenda Rivera RECAP,0.9620253164556962
85032,85032,100,175,1,0,9,185,175,10,0,0.9459459459459459,0.005405405405405406,0.0,0.04864864864864865,0.9459459459459459,0.05405405405405406,0.0,Brenda Rivera RECAP,0.9459459459459459
85033,85033,100,161,5,0,4,170,161,9,0,0.9470588235294117,0.029411764705882353,0.0,0.023529411764705882,0.9470588235294117,0.052941176470588235,0.0,Brenda Rivera RECAP,0.9470588235294117
85034,85034,100,139,2,0,10,151,139,12,0,0.9205298013245033,0.013245033112582781,0.0,0.06622516556291391,0.9205298013245033,0.07947019867549669,0.0,Brenda Rivera RECAP,0.9205298013245033
85035,85035,100,0,0,0,0,0,0,0,0,0,0,0,0,0,0,0,n/a,0
85036,85036,100,34,0,0,2,36,34,2,0,0.9444444444444444,0.0,0.0,0.05555555555555555,0.9444444444444444,0.05555555555555555,0.0,Brenda Rivera RECAP,0.9444444444444444
85037,85037,100,206,2,0,3,211,206,5,0,0.976303317535545,0.009478672985781991,0.0,0.014218009478672985,0.976303317535545,0.023696682464454975,0.0,Brenda Rivera RECAP,0.976303317535545
85038,85038,100,72,0,0,6,78,72,6,0,0.9230769230769231,0.0,0.0,0.07692307692307693,0.9230769230769231,0.07692307692307693,0.0,Brenda Rivera RECAP,0.9230769230769231
85039,85039,100,133,0,0,6,139,133,6,0,0.9568345323741008,0.0,0.0,0.04316546762589928,0.9568345323741008,0.04316546762589928,0.0,Brenda Rivera RECAP,0.9568345323741008
85040,85040,100,64,1,0,2,67,64,3,0,0.9552238805970149,0.014925373134328358,0.0,0.029850746268656716,0.9552238805970149,0.04477611940298507,0.0,Brenda Rivera RECAP,0.9552238805970149
85041,85041,100,154,6,0,10,170,154,16,0,0.9058823529411765,0.03529411764705882,0.0,0.058823529411764705,0.9058823529411765,0.09411764705882353,0.0,Brenda Rivera RECAP,0.9058823529411765
85042,85042,100,136,2,0,4,142,136,6,0,0.9577464788732394,0.014084507042253521,0.0,0.028169014084507043,0.9577464788732394,0.04225352112676056,0.0,Brenda Rivera RECAP,0.9577464788732394
85043,85043,100,82,0,0,6,88,82,6,0,0.9318181818181818,0.0,0.0,0.06818181818181818,0.9318181818181818,0.06818181818181818,0.0,Brenda Rivera RECAP,0.9318181818181818
85044,85044,100,129,1,0,7,137,129,8,0,0.9416058394160584,0.0072992700729927005,0.0,0.051094890510948905,0.9416058394160584,0.058394160583941604,0.0,Brenda Rivera RECAP,0.9416058394160584
85045,85045,100,152,0,0,5,157,152,5,0,0.9681528662420382,0.0,0.0,0.03184713375796178,0.9681528662420382,0.03184713375796178,0.0,Brenda Rivera RECAP,0.9681528662420382
85046,85046,100,183,2,0,10,195,183,12,0,0.9384615384615385,0.010256410256410256,0.0,0.05128205128205128,0.9384615384615385,0.06153846153846154,0.0,Brenda Rivera RECAP,0.9384615384615385
85047,85047,100,120,1,0,2,123,120,3,0,0.975609756097561,0.008130081300813009,0.0,0.016260162601626018,0.975609756097561,0.024390243902439025,0.0,Brenda Rivera RECAP,0.975609756097561
85048,85048,100,130,0,0,4,134,130,4,0,0.9701492537313433,0.0,0.0,0.029850746268656716,0.9701492537313433,0.029850746268656716,0.0,Brenda Rivera RECAP,0.9701492537313433
85049,85049,100,154,0,0,7,161,154,7,0,0.9565217391304348,0.0,0.0,0.043478260869565216,0.9565217391304348,0.043478260869565216,0.0,Brenda Rivera RECAP,0.9565217391304348
85050,85050,100,158,2,0,7,167,158,9,0,0.9461077844311377,0.011976047904191617,0.0,0.041916167664670656,0.9461077844311377,0.05389221556886228,0.0,Brenda Rivera RECAP,0.9461077844311377
85051,85051,100,108,0,0,4,112,108,4,0,0.9642857142857143,0.0,0.0,0.03571428571428571,0.9642857142857143,0.03571428571428571,0.0,Brenda Rivera RECAP,0.9642857142857143
85052,85052,100,104,0,0,2,106,104,2,0,0.9811320754716981,0.0,0.0,0.018867924528301886,0.9811320754716981,0.018867924528301886,0.0,Brenda Rivera RECAP,0.9811320754716981
85053,85053,100,130,4,0,7,141,130,11,0,0.9219858156028369,0.028368794326241134,0.0,0.04964539007092199,0.9219858156028369,0.07801418439716312,0.0,Brenda Rivera RECAP,0.9219858156028369
85054,85054,100,132,1,0,10,143,132,11,0,0.9230769230769231,0.006993006993006993,0.0,0.06993006993006994,0.9230769230769231,0.07692307692307693,0.0,Brenda Rivera RECAP,0.9230769230769231
85055,85055,100,142,0,0,9,151,142,9,0,0.9403973509933775,0.0,0.0,0.059602649006622516,0.9403973509933775,0.059602649006622516,0.0,Brenda Rivera RECAP,0.9403973509933775
85056,85056,100,64,0,0,4,68,64,4,0,0.9411764705882353,0.0,0.0,0.058823529411764705,0.9411764705882353,0.058823529411764705,0.0,Brenda Rivera RECAP,0.9411764705882353
85057,85057,100,84,0,0,3,87,84,3,0,0.9655172413793104,0.0,0.0,0.034482758620689655,0.9655172413793104,0.034482758620689655,0.0,Brenda Rivera RECAP,0.9655172413793104
85058,85058,100,142,2,0,6,150,142,8,0,0.9466666666666667,0.013333333333333334,0.0,0.04,0.9466666666666667,0.05333333333333334,0.0,Brenda Rivera RECAP,0.9466666666666667
85059,85059,100,162,0,1,13,176,162,13,1,0.9204545454545454,0.0,0.005681818181818182,0.07386363636363637,0.9204545454545454,0.07386363636363637,0.005681818181818182,Brenda Rivera RECAP,0.9204545454545454
85060,85060,100,198,1,0,5,204,198,6,0,0.9705882352941176,0.004901960784313725,0.0,0.024509803921568627,0.9705882352941176,0.029411764705882353,0.0,Brenda Rivera RECAP,0.9705882352941176
85061,85061,100,75,0,0,3,78,75,3,0,0.9615384615384616,0.0,0.0,0.038461538461538464,0.9615384615384616,0.038461538461538464,0.0,Brenda Rivera RECAP,0.9615384615384616
85062,85062,100,122,1,0,5,128,122,6,0,0.953125,0.0078125,0.0,0.0390625,0.953125,0.046875,0.0,Brenda Rivera RECAP,0.953125
85063,85063,100,127,0,0,5,132,127,5,0,0.9621212121212122,0.0,0.0,0.03787878787878788,0.9621212121212122,0.03787878787878788,0.0,Brenda Rivera RECAP,0.9621212121212122
85064,85064,100,123,0,0,8,131,123,8,0,0.9389312977099237,0.0,0.0,0.061068702290076333,0.9389312977099237,0.061068702290076333,0.0,Brenda Rivera RECAP,0.9389312977099237
85065,85065,100,150,2,0,2,154,150,4,0,0.974025974025974,0.012987012987012988,0.0,0.012987012987012988,0.974025974025974,0.025974025974025976,0.0,Brenda Rivera RECAP,0.974025974025974
85066,85066,100,146,1,0,12,159,146,13,0,0.9182389937106918,0.006289308176100629,0.0,0.07547169811320754,0.9182389937106918,0.08176100628930817,0.0,Brenda Rivera RECAP,0.9182389937106918
85067,85067,100,110,3,0,7,120,110,10,0,0.9166666666666666,0.025,0.0,0.058333333333333334,0.9166666666666666,0.08333333333333333,0.0,Brenda Rivera RECAP,0.9166666666666666
85068,85068,100,189,1,0,14,204,189,15,0,0.9264705882352942,0.004901960784313725,0.0,0.06862745098039216,0.9264705882352942,0.07352941176470588,0.0,Brenda Rivera RECAP,0.9264705882352942
85069,85069,100,134,1,0,3,138,134,4,0,0.9710144927536232,0.007246376811594203,0.0,0.021739130434782608,0.9710144927536232,0.028985507246376812,0.0,Brenda Rivera RECAP,0.9710144927536232
85070,85070,100,103,1,0,3,107,103,4,0,0.9626168224299065,0.009345794392523364,0.0,0.028037383177570093,0.9626168224299065,0.037383177570093455,0.0,Brenda Rivera RECAP,0.9626168224299065
85071,85071,100,0,0,0,0,0,0,0,0,0,0,0,0,0,0,0,n/a,0
85072,85072,100,0,0,0,0,0,0,0,0,0,0,0,0,0,0,0,n/a,0
85073,85072,100,0,0,0,0,0,0,0,0,0,0,0,0,0,0,0,n/a,0
85074,85072,100,0,0,0,0,0,0,0,0,0,0,0,0,0,0,0,n/a,0
85075,85072,100,0,0,0,0,0,0,0,0,0,0,0,0,0,0,0,n/a,0
85076,85076,100,0,0,0,0,0,0,0,0,0,0,0,0,0,0,0,n/a,0
85077,85072,100,0,0,0,0,0,0,0,0,0,0,0,0,0,0,0,n/a,0
85078,85072,100,0,0,0,0,0,0,0,0,0,0,0,0,0,0,0,n/a,0
85079,85072,100,0,0,0,0,0,0,0,0,0,0,0,0,0,0,0,n/a,0
86001,86001,100,160,0,0,0,160,160,0,0,1.0,0.0,0.0,0.0,1.0,0.0,0.0,Brenda Rivera RECAP,1.0
86002,86002,100,123,0,0,6,129,123,6,0,0.9534883720930233,0.0,0.0,0.046511627906976744,0.9534883720930233,0.046511627906976744,0.0,Brenda Rivera RECAP,0.9534883720930233
86003,86003,100,145,1,0,7,153,145,8,0,0.9477124183006536,0.006535947712418301,0.0,0.0457516339869281,0.9477124183006536,0.05228758169934641,0.0,Brenda Rivera RECAP,0.9477124183006536
86004,86004,100,74,0,0,9,83,74,9,0,0.891566265060241,0.0,0.0,0.10843373493975904,0.891566265060241,0.10843373493975904,0.0,Brenda Rivera RECAP,0.891566265060241
86005,86005,100,107,0,0,0,107,107,0,0,1.0,0.0,0.0,0.0,1.0,0.0,0.0,Brenda Rivera RECAP,1.0
86006,86006,100,98,0,0,6,104,98,6,0,0.9423076923076923,0.0,0.0,0.057692307692307696,0.9423076923076923,0.057692307692307696,0.0,Brenda Rivera RECAP,0.9423076923076923
86007,86007,100,115,1,1,6,123,115,7,1,0.9349593495934959,0.008130081300813009,0.008130081300813009,0.04878048780487805,0.9349593495934959,0.056910569105691054,0.008130081300813009,Brenda Rivera RECAP,0.9349593495934959
86008,86008,100,166,2,0,11,179,166,13,0,0.9273743016759777,0.0111731843575419,0.0,0.061452513966480445,0.9273743016759777,0.07262569832402235,0.0,Brenda Rivera RECAP,0.9273743016759777
86009,86009,100,109,3,1,3,116,109,6,1,0.9396551724137931,0.02586206896551724,0.008620689655172414,0.02586206896551724,0.9396551724137931,0.05172413793103448,0.008620689655172414,Brenda Rivera RECAP,0.9396551724137931
86010,86010,100,83,1,1,1,86,83,2,1,0.9651162790697675,0.011627906976744186,0.011627906976744186,0.011627906976744186,0.9651162790697675,0.023255813953488372,0.011627906976744186,Brenda Rivera RECAP,0.9651162790697675
86011,86011,100,190,1,0,11,202,190,12,0,0.9405940594059405,0.0049504950495049506,0.0,0.054455445544554455,0.9405940594059405,0.0594059405940594,0.0,Brenda Rivera RECAP,0.9405940594059405
86012,86012,100,138,4,0,9,151,138,13,0,0.9139072847682119,0.026490066225165563,0.0,0.059602649006622516,0.9139072847682119,0.08609271523178808,0.0,Brenda Rivera RECAP,0.9139072847682119
86013,86013,100,123,0,0,7,130,123,7,0,0.9461538461538461,0.0,0.0,0.05384615384615385,0.9461538461538461,0.05384615384615385,0.0,Brenda Rivera RECAP,0.9461538461538461
86014,86014,100,181,2,0,6,189,181,8,0,0.9576719576719577,0.010582010582010581,0.0,0.031746031746031744,0.9576719576719577,0.042328042328042326,0.0,Brenda Rivera RECAP,0.9576719576719577
86015,86015,100,115,0,0,4,119,115,4,0,0.9663865546218487,0.0,0.0,0.03361344537815126,0.9663865546218487,0.03361344537815126,0.0,Brenda Rivera RECAP,0.9663865546218487
86016,86016,100,132,4,0,5,141,132,9,0,0.9361702127659575,0.028368794326241134,0.0,0.03546099290780142,0.9361702127659575,0.06382978723404255,0.0,Brenda Rivera RECAP,0.9361702127659575
86017,86017,100,147,3,0,5,155,147,8,0,0.9483870967741935,0.01935483870967742,0.0,0.03225806451612903,0.9483870967741935,0.05161290322580645,0.0,Brenda Rivera RECAP,0.9483870967741935
86018,86018,100,125,2,0,6,133,125,8,0,0.9398496240601504,0.015037593984962405,0.0,0.045112781954887216,0.9398496240601504,0.06015037593984962,0.0,Brenda Rivera RECAP,0.9398496240601504
86019,86019,100,201,1,1,11,214,201,12,1,0.9392523364485982,0.004672897196261682,0.004672897196261682,0.0514018691588785,0.9392523364485982,0.056074766355140186,0.004672897196261682,Brenda Rivera RECAP,0.9392523364485982
86020,86020,100,169,3,0,10,182,169,13,0,0.9285714285714286,0.016483516483516484,0.0,0.054945054945054944,0.9285714285714286,0.07142857142857142,0.0,Brenda Rivera RECAP,0.9285714285714286
86021,86021,100,14,0,0,0,14,14,0,0,1.0,0.0,0.0,0.0,1.0,0.0,0.0,Brenda Rivera RECAP,1.0
86022,86022,100,152,2,1,6,161,152,8,1,0.9440993788819876,0.012422360248447204,0.006211180124223602,0.037267080745341616,0.9440993788819876,0.049689440993788817,0.006211180124223602,Brenda Rivera RECAP,0.9440993788819876
86023,86023,100,148,2,0,6,156,148,8,0,0.9487179487179487,0.01282051282051282,0.0,0.038461538461538464,0.9487179487179487,0.05128205128205128,0.0,Brenda Rivera RECAP,0.9487179487179487
86024,86024,100,129,0,0,11,140,129,11,0,0.9214285714285714,0.0,0.0,0.07857142857142857,0.9214285714285714,0.07857142857142857,0.0,Brenda Rivera RECAP,0.9214285714285714
86025,86025,100,144,1,0,2,147,144,3,0,0.9795918367346939,0.006802721088435374,0.0,0.013605442176870748,0.9795918367346939,0.02040816326530612,0.0,Brenda Rivera RECAP,0.9795918367346939
86026,86026,100,176,1,1,10,188,176,11,1,0.9361702127659575,0.005319148936170213,0.005319148936170213,0.05319148936170213,0.9361702127659575,0.05851063829787234,0.005319148936170213,Brenda Rivera RECAP,0.9361702127659575
86027,86027,100,197,1,0,10,208,197,11,0,0.9471153846153846,0.004807692307692308,0.0,0.04807692307692308,0.9471153846153846,0.052884615384615384,0.0,Brenda Rivera RECAP,0.9471153846153846
86028,86028,100,159,2,0,8,169,159,10,0,0.9408284023668639,0.011834319526627219,0.0,0.047337278106508875,0.9408284023668639,0.05917159763313609,0.0,Brenda Rivera RECAP,0.9408284023668639
86029,86029,100,145,3,0,4,152,145,7,0,0.9539473684210527,0.019736842105263157,0.0,0.02631578947368421,0.9539473684210527,0.046052631578947366,0.0,Brenda Rivera RECAP,0.9539473684210527
86030,86030,100,207,1,0,14,222,207,15,0,0.9324324324324325,0.0045045045045045045,0.0,0.06306306306306306,0.9324324324324325,0.06756756756756757,0.0,Brenda Rivera RECAP,0.9324324324324325
86031,86031,100,164,2,0,5,171,164,7,0,0.9590643274853801,0.011695906432748537,0.0,0.029239766081871343,0.9590643274853801,0.04093567251461988,0.0,Brenda Rivera RECAP,0.9590643274853801
86032,86032,100,140,3,1,7,151,140,10,1,0.9271523178807947,0.019867549668874173,0.006622516556291391,0.046357615894039736,0.9271523178807947,0.06622516556291391,0.006622516556291391,Brenda Rivera RECAP,0.9271523178807947
86033,86033,100,230,0,0,5,235,230,5,0,0.9787234042553191,0.0,0.0,0.02127659574468085,0.9787234042553191,0.02127659574468085,0.0,Brenda Rivera RECAP,0.9787234042553191
86034,86034,100,161,2,1,2,166,161,4,1,0.9698795180722891,0.012048192771084338,0.006024096385542169,0.012048192771084338,0.9698795180722891,0.024096385542168676,0.006024096385542169,Brenda Rivera RECAP,0.9698795180722891
86035,86035,100,188,1,0,3,192,188,4,0,0.9791666666666666,0.005208333333333333,0.0,0.015625,0.9791666666666666,0.020833333333333332,0.0,Brenda Rivera RECAP,0.9791666666666666
86036,86036,100,188,0,0,3,191,188,3,0,0.9842931937172775,0.0,0.0,0.015706806282722512,0.9842931937172775,0.015706806282722512,0.0,Brenda Rivera RECAP,0.9842931937172775
86037,86037,100,123,3,0,9,135,123,12,0,0.9111111111111111,0.022222222222222223,0.0,0.06666666666666667,0.9111111111111111,0.08888888888888889,0.0,Brenda Rivera RECAP,0.9111111111111111
86038,86038,100,65,1,0,2,68,65,3,0,0.9558823529411765,0.014705882352941176,0.0,0.029411764705882353,0.9558823529411765,0.04411764705882353,0.0,Brenda Rivera RECAP,0.9558823529411765
86039,86039,100,83,3,0,1,87,83,4,0,0.9540229885057471,0.034482758620689655,0.0,0.011494252873563218,0.9540229885057471,0.04597701149425287,0.0,Brenda Rivera RECAP,0.9540229885057471
86040,86040,100,143,0,0,4,147,143,4,0,0.9727891156462585,0.0,0.0,0.027210884353741496,0.9727891156462585,0.027210884353741496,0.0,Brenda Rivera RECAP,0.9727891156462585
86041,86041,100,87,1,0,0,88,87,1,0,0.9886363636363636,0.011363636363636364,0.0,0.0,0.9886363636363636,0.011363636363636364,0.0,Brenda Rivera RECAP,0.9886363636363636
86042,86042,100,0,0,0,0,0,0,0,0,0,0,0,0,0,0,0,n/a,0
86043,86043,100,15,0,0,0,15,15,0,0,1.0,0.0,0.0,0.0,1.0,0.0,0.0,Brenda Rivera RECAP,1.0
86044,86044,100,34,0,0,1,35,34,1,0,0.9714285714285714,0.0,0.0,0.02857142857142857,0.9714285714285714,0.02857142857142857,0.0,Brenda Rivera RECAP,0.9714285714285714
86045,86045,100,101,0,1,7,109,101,7,1,0.926605504587156,0.0,0.009174311926605505,0.06422018348623854,0.926605504587156,0.06422018348623854,0.009174311926605505,Brenda Rivera RECAP,0.926605504587156
86046,86046,100,75,2,0,1,78,75,3,0,0.9615384615384616,0.02564102564102564,0.0,0.01282051282051282,0.9615384615384616,0.038461538461538464,0.0,Brenda Rivera RECAP,0.9615384615384616
86047,86047,100,202,1,0,3,206,202,4,0,0.9805825242718447,0.0048543689320388345,0.0,0.014563106796116505,0.9805825242718447,0.019417475728155338,0.0,Brenda Rivera RECAP,0.9805825242718447
86048,86048,100,99,1,0,3,103,99,4,0,0.9611650485436893,0.009708737864077669,0.0,0.02912621359223301,0.9611650485436893,0.038834951456310676,0.0,Brenda Rivera RECAP,0.9611650485436893
86049,86049,100,138,0,0,2,140,138,2,0,0.9857142857142858,0.0,0.0,0.014285714285714285,0.9857142857142858,0.014285714285714285,0.0,Brenda Rivera RECAP,0.9857142857142858
86050,86050,100,182,3,0,12,197,182,15,0,0.9238578680203046,0.015228426395939087,0.0,0.06091370558375635,0.9238578680203046,0.07614213197969544,0.0,Brenda Rivera RECAP,0.9238578680203046
86051,86051,100,92,2,0,0,94,92,2,0,0.9787234042553191,0.02127659574468085,0.0,0.0,0.9787234042553191,0.02127659574468085,0.0,Brenda Rivera RECAP,0.9787234042553191
86052,86052,100,146,3,0,9,158,146,12,0,0.9240506329113924,0.0189873417721519,0.0,0.056962025316455694,0.9240506329113924,0.0759493670886076,0.0,Brenda Rivera RECAP,0.9240506329113924
86053,86053,100,109,0,0,4,113,109,4,0,0.9646017699115044,0.0,0.0,0.035398230088495575,0.9646017699115044,0.035398230088495575,0.0,Brenda Rivera RECAP,0.9646017699115044
86054,86054,100,161,0,1,8,170,161,8,1,0.9470588235294117,0.0,0.0058823529411764705,0.047058823529411764,0.9470588235294117,0.047058823529411764,0.0058823529411764705,Brenda Rivera RECAP,0.9470588235294117
86055,86055,100,174,0,0,8,182,174,8,0,0.9560439560439561,0.0,0.0,0.04395604395604396,0.9560439560439561,0.04395604395604396,0.0,Brenda Rivera RECAP,0.9560439560439561
86056,86056,100,92,2,0,2,96,92,4,0,0.9583333333333334,0.020833333333333332,0.0,0.020833333333333332,0.9583333333333334,0.041666666666666664,0.0,Brenda Rivera RECAP,0.9583333333333334
86057,86057,100,110,1,0,1,112,110,2,0,0.9821428571428571,0.008928571428571428,0.0,0.008928571428571428,0.9821428571428571,0.017857142857142856,0.0,Brenda Rivera RECAP,0.9821428571428571
86058,86058,100,40,1,0,0,41,40,1,0,0.975609756097561,0.024390243902439025,0.0,0.0,0.975609756097561,0.024390243902439025,0.0,Brenda Rivera RECAP,0.975609756097561
86059,86059,100,56,0,0,1,57,56,1,0,0.9824561403508771,0.0,0.0,0.017543859649122806,0.9824561403508771,0.017543859649122806,0.0,Brenda Rivera RECAP,0.9824561403508771
86060,86060,100,8,0,0,0,8,8,0,0,1.0,0.0,0.0,0.0,1.0,0.0,0.0,Brenda Rivera RECAP,1.0
87001,87001,100,20,0,0,0,20,20,0,0,1.0,0.0,0.0,0.0,1.0,0.0,0.0,Brenda Rivera RECAP,1.0
87002,87002,100,87,0,0,6,93,87,6,0,0.9354838709677419,0.0,0.0,0.06451612903225806,0.9354838709677419,0.06451612903225806,0.0,Brenda Rivera RECAP,0.9354838709677419
87003,87003,100,61,0,0,5,66,61,5,0,0.9242424242424242,0.0,0.0,0.07575757575757576,0.9242424242424242,0.07575757575757576,0.0,Brenda Rivera RECAP,0.9242424242424242
87004,87004,100,116,2,0,6,124,116,8,0,0.9354838709677419,0.016129032258064516,0.0,0.04838709677419355,0.9354838709677419,0.06451612903225806,0.0,Brenda Rivera RECAP,0.9354838709677419
87005,87005,100,82,0,0,2,84,82,2,0,0.9761904761904762,0.0,0.0,0.023809523809523808,0.9761904761904762,0.023809523809523808,0.0,Brenda Rivera RECAP,0.9761904761904762
87006,87006,100,160,0,0,7,167,160,7,0,0.9580838323353293,0.0,0.0,0.041916167664670656,0.9580838323353293,0.041916167664670656,0.0,Brenda Rivera RECAP,0.9580838323353293
87007,87007,100,99,0,0,5,104,99,5,0,0.9519230769230769,0.0,0.0,0.04807692307692308,0.9519230769230769,0.04807692307692308,0.0,Brenda Rivera RECAP,0.9519230769230769
87008,87008,100,104,0,0,1,105,104,1,0,0.9904761904761905,0.0,0.0,0.009523809523809525,0.9904761904761905,0.009523809523809525,0.0,Brenda Rivera RECAP,0.9904761904761905
87009,87009,100,132,0,0,6,138,132,6,0,0.9565217391304348,0.0,0.0,0.043478260869565216,0.9565217391304348,0.043478260869565216,0.0,Brenda Rivera RECAP,0.9565217391304348
87010,87010,100,159,2,0,8,169,159,10,0,0.9408284023668639,0.011834319526627219,0.0,0.047337278106508875,0.9408284023668639,0.05917159763313609,0.0,Brenda Rivera RECAP,0.9408284023668639
87011,87011,100,114,2,0,4,120,114,6,0,0.95,0.016666666666666666,0.0,0.03333333333333333,0.95,0.05,0.0,Brenda Rivera RECAP,0.95
87013,87013,100,36,0,0,1,37,36,1,0,0.972972972972973,0.0,0.0,0.02702702702702703,0.972972972972973,0.02702702702702703,0.0,Brenda Rivera RECAP,0.972972972972973
87012,87013,100,0,0,0,0,0,0,0,0,0,0,0,0,0,0,0,n/a,0
87014,87014,100,23,1,0,2,26,23,3,0,0.8846153846153846,0.038461538461538464,0.0,0.07692307692307693,0.8846153846153846,0.11538461538461539,0.0,Brenda Rivera RECAP,0.8846153846153846
87015,87015,100,39,0,0,3,42,39,3,0,0.9285714285714286,0.0,0.0,0.07142857142857142,0.9285714285714286,0.07142857142857142,0.0,Brenda Rivera RECAP,0.9285714285714286
87016,87016,100,40,0,0,2,42,40,2,0,0.9523809523809523,0.0,0.0,0.047619047619047616,0.9523809523809523,0.047619047619047616,0.0,Brenda Rivera RECAP,0.9523809523809523
87017,87017,100,33,2,0,1,36,33,3,0,0.9166666666666666,0.05555555555555555,0.0,0.027777777777777776,0.9166666666666666,0.08333333333333333,0.0,Brenda Rivera RECAP,0.9166666666666666
87018,87018,100,81,0,0,6,87,81,6,0,0.9310344827586207,0.0,0.0,0.06896551724137931,0.9310344827586207,0.06896551724137931,0.0,Brenda Rivera RECAP,0.9310344827586207
87019,87019,100,71,1,0,8,80,71,9,0,0.8875,0.0125,0.0,0.1,0.8875,0.1125,0.0,Brenda Rivera RECAP,0.8875
87020,87020,100,87,3,0,15,105,87,18,0,0.8285714285714286,0.02857142857142857,0.0,0.14285714285714285,0.8285714285714286,0.17142857142857143,0.0,Brenda Rivera RECAP,0.8285714285714286
87021,87021,100,28,0,0,1,29,28,1,0,0.9655172413793104,0.0,0.0,0.034482758620689655,0.9655172413793104,0.034482758620689655,0.0,Brenda Rivera RECAP,0.9655172413793104
87022,87022,100,103,2,0,2,107,103,4,0,0.9626168224299065,0.018691588785046728,0.0,0.018691588785046728,0.9626168224299065,0.037383177570093455,0.0,Brenda Rivera RECAP,0.9626168224299065
87023,87023,100,140,6,0,10,156,140,16,0,0.8974358974358975,0.038461538461538464,0.0,0.0641025641025641,0.8974358974358975,0.10256410256410256,0.0,Brenda Rivera RECAP,0.8974358974358975
87024,87024,100,69,1,0,5,75,69,6,0,0.92,0.013333333333333334,0.0,0.06666666666666667,0.92,0.08,0.0,Brenda Rivera RECAP,0.92
87025,87025,100,55,0,0,1,56,55,1,0,0.9821428571428571,0.0,0.0,0.017857142857142856,0.9821428571428571,0.017857142857142856,0.0,Brenda Rivera RECAP,0.9821428571428571
87026,87026,100,132,3,0,11,146,132,14,0,0.9041095890410958,0.02054794520547945,0.0,0.07534246575342465,0.9041095890410958,0.0958904109589041,0.0,Brenda Rivera RECAP,0.9041095890410958
87027,87027,100,88,3,0,5,96,88,8,0,0.9166666666666666,0.03125,0.0,0.052083333333333336,0.9166666666666666,0.08333333333333333,0.0,Brenda Rivera RECAP,0.9166666666666666
87028,87028,100,131,1,0,13,145,131,14,0,0.903448275862069,0.006896551724137931,0.0,0.0896551724137931,0.903448275862069,0.09655172413793103,0.0,Brenda Rivera RECAP,0.903448275862069
87029,87029,100,95,3,0,7,105,95,10,0,0.9047619047619048,0.02857142857142857,0.0,0.06666666666666667,0.9047619047619048,0.09523809523809523,0.0,Brenda Rivera RECAP,0.9047619047619048
87030,87030,100,53,1,0,3,57,53,4,0,0.9298245614035088,0.017543859649122806,0.0,0.05263157894736842,0.9298245614035088,0.07017543859649122,0.0,Brenda Rivera RECAP,0.9298245614035088
87031,87031,100,85,0,0,3,88,85,3,0,0.9659090909090909,0.0,0.0,0.03409090909090909,0.9659090909090909,0.03409090909090909,0.0,Brenda Rivera RECAP,0.9659090909090909
87032,87032,100,148,2,0,7,157,148,9,0,0.9426751592356688,0.012738853503184714,0.0,0.044585987261146494,0.9426751592356688,0.05732484076433121,0.0,Brenda Rivera RECAP,0.9426751592356688
87033,87033,100,159,4,0,4,167,159,8,0,0.9520958083832335,0.023952095808383235,0.0,0.023952095808383235,0.9520958083832335,0.04790419161676647,0.0,Brenda Rivera RECAP,0.9520958083832335
87034,87034,100,143,2,0,6,151,143,8,0,0.9470198675496688,0.013245033112582781,0.0,0.039735099337748346,0.9470198675496688,0.052980132450331126,0.0,Brenda Rivera RECAP,0.9470198675496688
87035,87035,100,116,0,0,4,120,116,4,0,0.9666666666666667,0.0,0.0,0.03333333333333333,0.9666666666666667,0.03333333333333333,0.0,Brenda Rivera RECAP,0.9666666666666667
87036,87036,100,113,1,0,19,133,113,20,0,0.849624060150376,0.007518796992481203,0.0,0.14285714285714285,0.849624060150376,0.15037593984962405,0.0,Brenda Rivera RECAP,0.849624060150376
87037,87037,100,139,2,0,12,153,139,14,0,0.9084967320261438,0.013071895424836602,0.0,0.0784313725490196,0.9084967320261438,0.0915032679738562,0.0,Brenda Rivera RECAP,0.9084967320261438
87038,87038,100,155,1,0,8,164,155,9,0,0.9451219512195121,0.006097560975609756,0.0,0.04878048780487805,0.9451219512195121,0.054878048780487805,0.0,Brenda Rivera RECAP,0.9451219512195121
87039,87039,100,168,1,0,10,179,168,11,0,0.9385474860335196,0.00558659217877095,0.0,0.055865921787709494,0.9385474860335196,0.061452513966480445,0.0,Brenda Rivera RECAP,0.9385474860335196
87040,87040,100,186,5,0,18,209,186,23,0,0.8899521531100478,0.023923444976076555,0.0,0.0861244019138756,0.8899521531100478,0.11004784688995216,0.0,Brenda Rivera RECAP,0.8899521531100478
87041,87041,100,75,2,0,7,84,75,9,0,0.8928571428571429,0.023809523809523808,0.0,0.08333333333333333,0.8928571428571429,0.10714285714285714,0.0,Brenda Rivera RECAP,0.8928571428571429
87042,87042,100,164,2,0,6,172,164,8,0,0.9534883720930233,0.011627906976744186,0.0,0.03488372093023256,0.9534883720930233,0.046511627906976744,0.0,Brenda Rivera RECAP,0.9534883720930233
87043,87043,100,0,0,0,0,0,0,0,0,0,0,0,0,0,0,0,n/a,0
87044,87044,100,27,1,0,6,34,27,7,0,0.7941176470588235,0.029411764705882353,0.0,0.17647058823529413,0.7941176470588235,0.20588235294117646,0.0,Brenda Rivera RECAP,0.7941176470588235
87045,87045,100,11,0,0,2,13,11,2,0,0.8461538461538461,0.0,0.0,0.15384615384615385,0.8461538461538461,0.15384615384615385,0.0,Brenda Rivera RECAP,0.8461538461538461
87046,87046,100,99,1,0,14,114,99,15,0,0.868421052631579,0.008771929824561403,0.0,0.12280701754385964,0.868421052631579,0.13157894736842105,0.0,Brenda Rivera RECAP,0.868421052631579
87047,87047,100,264,2,0,15,281,264,17,0,0.9395017793594306,0.0071174377224199285,0.0,0.05338078291814947,0.9395017793594306,0.060498220640569395,0.0,Brenda Rivera RECAP,0.9395017793594306
87048,87048,100,250,3,0,14,267,250,17,0,0.9363295880149812,0.011235955056179775,0.0,0.052434456928838954,0.9363295880149812,0.06367041198501873,0.0,Brenda Rivera RECAP,0.9363295880149812
87049,87049,100,204,4,0,12,220,204,16,0,0.9272727272727272,0.01818181818181818,0.0,0.05454545454545454,0.9272727272727272,0.07272727272727272,0.0,Brenda Rivera RECAP,0.9272727272727272
87050,87050,100,233,5,1,5,244,233,10,1,0.9549180327868853,0.020491803278688523,0.004098360655737705,0.020491803278688523,0.9549180327868853,0.040983606557377046,0.004098360655737705,Brenda Rivera RECAP,0.9549180327868853
87051,87051,100,258,2,1,18,279,258,20,1,0.9247311827956989,0.007168458781362007,0.0035842293906810036,0.06451612903225806,0.9247311827956989,0.07168458781362007,0.0035842293906810036,Brenda Rivera RECAP,0.9247311827956989
87052,87052,100,244,2,1,7,254,244,9,1,0.9606299212598425,0.007874015748031496,0.003937007874015748,0.027559055118110236,0.9606299212598425,0.03543307086614173,0.003937007874015748,Brenda Rivera RECAP,0.9606299212598425
87053,87053,100,250,4,3,10,267,250,14,3,0.9363295880149812,0.0149812734082397,0.011235955056179775,0.03745318352059925,0.9363295880149812,0.052434456928838954,0.011235955056179775,Brenda Rivera RECAP,0.9363295880149812
87054,87054,100,199,3,1,11,214,199,14,1,0.9299065420560748,0.014018691588785047,0.004672897196261682,0.0514018691588785,0.9299065420560748,0.06542056074766354,0.004672897196261682,Brenda Rivera RECAP,0.9299065420560748
87055,87055,100,166,1,0,7,174,166,8,0,0.9540229885057471,0.005747126436781609,0.0,0.040229885057471264,0.9540229885057471,0.04597701149425287,0.0,Brenda Rivera RECAP,0.9540229885057471
87056,87056,100,204,2,0,10,216,204,12,0,0.9444444444444444,0.009259259259259259,0.0,0.046296296296296294,0.9444444444444444,0.05555555555555555,0.0,Brenda Rivera RECAP,0.9444444444444444
87057,87057,100,252,1,0,20,273,252,21,0,0.9230769230769231,0.003663003663003663,0.0,0.07326007326007326,0.9230769230769231,0.07692307692307693,0.0,Brenda Rivera RECAP,0.9230769230769231
87058,87058,100,113,2,0,6,121,113,8,0,0.9338842975206612,0.01652892561983471,0.0,0.049586776859504134,0.9338842975206612,0.06611570247933884,0.0,Brenda Rivera RECAP,0.9338842975206612
87059,87059,100,267,4,0,15,286,267,19,0,0.9335664335664335,0.013986013986013986,0.0,0.05244755244755245,0.9335664335664335,0.06643356643356643,0.0,Brenda Rivera RECAP,0.9335664335664335
87060,87060,100,166,4,0,10,180,166,14,0,0.9222222222222223,0.022222222222222223,0.0,0.05555555555555555,0.9222222222222223,0.07777777777777778,0.0,Brenda Rivera RECAP,0.9222222222222223
87061,87061,100,188,6,0,7,201,188,13,0,0.9353233830845771,0.029850746268656716,0.0,0.03482587064676617,0.9353233830845771,0.06467661691542288,0.0,Brenda Rivera RECAP,0.9353233830845771
87062,87062,100,234,5,0,10,249,234,15,0,0.9397590361445783,0.020080321285140562,0.0,0.040160642570281124,0.9397590361445783,0.060240963855421686,0.0,Brenda Rivera RECAP,0.9397590361445783
87063,87063,100,9,0,0,1,10,9,1,0,0.9,0.0,0.0,0.1,0.9,0.1,0.0,Brenda Rivera RECAP,0.9
87064,87064,100,1,0,0,0,1,1,0,0,1.0,0.0,0.0,0.0,1.0,0.0,0.0,Brenda Rivera RECAP,1.0
87065,87065,100,77,4,0,9,90,77,13,0,0.8555555555555555,0.044444444444444446,0.0,0.1,0.8555555555555555,0.14444444444444443,0.0,Brenda Rivera RECAP,0.8555555555555555
87066,87066,100,91,2,0,4,97,91,6,0,0.9381443298969072,0.020618556701030927,0.0,0.041237113402061855,0.9381443298969072,0.061855670103092786,0.0,Brenda Rivera RECAP,0.9381443298969072
87067,87067,100,73,2,0,8,83,73,10,0,0.8795180722891566,0.024096385542168676,0.0,0.0963855421686747,0.8795180722891566,0.12048192771084337,0.0,Brenda Rivera RECAP,0.8795180722891566
87068,87068,100,128,6,0,26,160,128,32,0,0.8,0.0375,0.0,0.1625,0.8,0.2,0.0,Brenda Rivera RECAP,0.8
87069,87069,100,144,2,0,8,154,144,10,0,0.935064935064935,0.012987012987012988,0.0,0.05194805194805195,0.935064935064935,0.06493506493506493,0.0,Brenda Rivera RECAP,0.935064935064935
87070,87070,100,112,0,0,0,112,112,0,0,1.0,0.0,0.0,0.0,1.0,0.0,0.0,Brenda Rivera RECAP,1.0
87071,87071,100,70,0,0,2,72,70,2,0,0.9722222222222222,0.0,0.0,0.027777777777777776,0.9722222222222222,0.027777777777777776,0.0,Brenda Rivera RECAP,0.9722222222222222
87072,87072,100,73,0,0,16,89,73,16,0,0.8202247191011236,0.0,0.0,0.1797752808988764,0.8202247191011236,0.1797752808988764,0.0,Brenda Rivera RECAP,0.8202247191011236
87073,87073,100,24,1,0,3,28,24,4,0,0.8571428571428571,0.03571428571428571,0.0,0.10714285714285714,0.8571428571428571,0.14285714285714285,0.0,Brenda Rivera RECAP,0.8571428571428571
87074,87074,100,158,2,1,17,178,158,19,1,0.8876404494382022,0.011235955056179775,0.0056179775280898875,0.09550561797752809,0.8876404494382022,0.10674157303370786,0.0056179775280898875,Brenda Rivera RECAP,0.8876404494382022
87075,87075,100,133,2,0,16,151,133,18,0,0.8807947019867549,0.013245033112582781,0.0,0.10596026490066225,0.8807947019867549,0.11920529801324503,0.0,Brenda Rivera RECAP,0.8807947019867549
87076,87076,100,123,4,1,15,143,123,19,1,0.8601398601398601,0.027972027972027972,0.006993006993006993,0.1048951048951049,0.8601398601398601,0.13286713286713286,0.006993006993006993,Brenda Rivera RECAP,0.8601398601398601
87077,87077,100,125,1,0,12,138,125,13,0,0.9057971014492754,0.007246376811594203,0.0,0.08695652173913043,0.9057971014492754,0.09420289855072464,0.0,Brenda Rivera RECAP,0.9057971014492754
87078,87078,100,178,4,0,13,195,178,17,0,0.9128205128205128,0.020512820512820513,0.0,0.06666666666666667,0.9128205128205128,0.08717948717948718,0.0,Brenda Rivera RECAP,0.9128205128205128
87079,87079,100,23,1,0,2,26,23,3,0,0.8846153846153846,0.038461538461538464,0.0,0.07692307692307693,0.8846153846153846,0.11538461538461539,0.0,Brenda Rivera RECAP,0.8846153846153846
87080,87080,100,110,1,0,7,118,110,8,0,0.9322033898305084,0.00847457627118644,0.0,0.059322033898305086,0.9322033898305084,0.06779661016949153,0.0,Brenda Rivera RECAP,0.9322033898305084
87081,87081,100,124,2,0,10,136,124,12,0,0.9117647058823529,0.014705882352941176,0.0,0.07352941176470588,0.9117647058823529,0.08823529411764706,0.0,Brenda Rivera RECAP,0.9117647058823529
87082,87082,100,85,1,0,3,89,85,4,0,0.9550561797752809,0.011235955056179775,0.0,0.033707865168539325,0.9550561797752809,0.0449438202247191,0.0,Brenda Rivera RECAP,0.9550561797752809
87083,87083,100,9,0,0,5,14,9,5,0,0.6428571428571429,0.0,0.0,0.35714285714285715,0.6428571428571429,0.35714285714285715,0.0,Brenda Rivera RECAP,0.6428571428571429
87084,87084,100,171,0,0,10,181,171,10,0,0.9447513812154696,0.0,0.0,0.055248618784530384,0.9447513812154696,0.055248618784530384,0.0,Brenda Rivera RECAP,0.9447513812154696
87085,87085,100,200,1,0,10,211,200,11,0,0.9478672985781991,0.004739336492890996,0.0,0.04739336492890995,0.9478672985781991,0.052132701421800945,0.0,Brenda Rivera RECAP,0.9478672985781991
87086,87086,100,47,0,0,1,48,47,1,0,0.9791666666666666,0.0,0.0,0.020833333333333332,0.9791666666666666,0.020833333333333332,0.0,Brenda Rivera RECAP,0.9791666666666666
87087,87087,100,311,2,0,6,319,311,8,0,0.9749216300940439,0.006269592476489028,0.0,0.018808777429467086,0.9749216300940439,0.025078369905956112,0.0,Brenda Rivera RECAP,0.9749216300940439
87088,87088,100,139,0,0,3,142,139,3,0,0.9788732394366197,0.0,0.0,0.02112676056338028,0.9788732394366197,0.02112676056338028,0.0,Brenda Rivera RECAP,0.9788732394366197
87089,87089,100,121,5,1,1,128,121,6,1,0.9453125,0.0390625,0.0078125,0.0078125,0.9453125,0.046875,0.0078125,Brenda Rivera RECAP,0.9453125
87090,87090,100,0,0,0,0,0,0,0,0,0,0,0,0,0,0,0,n/a,0
87091,87091,100,0,0,0,0,0,0,0,0,0,0,0,0,0,0,0,n/a,0
87092,87092,100,0,0,0,0,0,0,0,0,0,0,0,0,0,0,0,n/a,0
87093,87093,100,0,0,0,0,0,0,0,0,0,0,0,0,0,0,0,n/a,0
87094,87094,100,0,0,0,0,0,0,0,0,0,0,0,0,0,0,0,n/a,0
87095,87095,100,0,0,0,0,0,0,0,0,0,0,0,0,0,0,0,n/a,0
