ED,Reported As,Reporting,Mike Yusupov (Conservative),James F. Brennan (Working Families),Mike Yusupov (Republican),Scattered,James F. Brennan (Democratic),Total Votes,Mike Yusupov RECAP,James F. Brennan RECAP,Scattered RECAP,p_Mike Yusupov (Conservative),p_James F. Brennan (Working Families),p_Mike Yusupov (Republican),p_Scattered,p_James F. Brennan (Democratic),p_Mike Yusupov RECAP,p_James F. Brennan RECAP,p_Scattered RECAP,winner,winner_p
44001,44001,100,23,16,44,11,155,249,67,171,11,0.09236947791164658,0.0642570281124498,0.17670682730923695,0.04417670682730924,0.6224899598393574,0.26907630522088355,0.6867469879518072,0.04417670682730924,James F. Brennan RECAP,0.6867469879518072
44002,44002,100,42,10,77,2,161,292,119,171,2,0.14383561643835616,0.03424657534246575,0.2636986301369863,0.00684931506849315,0.5513698630136986,0.4075342465753425,0.5856164383561644,0.00684931506849315,James F. Brennan RECAP,0.5856164383561644
44003,44003,100,37,10,57,19,121,244,94,131,19,0.15163934426229508,0.040983606557377046,0.2336065573770492,0.0778688524590164,0.4959016393442623,0.38524590163934425,0.5368852459016393,0.0778688524590164,James F. Brennan RECAP,0.5368852459016393
44004,44004,100,6,6,22,95,58,187,28,64,95,0.03208556149732621,0.03208556149732621,0.11764705882352941,0.5080213903743316,0.31016042780748665,0.1497326203208556,0.3422459893048128,0.5080213903743316,Scattered RECAP,0.5080213903743316
44005,44005,100,22,19,32,2,110,185,54,129,2,0.11891891891891893,0.10270270270270271,0.17297297297297298,0.010810810810810811,0.5945945945945946,0.2918918918918919,0.6972972972972973,0.010810810810810811,James F. Brennan RECAP,0.6972972972972973
44006,44006,100,16,19,26,2,135,198,42,154,2,0.08080808080808081,0.09595959595959595,0.13131313131313133,0.010101010101010102,0.6818181818181818,0.21212121212121213,0.7777777777777778,0.010101010101010102,James F. Brennan RECAP,0.7777777777777778
44007,44007,100,5,30,10,1,113,159,15,143,1,0.031446540880503145,0.18867924528301888,0.06289308176100629,0.006289308176100629,0.710691823899371,0.09433962264150944,0.89937106918239,0.006289308176100629,James F. Brennan RECAP,0.89937106918239
44008,44008,100,24,67,23,3,166,283,47,233,3,0.08480565371024736,0.23674911660777384,0.0812720848056537,0.01060070671378092,0.5865724381625441,0.16607773851590105,0.823321554770318,0.01060070671378092,James F. Brennan RECAP,0.823321554770318
44009,44009,100,5,40,11,0,118,174,16,158,0,0.028735632183908046,0.22988505747126436,0.06321839080459771,0.0,0.6781609195402298,0.09195402298850575,0.9080459770114943,0.0,James F. Brennan RECAP,0.9080459770114943
44010,44010,100,8,19,11,1,118,157,19,137,1,0.050955414012738856,0.12101910828025478,0.07006369426751592,0.006369426751592357,0.7515923566878981,0.12101910828025478,0.8726114649681529,0.006369426751592357,James F. Brennan RECAP,0.8726114649681529
44011,44011,100,5,3,9,0,36,53,14,39,0,0.09433962264150944,0.05660377358490566,0.16981132075471697,0.0,0.6792452830188679,0.2641509433962264,0.7358490566037735,0.0,James F. Brennan RECAP,0.7358490566037735
44012,44012,100,1,7,2,0,28,38,3,35,0,0.02631578947368421,0.18421052631578946,0.05263157894736842,0.0,0.7368421052631579,0.07894736842105263,0.9210526315789473,0.0,James F. Brennan RECAP,0.9210526315789473
44013,44013,100,5,0,7,2,32,46,12,32,2,0.10869565217391304,0.0,0.15217391304347827,0.043478260869565216,0.6956521739130435,0.2608695652173913,0.6956521739130435,0.043478260869565216,James F. Brennan RECAP,0.6956521739130435
44014,44014,100,7,41,18,0,144,210,25,185,0,0.03333333333333333,0.19523809523809524,0.08571428571428572,0.0,0.6857142857142857,0.11904761904761904,0.8809523809523809,0.0,James F. Brennan RECAP,0.8809523809523809
44015,44015,100,14,69,28,0,212,323,42,281,0,0.043343653250773995,0.21362229102167182,0.08668730650154799,0.0,0.6563467492260062,0.13003095975232198,0.8699690402476781,0.0,James F. Brennan RECAP,0.8699690402476781
44016,44016,100,4,23,13,0,115,155,17,138,0,0.025806451612903226,0.14838709677419354,0.08387096774193549,0.0,0.7419354838709677,0.10967741935483871,0.8903225806451613,0.0,James F. Brennan RECAP,0.8903225806451613
44017,44017,100,14,87,33,0,161,295,47,248,0,0.04745762711864407,0.29491525423728815,0.11186440677966102,0.0,0.5457627118644067,0.15932203389830507,0.8406779661016949,0.0,James F. Brennan RECAP,0.8406779661016949
44018,44018,100,14,64,16,0,148,242,30,212,0,0.05785123966942149,0.2644628099173554,0.06611570247933884,0.0,0.6115702479338843,0.12396694214876033,0.8760330578512396,0.0,James F. Brennan RECAP,0.8760330578512396
44019,44019,100,8,35,31,0,185,259,39,220,0,0.03088803088803089,0.13513513513513514,0.11969111969111969,0.0,0.7142857142857143,0.15057915057915058,0.8494208494208494,0.0,James F. Brennan RECAP,0.8494208494208494
44020,44020,100,14,10,18,0,93,135,32,103,0,0.1037037037037037,0.07407407407407407,0.13333333333333333,0.0,0.6888888888888889,0.23703703703703705,0.762962962962963,0.0,James F. Brennan RECAP,0.762962962962963
44021,44021,100,2,0,8,2,16,28,10,16,2,0.07142857142857142,0.0,0.2857142857142857,0.07142857142857142,0.5714285714285714,0.35714285714285715,0.5714285714285714,0.07142857142857142,James F. Brennan RECAP,0.5714285714285714
44022,44022,100,0,1,1,1,9,12,1,10,1,0.0,0.08333333333333333,0.08333333333333333,0.08333333333333333,0.75,0.08333333333333333,0.8333333333333334,0.08333333333333333,James F. Brennan RECAP,0.8333333333333334
44023,44023,100,18,9,40,3,83,153,58,92,3,0.11764705882352941,0.058823529411764705,0.26143790849673204,0.0196078431372549,0.5424836601307189,0.3790849673202614,0.6013071895424836,0.0196078431372549,James F. Brennan RECAP,0.6013071895424836
44024,44024,100,14,8,24,0,76,122,38,84,0,0.11475409836065574,0.06557377049180328,0.19672131147540983,0.0,0.6229508196721312,0.3114754098360656,0.6885245901639344,0.0,James F. Brennan RECAP,0.6885245901639344
44025,44025,100,34,14,83,0,149,280,117,163,0,0.12142857142857143,0.05,0.29642857142857143,0.0,0.5321428571428571,0.41785714285714287,0.5821428571428572,0.0,James F. Brennan RECAP,0.5821428571428572
44026,44026,100,30,14,82,1,128,255,112,142,1,0.11764705882352941,0.054901960784313725,0.3215686274509804,0.00392156862745098,0.5019607843137255,0.4392156862745098,0.5568627450980392,0.00392156862745098,James F. Brennan RECAP,0.5568627450980392
44027,44027,100,35,21,52,1,95,204,87,116,1,0.1715686274509804,0.10294117647058823,0.2549019607843137,0.004901960784313725,0.46568627450980393,0.4264705882352941,0.5686274509803921,0.004901960784313725,James F. Brennan RECAP,0.5686274509803921
44028,44028,100,6,27,39,0,121,193,45,148,0,0.031088082901554404,0.13989637305699482,0.20207253886010362,0.0,0.6269430051813472,0.23316062176165803,0.7668393782383419,0.0,James F. Brennan RECAP,0.7668393782383419
44029,44029,100,14,19,36,0,139,208,50,158,0,0.0673076923076923,0.09134615384615384,0.17307692307692307,0.0,0.6682692307692307,0.2403846153846154,0.7596153846153846,0.0,James F. Brennan RECAP,0.7596153846153846
44030,44030,100,17,17,43,0,150,227,60,167,0,0.07488986784140969,0.07488986784140969,0.1894273127753304,0.0,0.6607929515418502,0.2643171806167401,0.73568281938326,0.0,James F. Brennan RECAP,0.73568281938326
44031,44031,100,11,66,22,0,187,286,33,253,0,0.038461538461538464,0.23076923076923078,0.07692307692307693,0.0,0.6538461538461539,0.11538461538461539,0.8846153846153846,0.0,James F. Brennan RECAP,0.8846153846153846
44032,44032,100,3,7,4,0,42,56,7,49,0,0.05357142857142857,0.125,0.07142857142857142,0.0,0.75,0.125,0.875,0.0,James F. Brennan RECAP,0.875
44033,44033,100,2,62,11,1,156,232,13,218,1,0.008620689655172414,0.2672413793103448,0.04741379310344827,0.004310344827586207,0.6724137931034483,0.05603448275862069,0.9396551724137931,0.004310344827586207,James F. Brennan RECAP,0.9396551724137931
44034,44034,100,0,22,8,0,103,133,8,125,0,0.0,0.16541353383458646,0.06015037593984962,0.0,0.7744360902255639,0.06015037593984962,0.9398496240601504,0.0,James F. Brennan RECAP,0.9398496240601504
44035,44035,100,12,59,17,0,144,232,29,203,0,0.05172413793103448,0.2543103448275862,0.07327586206896551,0.0,0.6206896551724138,0.125,0.875,0.0,James F. Brennan RECAP,0.875
44036,44036,100,4,83,13,1,240,341,17,323,1,0.011730205278592375,0.2434017595307918,0.03812316715542522,0.002932551319648094,0.7038123167155426,0.04985337243401759,0.9472140762463344,0.002932551319648094,James F. Brennan RECAP,0.9472140762463344
44037,44037,100,5,16,3,0,82,106,8,98,0,0.04716981132075472,0.1509433962264151,0.02830188679245283,0.0,0.7735849056603774,0.07547169811320754,0.9245283018867925,0.0,James F. Brennan RECAP,0.9245283018867925
44038,44038,100,7,85,14,1,161,268,21,246,1,0.026119402985074626,0.31716417910447764,0.05223880597014925,0.0037313432835820895,0.6007462686567164,0.07835820895522388,0.917910447761194,0.0037313432835820895,James F. Brennan RECAP,0.917910447761194
44039,44039,100,5,28,7,0,114,154,12,142,0,0.032467532467532464,0.18181818181818182,0.045454545454545456,0.0,0.7402597402597403,0.07792207792207792,0.922077922077922,0.0,James F. Brennan RECAP,0.922077922077922
44040,44040,100,0,1,0,0,25,26,0,26,0,0.0,0.038461538461538464,0.0,0.0,0.9615384615384616,0.0,1.0,0.0,James F. Brennan RECAP,1.0
44041,44041,100,19,5,14,0,32,70,33,37,0,0.2714285714285714,0.07142857142857142,0.2,0.0,0.45714285714285713,0.4714285714285714,0.5285714285714286,0.0,James F. Brennan RECAP,0.5285714285714286
44042,44042,100,11,37,35,0,97,180,46,134,0,0.06111111111111111,0.20555555555555555,0.19444444444444445,0.0,0.5388888888888889,0.25555555555555554,0.7444444444444445,0.0,James F. Brennan RECAP,0.7444444444444445
44043,44043,100,17,42,45,1,157,262,62,199,1,0.0648854961832061,0.16030534351145037,0.1717557251908397,0.003816793893129771,0.5992366412213741,0.2366412213740458,0.7595419847328244,0.003816793893129771,James F. Brennan RECAP,0.7595419847328244
44044,44044,100,9,19,21,0,61,110,30,80,0,0.08181818181818182,0.17272727272727273,0.19090909090909092,0.0,0.5545454545454546,0.2727272727272727,0.7272727272727273,0.0,James F. Brennan RECAP,0.7272727272727273
44045,44045,100,3,36,19,0,85,143,22,121,0,0.02097902097902098,0.2517482517482518,0.13286713286713286,0.0,0.5944055944055944,0.15384615384615385,0.8461538461538461,0.0,James F. Brennan RECAP,0.8461538461538461
44046,44046,100,1,26,2,0,76,105,3,102,0,0.009523809523809525,0.24761904761904763,0.01904761904761905,0.0,0.7238095238095238,0.02857142857142857,0.9714285714285714,0.0,James F. Brennan RECAP,0.9714285714285714
44047,44047,100,1,5,4,0,24,34,5,29,0,0.029411764705882353,0.14705882352941177,0.11764705882352941,0.0,0.7058823529411765,0.14705882352941177,0.8529411764705882,0.0,James F. Brennan RECAP,0.8529411764705882
44048,44048,100,4,36,8,0,126,174,12,162,0,0.022988505747126436,0.20689655172413793,0.04597701149425287,0.0,0.7241379310344828,0.06896551724137931,0.9310344827586207,0.0,James F. Brennan RECAP,0.9310344827586207
44049,44049,100,9,79,20,0,227,335,29,306,0,0.026865671641791045,0.23582089552238805,0.05970149253731343,0.0,0.6776119402985075,0.08656716417910448,0.9134328358208955,0.0,James F. Brennan RECAP,0.9134328358208955
44050,44050,100,4,92,12,0,174,282,16,266,0,0.014184397163120567,0.3262411347517731,0.0425531914893617,0.0,0.6170212765957447,0.05673758865248227,0.9432624113475178,0.0,James F. Brennan RECAP,0.9432624113475178
44051,44051,100,9,86,21,0,170,286,30,256,0,0.03146853146853147,0.3006993006993007,0.07342657342657342,0.0,0.5944055944055944,0.1048951048951049,0.8951048951048951,0.0,James F. Brennan RECAP,0.8951048951048951
44052,44052,100,17,119,13,1,226,376,30,345,1,0.04521276595744681,0.31648936170212766,0.034574468085106384,0.0026595744680851063,0.601063829787234,0.0797872340425532,0.9175531914893617,0.0026595744680851063,James F. Brennan RECAP,0.9175531914893617
44053,44053,100,20,100,20,1,176,317,40,276,1,0.06309148264984227,0.31545741324921134,0.06309148264984227,0.0031545741324921135,0.555205047318612,0.12618296529968454,0.8706624605678234,0.0031545741324921135,James F. Brennan RECAP,0.8706624605678234
44054,44054,100,15,160,19,0,234,428,34,394,0,0.035046728971962614,0.37383177570093457,0.04439252336448598,0.0,0.5467289719626168,0.0794392523364486,0.9205607476635514,0.0,James F. Brennan RECAP,0.9205607476635514
44055,44055,100,16,140,40,0,222,418,56,362,0,0.03827751196172249,0.3349282296650718,0.09569377990430622,0.0,0.5311004784688995,0.1339712918660287,0.8660287081339713,0.0,James F. Brennan RECAP,0.8660287081339713
44056,44056,100,9,71,17,0,131,228,26,202,0,0.039473684210526314,0.31140350877192985,0.07456140350877193,0.0,0.5745614035087719,0.11403508771929824,0.8859649122807017,0.0,James F. Brennan RECAP,0.8859649122807017
44057,44057,100,16,145,25,1,236,423,41,381,1,0.037825059101654845,0.34278959810874704,0.0591016548463357,0.002364066193853428,0.557919621749409,0.09692671394799054,0.900709219858156,0.002364066193853428,James F. Brennan RECAP,0.900709219858156
44058,44058,100,35,125,23,0,180,363,58,305,0,0.09641873278236915,0.3443526170798898,0.06336088154269973,0.0,0.49586776859504134,0.15977961432506887,0.8402203856749312,0.0,James F. Brennan RECAP,0.8402203856749312
44059,44059,100,19,97,23,0,160,299,42,257,0,0.06354515050167224,0.32441471571906355,0.07692307692307693,0.0,0.5351170568561873,0.14046822742474915,0.8595317725752508,0.0,James F. Brennan RECAP,0.8595317725752508
44060,44060,100,15,65,13,0,184,277,28,249,0,0.05415162454873646,0.23465703971119134,0.04693140794223827,0.0,0.6642599277978339,0.10108303249097472,0.8989169675090253,0.0,James F. Brennan RECAP,0.8989169675090253
44061,44061,100,3,53,3,0,103,162,6,156,0,0.018518518518518517,0.3271604938271605,0.018518518518518517,0.0,0.6358024691358025,0.037037037037037035,0.9629629629629629,0.0,James F. Brennan RECAP,0.9629629629629629
44062,44062,100,11,70,10,0,103,194,21,173,0,0.05670103092783505,0.36082474226804123,0.05154639175257732,0.0,0.5309278350515464,0.10824742268041238,0.8917525773195877,0.0,James F. Brennan RECAP,0.8917525773195877
44063,44063,100,6,65,4,0,119,194,10,184,0,0.030927835051546393,0.33505154639175255,0.020618556701030927,0.0,0.6134020618556701,0.05154639175257732,0.9484536082474226,0.0,James F. Brennan RECAP,0.9484536082474226
44064,44064,100,1,34,6,0,42,83,7,76,0,0.012048192771084338,0.40963855421686746,0.07228915662650602,0.0,0.5060240963855421,0.08433734939759036,0.9156626506024096,0.0,James F. Brennan RECAP,0.9156626506024096
44065,44065,100,4,96,14,0,182,296,18,278,0,0.013513513513513514,0.32432432432432434,0.0472972972972973,0.0,0.6148648648648649,0.060810810810810814,0.9391891891891891,0.0,James F. Brennan RECAP,0.9391891891891891
44066,44066,100,5,52,7,0,99,163,12,151,0,0.03067484662576687,0.31901840490797545,0.04294478527607362,0.0,0.6073619631901841,0.0736196319018405,0.9263803680981595,0.0,James F. Brennan RECAP,0.9263803680981595
44067,44067,100,35,14,41,0,86,176,76,100,0,0.19886363636363635,0.07954545454545454,0.23295454545454544,0.0,0.48863636363636365,0.4318181818181818,0.5681818181818182,0.0,James F. Brennan RECAP,0.5681818181818182
44068,44068,100,4,60,4,0,118,186,8,178,0,0.021505376344086023,0.3225806451612903,0.021505376344086023,0.0,0.6344086021505376,0.043010752688172046,0.956989247311828,0.0,James F. Brennan RECAP,0.956989247311828
44069,44069,100,20,155,6,0,191,372,26,346,0,0.053763440860215055,0.4166666666666667,0.016129032258064516,0.0,0.5134408602150538,0.06989247311827956,0.9301075268817204,0.0,James F. Brennan RECAP,0.9301075268817204
44070,44070,100,13,79,10,1,134,237,23,213,1,0.05485232067510549,0.3333333333333333,0.04219409282700422,0.004219409282700422,0.5654008438818565,0.0970464135021097,0.8987341772151899,0.004219409282700422,James F. Brennan RECAP,0.8987341772151899
44071,44071,100,19,129,12,0,191,351,31,320,0,0.05413105413105413,0.36752136752136755,0.03418803418803419,0.0,0.5441595441595442,0.08831908831908832,0.9116809116809117,0.0,James F. Brennan RECAP,0.9116809116809117
44072,44072,100,5,105,10,0,176,296,15,281,0,0.016891891891891893,0.3547297297297297,0.033783783783783786,0.0,0.5945945945945946,0.05067567567567568,0.9493243243243243,0.0,James F. Brennan RECAP,0.9493243243243243
44073,44073,100,16,100,14,0,175,305,30,275,0,0.05245901639344262,0.32786885245901637,0.04590163934426229,0.0,0.5737704918032787,0.09836065573770492,0.9016393442622951,0.0,James F. Brennan RECAP,0.9016393442622951
44074,44074,100,10,138,17,0,202,367,27,340,0,0.027247956403269755,0.3760217983651226,0.04632152588555858,0.0,0.5504087193460491,0.07356948228882834,0.9264305177111717,0.0,James F. Brennan RECAP,0.9264305177111717
44075,44075,100,7,126,23,0,175,331,30,301,0,0.021148036253776436,0.3806646525679758,0.06948640483383686,0.0,0.5287009063444109,0.09063444108761329,0.9093655589123867,0.0,James F. Brennan RECAP,0.9093655589123867
44076,44076,100,4,86,10,0,184,284,14,270,0,0.014084507042253521,0.3028169014084507,0.035211267605633804,0.0,0.647887323943662,0.04929577464788732,0.9507042253521126,0.0,James F. Brennan RECAP,0.9507042253521126
44077,44077,100,10,94,16,0,186,306,26,280,0,0.032679738562091505,0.30718954248366015,0.05228758169934641,0.0,0.6078431372549019,0.08496732026143791,0.9150326797385621,0.0,James F. Brennan RECAP,0.9150326797385621
44078,44078,100,10,179,10,1,219,419,20,398,1,0.02386634844868735,0.42720763723150357,0.02386634844868735,0.002386634844868735,0.522673031026253,0.0477326968973747,0.9498806682577565,0.002386634844868735,James F. Brennan RECAP,0.9498806682577565
44079,44079,100,14,100,14,0,215,343,28,315,0,0.04081632653061224,0.2915451895043732,0.04081632653061224,0.0,0.6268221574344023,0.08163265306122448,0.9183673469387755,0.0,James F. Brennan RECAP,0.9183673469387755
44080,44080,100,5,113,15,0,145,278,20,258,0,0.017985611510791366,0.4064748201438849,0.0539568345323741,0.0,0.5215827338129496,0.07194244604316546,0.9280575539568345,0.0,James F. Brennan RECAP,0.9280575539568345
44081,44081,100,12,6,37,0,52,107,49,58,0,0.11214953271028037,0.056074766355140186,0.34579439252336447,0.0,0.48598130841121495,0.45794392523364486,0.5420560747663551,0.0,James F. Brennan RECAP,0.5420560747663551
44082,44082,100,0,0,0,0,0,0,0,0,0,0,0,0,0,0,0,0,0,n/a,0
44083,44083,100,0,0,0,0,0,0,0,0,0,0,0,0,0,0,0,0,0,n/a,0
44084,44084,100,0,0,0,0,0,0,0,0,0,0,0,0,0,0,0,0,0,n/a,0
