ED,Reported As,Reporting,Scattered,Velmanette Montgomery (Democratic),Velmanette Montgomery (Working Families),Total Votes,Scattered RECAP,Velmanette Montgomery RECAP,p_Scattered,p_Velmanette Montgomery (Democratic),p_Velmanette Montgomery (Working Families),p_Scattered RECAP,p_Velmanette Montgomery RECAP,winner,winner_p
43012,43012,100,0,188,16,204,0,204,0.0,0.9215686274509803,0.0784313725490196,0.0,1.0,Velmanette Montgomery RECAP,1.0
43045,43045,100,0,164,42,206,0,206,0.0,0.7961165048543689,0.20388349514563106,0.0,1.0,Velmanette Montgomery RECAP,1.0
43046,43046,100,0,94,17,111,0,111,0.0,0.8468468468468469,0.15315315315315314,0.0,1.0,Velmanette Montgomery RECAP,1.0
43047,43047,100,0,157,40,197,0,197,0.0,0.7969543147208121,0.20304568527918782,0.0,1.0,Velmanette Montgomery RECAP,1.0
43048,43048,100,0,220,23,243,0,243,0.0,0.9053497942386831,0.09465020576131687,0.0,1.0,Velmanette Montgomery RECAP,1.0
43049,43049,100,0,248,18,266,0,266,0.0,0.9323308270676691,0.06766917293233082,0.0,1.0,Velmanette Montgomery RECAP,1.0
43050,43050,100,1,145,21,167,1,166,0.005988023952095809,0.8682634730538922,0.12574850299401197,0.005988023952095809,0.9940119760479041,Velmanette Montgomery RECAP,0.9940119760479041
43051,43051,100,0,262,21,283,0,283,0.0,0.9257950530035336,0.07420494699646643,0.0,1.0,Velmanette Montgomery RECAP,1.0
43072,43072,100,0,211,38,249,0,249,0.0,0.8473895582329317,0.15261044176706828,0.0,1.0,Velmanette Montgomery RECAP,1.0
50001,50001,100,0,18,11,29,0,29,0.0,0.6206896551724138,0.3793103448275862,0.0,1.0,Velmanette Montgomery RECAP,1.0
50014,50014,100,0,80,4,84,0,84,0.0,0.9523809523809523,0.047619047619047616,0.0,1.0,Velmanette Montgomery RECAP,1.0
50083,50083,100,0,62,7,69,0,69,0.0,0.8985507246376812,0.10144927536231885,0.0,1.0,Velmanette Montgomery RECAP,1.0
50084,50084,100,0,17,3,20,0,20,0.0,0.85,0.15,0.0,1.0,Velmanette Montgomery RECAP,1.0
50085,50085,100,1,20,23,44,1,43,0.022727272727272728,0.45454545454545453,0.5227272727272727,0.022727272727272728,0.9772727272727273,Velmanette Montgomery RECAP,0.9772727272727273
50086,50084,100,0,0,0,0,0,0,0,0,0,0,0,n/a,0
50088,50088,100,0,16,1,17,0,17,0.0,0.9411764705882353,0.058823529411764705,0.0,1.0,Velmanette Montgomery RECAP,1.0
50089,50089,100,1,130,70,201,1,200,0.004975124378109453,0.6467661691542289,0.3482587064676617,0.004975124378109453,0.9950248756218906,Velmanette Montgomery RECAP,0.9950248756218906
50090,50090,100,1,84,29,114,1,113,0.008771929824561403,0.7368421052631579,0.2543859649122807,0.008771929824561403,0.9912280701754386,Velmanette Montgomery RECAP,0.9912280701754386
50091,50091,100,1,168,68,237,1,236,0.004219409282700422,0.7088607594936709,0.2869198312236287,0.004219409282700422,0.9957805907172996,Velmanette Montgomery RECAP,0.9957805907172996
50092,50092,100,1,152,49,202,1,201,0.0049504950495049506,0.7524752475247525,0.24257425742574257,0.0049504950495049506,0.995049504950495,Velmanette Montgomery RECAP,0.995049504950495
50093,50093,100,0,28,10,38,0,38,0.0,0.7368421052631579,0.2631578947368421,0.0,1.0,Velmanette Montgomery RECAP,1.0
50095,50095,100,0,0,0,0,0,0,0,0,0,0,0,n/a,0
50098,50088,100,0,0,0,0,0,0,0,0,0,0,0,n/a,0
51008,51008,100,1,44,12,57,1,56,0.017543859649122806,0.7719298245614035,0.21052631578947367,0.017543859649122806,0.9824561403508771,Velmanette Montgomery RECAP,0.9824561403508771
51044,51044,100,0,17,11,28,0,28,0.0,0.6071428571428571,0.39285714285714285,0.0,1.0,Velmanette Montgomery RECAP,1.0
51045,51045,100,0,2,0,2,0,2,0.0,1.0,0.0,0.0,1.0,Velmanette Montgomery RECAP,1.0
51046,51046,100,0,3,4,7,0,7,0.0,0.42857142857142855,0.5714285714285714,0.0,1.0,Velmanette Montgomery RECAP,1.0
51048,51048,100,0,0,0,0,0,0,0,0,0,0,0,n/a,0
51049,51049,100,5,113,57,175,5,170,0.02857142857142857,0.6457142857142857,0.32571428571428573,0.02857142857142857,0.9714285714285714,Velmanette Montgomery RECAP,0.9714285714285714
51050,51050,100,0,33,3,36,0,36,0.0,0.9166666666666666,0.08333333333333333,0.0,1.0,Velmanette Montgomery RECAP,1.0
51051,51051,100,0,94,32,126,0,126,0.0,0.746031746031746,0.25396825396825395,0.0,1.0,Velmanette Montgomery RECAP,1.0
51052,51052,100,2,106,19,127,2,125,0.015748031496062992,0.8346456692913385,0.14960629921259844,0.015748031496062992,0.984251968503937,Velmanette Montgomery RECAP,0.984251968503937
51053,51053,100,0,72,14,86,0,86,0.0,0.8372093023255814,0.16279069767441862,0.0,1.0,Velmanette Montgomery RECAP,1.0
51054,51054,100,0,50,14,64,0,64,0.0,0.78125,0.21875,0.0,1.0,Velmanette Montgomery RECAP,1.0
51055,51055,100,0,109,44,153,0,153,0.0,0.7124183006535948,0.2875816993464052,0.0,1.0,Velmanette Montgomery RECAP,1.0
51068,51068,100,0,26,19,45,0,45,0.0,0.5777777777777777,0.4222222222222222,0.0,1.0,Velmanette Montgomery RECAP,1.0
51069,51069,100,0,100,9,109,0,109,0.0,0.9174311926605505,0.08256880733944955,0.0,1.0,Velmanette Montgomery RECAP,1.0
51070,51070,100,0,162,7,169,0,169,0.0,0.9585798816568047,0.04142011834319527,0.0,1.0,Velmanette Montgomery RECAP,1.0
51071,51071,100,0,156,15,171,0,171,0.0,0.9122807017543859,0.08771929824561403,0.0,1.0,Velmanette Montgomery RECAP,1.0
51072,51072,100,0,61,33,94,0,94,0.0,0.648936170212766,0.35106382978723405,0.0,1.0,Velmanette Montgomery RECAP,1.0
51073,51073,100,0,114,30,144,0,144,0.0,0.7916666666666666,0.20833333333333334,0.0,1.0,Velmanette Montgomery RECAP,1.0
51074,51074,100,0,117,2,119,0,119,0.0,0.9831932773109243,0.01680672268907563,0.0,1.0,Velmanette Montgomery RECAP,1.0
51075,51072,100,0,0,0,0,0,0,0,0,0,0,0,n/a,0
51077,51048,100,0,0,0,0,0,0,0,0,0,0,0,n/a,0
51078,51044,100,0,0,0,0,0,0,0,0,0,0,0,n/a,0
52003,52003,100,1,41,16,58,1,57,0.017241379310344827,0.7068965517241379,0.27586206896551724,0.017241379310344827,0.9827586206896551,Velmanette Montgomery RECAP,0.9827586206896551
52022,52022,100,0,102,41,143,0,143,0.0,0.7132867132867133,0.2867132867132867,0.0,1.0,Velmanette Montgomery RECAP,1.0
52023,52023,100,4,401,134,539,4,535,0.0074211502782931356,0.7439703153988868,0.24860853432282004,0.0074211502782931356,0.9925788497217068,Velmanette Montgomery RECAP,0.9925788497217068
52024,52024,100,0,30,15,45,0,45,0.0,0.6666666666666666,0.3333333333333333,0.0,1.0,Velmanette Montgomery RECAP,1.0
52025,52025,100,4,105,23,132,4,128,0.030303030303030304,0.7954545454545454,0.17424242424242425,0.030303030303030304,0.9696969696969697,Velmanette Montgomery RECAP,0.9696969696969697
52027,52027,100,1,69,22,92,1,91,0.010869565217391304,0.75,0.2391304347826087,0.010869565217391304,0.9891304347826086,Velmanette Montgomery RECAP,0.9891304347826086
52028,52028,100,2,222,52,276,2,274,0.007246376811594203,0.8043478260869565,0.18840579710144928,0.007246376811594203,0.9927536231884058,Velmanette Montgomery RECAP,0.9927536231884058
52029,52029,100,2,201,61,264,2,262,0.007575757575757576,0.7613636363636364,0.23106060606060605,0.007575757575757576,0.9924242424242424,Velmanette Montgomery RECAP,0.9924242424242424
52030,52030,100,1,206,52,259,1,258,0.003861003861003861,0.7953667953667953,0.20077220077220076,0.003861003861003861,0.9961389961389961,Velmanette Montgomery RECAP,0.9961389961389961
52031,52031,100,1,218,87,306,1,305,0.0032679738562091504,0.7124183006535948,0.28431372549019607,0.0032679738562091504,0.9967320261437909,Velmanette Montgomery RECAP,0.9967320261437909
52032,52032,100,2,188,64,254,2,252,0.007874015748031496,0.7401574803149606,0.25196850393700787,0.007874015748031496,0.9921259842519685,Velmanette Montgomery RECAP,0.9921259842519685
52033,52033,100,0,193,103,296,0,296,0.0,0.652027027027027,0.34797297297297297,0.0,1.0,Velmanette Montgomery RECAP,1.0
52048,52048,100,2,181,101,284,2,282,0.007042253521126761,0.6373239436619719,0.35563380281690143,0.007042253521126761,0.9929577464788732,Velmanette Montgomery RECAP,0.9929577464788732
52049,52049,100,1,190,72,263,1,262,0.0038022813688212928,0.7224334600760456,0.2737642585551331,0.0038022813688212928,0.9961977186311787,Velmanette Montgomery RECAP,0.9961977186311787
52050,52050,100,1,72,20,93,1,92,0.010752688172043012,0.7741935483870968,0.21505376344086022,0.010752688172043012,0.989247311827957,Velmanette Montgomery RECAP,0.989247311827957
52051,52051,100,1,154,13,168,1,167,0.005952380952380952,0.9166666666666666,0.07738095238095238,0.005952380952380952,0.9940476190476191,Velmanette Montgomery RECAP,0.9940476190476191
52052,52052,100,0,117,4,121,0,121,0.0,0.9669421487603306,0.03305785123966942,0.0,1.0,Velmanette Montgomery RECAP,1.0
52053,52053,100,2,227,91,320,2,318,0.00625,0.709375,0.284375,0.00625,0.99375,Velmanette Montgomery RECAP,0.99375
52054,52054,100,0,106,4,110,0,110,0.0,0.9636363636363636,0.03636363636363636,0.0,1.0,Velmanette Montgomery RECAP,1.0
52055,52055,100,2,215,47,264,2,262,0.007575757575757576,0.8143939393939394,0.17803030303030304,0.007575757575757576,0.9924242424242424,Velmanette Montgomery RECAP,0.9924242424242424
52056,52056,100,1,101,21,123,1,122,0.008130081300813009,0.8211382113821138,0.17073170731707318,0.008130081300813009,0.991869918699187,Velmanette Montgomery RECAP,0.991869918699187
52057,52057,100,1,136,64,201,1,200,0.004975124378109453,0.6766169154228856,0.31840796019900497,0.004975124378109453,0.9950248756218906,Velmanette Montgomery RECAP,0.9950248756218906
52058,52058,100,0,129,65,194,0,194,0.0,0.6649484536082474,0.33505154639175255,0.0,1.0,Velmanette Montgomery RECAP,1.0
52059,52059,100,0,208,109,317,0,317,0.0,0.6561514195583596,0.3438485804416404,0.0,1.0,Velmanette Montgomery RECAP,1.0
52060,52060,100,0,167,81,248,0,248,0.0,0.6733870967741935,0.32661290322580644,0.0,1.0,Velmanette Montgomery RECAP,1.0
52061,52061,100,0,169,79,248,0,248,0.0,0.6814516129032258,0.3185483870967742,0.0,1.0,Velmanette Montgomery RECAP,1.0
52062,52062,100,3,196,85,284,3,281,0.01056338028169014,0.6901408450704225,0.2992957746478873,0.01056338028169014,0.9894366197183099,Velmanette Montgomery RECAP,0.9894366197183099
52063,52063,100,0,1,0,1,0,1,0.0,1.0,0.0,0.0,1.0,Velmanette Montgomery RECAP,1.0
52089,52089,100,4,192,131,327,4,323,0.012232415902140673,0.5871559633027523,0.40061162079510704,0.012232415902140673,0.9877675840978594,Velmanette Montgomery RECAP,0.9877675840978594
52090,52090,100,2,175,99,276,2,274,0.007246376811594203,0.6340579710144928,0.358695652173913,0.007246376811594203,0.9927536231884058,Velmanette Montgomery RECAP,0.9927536231884058
52091,52091,100,1,83,48,132,1,131,0.007575757575757576,0.6287878787878788,0.36363636363636365,0.007575757575757576,0.9924242424242424,Velmanette Montgomery RECAP,0.9924242424242424
52095,52095,100,0,11,6,17,0,17,0.0,0.6470588235294118,0.35294117647058826,0.0,1.0,Velmanette Montgomery RECAP,1.0
52096,52096,100,1,168,89,258,1,257,0.003875968992248062,0.6511627906976745,0.3449612403100775,0.003875968992248062,0.9961240310077519,Velmanette Montgomery RECAP,0.9961240310077519
52097,52097,100,1,129,44,174,1,173,0.005747126436781609,0.7413793103448276,0.25287356321839083,0.005747126436781609,0.9942528735632183,Velmanette Montgomery RECAP,0.9942528735632183
52098,52098,100,2,193,77,272,2,270,0.007352941176470588,0.7095588235294118,0.28308823529411764,0.007352941176470588,0.9926470588235294,Velmanette Montgomery RECAP,0.9926470588235294
52099,52099,100,1,182,100,283,1,282,0.0035335689045936395,0.6431095406360424,0.35335689045936397,0.0035335689045936395,0.9964664310954063,Velmanette Montgomery RECAP,0.9964664310954063
52100,52100,100,3,103,46,152,3,149,0.019736842105263157,0.6776315789473685,0.3026315789473684,0.019736842105263157,0.9802631578947368,Velmanette Montgomery RECAP,0.9802631578947368
52102,52102,100,0,1,0,1,0,1,0.0,1.0,0.0,0.0,1.0,Velmanette Montgomery RECAP,1.0
52104,52104,100,2,189,42,233,2,231,0.008583690987124463,0.8111587982832618,0.18025751072961374,0.008583690987124463,0.9914163090128756,Velmanette Montgomery RECAP,0.9914163090128756
52106,52106,100,0,3,0,3,0,3,0.0,1.0,0.0,0.0,1.0,Velmanette Montgomery RECAP,1.0
52108,52102,100,0,0,0,0,0,0,0,0,0,0,0,n/a,0
52112,52112,100,0,0,0,0,0,0,0,0,0,0,0,n/a,0
52113,52112,100,0,0,0,0,0,0,0,0,0,0,0,n/a,0
52114,52114,100,0,0,0,0,0,0,0,0,0,0,0,n/a,0
54015,54015,100,0,68,11,79,0,79,0.0,0.8607594936708861,0.13924050632911392,0.0,1.0,Velmanette Montgomery RECAP,1.0
54026,54026,100,0,9,2,11,0,11,0.0,0.8181818181818182,0.18181818181818182,0.0,1.0,Velmanette Montgomery RECAP,1.0
55002,55002,100,0,50,11,61,0,61,0.0,0.819672131147541,0.18032786885245902,0.0,1.0,Velmanette Montgomery RECAP,1.0
55004,55004,100,0,207,19,226,0,226,0.0,0.915929203539823,0.084070796460177,0.0,1.0,Velmanette Montgomery RECAP,1.0
55008,55008,100,0,31,4,35,0,35,0.0,0.8857142857142857,0.11428571428571428,0.0,1.0,Velmanette Montgomery RECAP,1.0
55009,55009,100,3,124,7,134,3,131,0.022388059701492536,0.9253731343283582,0.05223880597014925,0.022388059701492536,0.9776119402985075,Velmanette Montgomery RECAP,0.9776119402985075
55010,55010,100,0,170,9,179,0,179,0.0,0.9497206703910615,0.05027932960893855,0.0,1.0,Velmanette Montgomery RECAP,1.0
55011,55011,100,0,164,10,174,0,174,0.0,0.9425287356321839,0.05747126436781609,0.0,1.0,Velmanette Montgomery RECAP,1.0
55012,55012,100,0,174,19,193,0,193,0.0,0.9015544041450777,0.09844559585492228,0.0,1.0,Velmanette Montgomery RECAP,1.0
55017,55017,100,0,79,0,79,0,79,0.0,1.0,0.0,0.0,1.0,Velmanette Montgomery RECAP,1.0
55018,55018,100,1,223,16,240,1,239,0.004166666666666667,0.9291666666666667,0.06666666666666667,0.004166666666666667,0.9958333333333333,Velmanette Montgomery RECAP,0.9958333333333333
55019,55019,100,0,214,11,225,0,225,0.0,0.9511111111111111,0.04888888888888889,0.0,1.0,Velmanette Montgomery RECAP,1.0
55020,55020,100,1,153,5,159,1,158,0.006289308176100629,0.9622641509433962,0.031446540880503145,0.006289308176100629,0.9937106918238994,Velmanette Montgomery RECAP,0.9937106918238994
55021,55021,100,0,120,8,128,0,128,0.0,0.9375,0.0625,0.0,1.0,Velmanette Montgomery RECAP,1.0
55022,55022,100,0,123,1,124,0,124,0.0,0.9919354838709677,0.008064516129032258,0.0,1.0,Velmanette Montgomery RECAP,1.0
55023,55023,100,0,177,14,191,0,191,0.0,0.9267015706806283,0.07329842931937172,0.0,1.0,Velmanette Montgomery RECAP,1.0
55024,55024,100,0,127,2,129,0,129,0.0,0.9844961240310077,0.015503875968992248,0.0,1.0,Velmanette Montgomery RECAP,1.0
55025,55025,100,0,150,5,155,0,155,0.0,0.967741935483871,0.03225806451612903,0.0,1.0,Velmanette Montgomery RECAP,1.0
55028,55028,100,0,59,2,61,0,61,0.0,0.9672131147540983,0.03278688524590164,0.0,1.0,Velmanette Montgomery RECAP,1.0
55029,55029,100,0,59,1,60,0,60,0.0,0.9833333333333333,0.016666666666666666,0.0,1.0,Velmanette Montgomery RECAP,1.0
55030,55030,100,0,57,1,58,0,58,0.0,0.9827586206896551,0.017241379310344827,0.0,1.0,Velmanette Montgomery RECAP,1.0
55031,55031,100,0,355,17,372,0,372,0.0,0.9543010752688172,0.0456989247311828,0.0,1.0,Velmanette Montgomery RECAP,1.0
55032,55032,100,0,77,3,80,0,80,0.0,0.9625,0.0375,0.0,1.0,Velmanette Montgomery RECAP,1.0
55033,55033,100,0,131,8,139,0,139,0.0,0.9424460431654677,0.05755395683453238,0.0,1.0,Velmanette Montgomery RECAP,1.0
55034,55034,100,0,187,7,194,0,194,0.0,0.9639175257731959,0.03608247422680412,0.0,1.0,Velmanette Montgomery RECAP,1.0
55101,55101,100,0,107,5,112,0,112,0.0,0.9553571428571429,0.044642857142857144,0.0,1.0,Velmanette Montgomery RECAP,1.0
55102,55102,100,1,112,7,120,1,119,0.008333333333333333,0.9333333333333333,0.058333333333333334,0.008333333333333333,0.9916666666666667,Velmanette Montgomery RECAP,0.9916666666666667
55103,55103,100,0,151,13,164,0,164,0.0,0.9207317073170732,0.07926829268292683,0.0,1.0,Velmanette Montgomery RECAP,1.0
55104,55104,100,0,173,12,185,0,185,0.0,0.9351351351351351,0.06486486486486487,0.0,1.0,Velmanette Montgomery RECAP,1.0
55108,55108,100,0,0,0,0,0,0,0,0,0,0,0,n/a,0
56005,56005,100,0,111,9,120,0,120,0.0,0.925,0.075,0.0,1.0,Velmanette Montgomery RECAP,1.0
56012,56012,100,0,172,37,209,0,209,0.0,0.8229665071770335,0.17703349282296652,0.0,1.0,Velmanette Montgomery RECAP,1.0
56013,56013,100,0,143,13,156,0,156,0.0,0.9166666666666666,0.08333333333333333,0.0,1.0,Velmanette Montgomery RECAP,1.0
56014,56014,100,1,157,27,185,1,184,0.005405405405405406,0.8486486486486486,0.14594594594594595,0.005405405405405406,0.9945945945945946,Velmanette Montgomery RECAP,0.9945945945945946
56015,56015,100,0,159,17,176,0,176,0.0,0.9034090909090909,0.09659090909090909,0.0,1.0,Velmanette Montgomery RECAP,1.0
56016,56016,100,1,225,36,262,1,261,0.003816793893129771,0.8587786259541985,0.13740458015267176,0.003816793893129771,0.9961832061068703,Velmanette Montgomery RECAP,0.9961832061068703
56018,56018,100,1,179,33,213,1,212,0.004694835680751174,0.8403755868544601,0.15492957746478872,0.004694835680751174,0.9953051643192489,Velmanette Montgomery RECAP,0.9953051643192489
56019,56019,100,0,194,16,210,0,210,0.0,0.9238095238095239,0.0761904761904762,0.0,1.0,Velmanette Montgomery RECAP,1.0
56021,56021,100,0,156,16,172,0,172,0.0,0.9069767441860465,0.09302325581395349,0.0,1.0,Velmanette Montgomery RECAP,1.0
56022,56022,100,0,220,12,232,0,232,0.0,0.9482758620689655,0.05172413793103448,0.0,1.0,Velmanette Montgomery RECAP,1.0
56023,56023,100,1,176,21,198,1,197,0.005050505050505051,0.8888888888888888,0.10606060606060606,0.005050505050505051,0.9949494949494949,Velmanette Montgomery RECAP,0.9949494949494949
56024,56024,100,0,164,14,178,0,178,0.0,0.9213483146067416,0.07865168539325842,0.0,1.0,Velmanette Montgomery RECAP,1.0
56025,56025,100,0,175,14,189,0,189,0.0,0.9259259259259259,0.07407407407407407,0.0,1.0,Velmanette Montgomery RECAP,1.0
56026,56026,100,0,209,20,229,0,229,0.0,0.9126637554585153,0.08733624454148471,0.0,1.0,Velmanette Montgomery RECAP,1.0
56027,56027,100,0,161,20,181,0,181,0.0,0.8895027624309392,0.11049723756906077,0.0,1.0,Velmanette Montgomery RECAP,1.0
56028,56028,100,0,180,20,200,0,200,0.0,0.9,0.1,0.0,1.0,Velmanette Montgomery RECAP,1.0
56029,56029,100,0,124,7,131,0,131,0.0,0.9465648854961832,0.05343511450381679,0.0,1.0,Velmanette Montgomery RECAP,1.0
56030,56030,100,0,196,9,205,0,205,0.0,0.9560975609756097,0.04390243902439024,0.0,1.0,Velmanette Montgomery RECAP,1.0
56031,56031,100,0,143,13,156,0,156,0.0,0.9166666666666666,0.08333333333333333,0.0,1.0,Velmanette Montgomery RECAP,1.0
56032,56032,100,0,220,15,235,0,235,0.0,0.9361702127659575,0.06382978723404255,0.0,1.0,Velmanette Montgomery RECAP,1.0
56033,56033,100,0,212,25,237,0,237,0.0,0.8945147679324894,0.10548523206751055,0.0,1.0,Velmanette Montgomery RECAP,1.0
56034,56034,100,0,135,21,156,0,156,0.0,0.8653846153846154,0.1346153846153846,0.0,1.0,Velmanette Montgomery RECAP,1.0
56035,56035,100,0,197,26,223,0,223,0.0,0.8834080717488789,0.11659192825112108,0.0,1.0,Velmanette Montgomery RECAP,1.0
56036,56036,100,0,190,33,223,0,223,0.0,0.852017937219731,0.14798206278026907,0.0,1.0,Velmanette Montgomery RECAP,1.0
56037,56037,100,0,212,45,257,0,257,0.0,0.8249027237354085,0.17509727626459143,0.0,1.0,Velmanette Montgomery RECAP,1.0
56038,56038,100,1,204,37,242,1,241,0.004132231404958678,0.8429752066115702,0.15289256198347106,0.004132231404958678,0.9958677685950413,Velmanette Montgomery RECAP,0.9958677685950413
56039,56039,100,0,177,26,203,0,203,0.0,0.8719211822660099,0.12807881773399016,0.0,1.0,Velmanette Montgomery RECAP,1.0
56040,56040,100,0,217,29,246,0,246,0.0,0.8821138211382114,0.11788617886178862,0.0,1.0,Velmanette Montgomery RECAP,1.0
56041,56041,100,0,150,22,172,0,172,0.0,0.872093023255814,0.12790697674418605,0.0,1.0,Velmanette Montgomery RECAP,1.0
56042,56042,100,1,230,29,260,1,259,0.0038461538461538464,0.8846153846153846,0.11153846153846154,0.0038461538461538464,0.9961538461538462,Velmanette Montgomery RECAP,0.9961538461538462
56043,56043,100,0,250,27,277,0,277,0.0,0.9025270758122743,0.09747292418772563,0.0,1.0,Velmanette Montgomery RECAP,1.0
56044,56044,100,0,249,19,268,0,268,0.0,0.9291044776119403,0.0708955223880597,0.0,1.0,Velmanette Montgomery RECAP,1.0
56045,56045,100,0,171,27,198,0,198,0.0,0.8636363636363636,0.13636363636363635,0.0,1.0,Velmanette Montgomery RECAP,1.0
56046,56046,100,0,252,18,270,0,270,0.0,0.9333333333333333,0.06666666666666667,0.0,1.0,Velmanette Montgomery RECAP,1.0
56047,56047,100,1,230,28,259,1,258,0.003861003861003861,0.888030888030888,0.10810810810810811,0.003861003861003861,0.9961389961389961,Velmanette Montgomery RECAP,0.9961389961389961
56048,56048,100,0,199,14,213,0,213,0.0,0.9342723004694836,0.06572769953051644,0.0,1.0,Velmanette Montgomery RECAP,1.0
56049,56049,100,1,287,44,332,1,331,0.0030120481927710845,0.8644578313253012,0.13253012048192772,0.0030120481927710845,0.9969879518072289,Velmanette Montgomery RECAP,0.9969879518072289
56050,56050,100,0,258,42,300,0,300,0.0,0.86,0.14,0.0,1.0,Velmanette Montgomery RECAP,1.0
56051,56051,100,0,236,19,255,0,255,0.0,0.9254901960784314,0.07450980392156863,0.0,1.0,Velmanette Montgomery RECAP,1.0
56052,56052,100,0,225,36,261,0,261,0.0,0.8620689655172413,0.13793103448275862,0.0,1.0,Velmanette Montgomery RECAP,1.0
56053,56053,100,0,202,21,223,0,223,0.0,0.905829596412556,0.09417040358744394,0.0,1.0,Velmanette Montgomery RECAP,1.0
56054,56054,100,1,192,17,210,1,209,0.004761904761904762,0.9142857142857143,0.08095238095238096,0.004761904761904762,0.9952380952380953,Velmanette Montgomery RECAP,0.9952380952380953
56055,56055,100,0,265,32,297,0,297,0.0,0.8922558922558923,0.10774410774410774,0.0,1.0,Velmanette Montgomery RECAP,1.0
56056,56056,100,0,92,13,105,0,105,0.0,0.8761904761904762,0.12380952380952381,0.0,1.0,Velmanette Montgomery RECAP,1.0
56057,56057,100,0,191,15,206,0,206,0.0,0.9271844660194175,0.07281553398058252,0.0,1.0,Velmanette Montgomery RECAP,1.0
56058,56058,100,1,232,32,265,1,264,0.0037735849056603774,0.8754716981132076,0.12075471698113208,0.0037735849056603774,0.9962264150943396,Velmanette Montgomery RECAP,0.9962264150943396
56059,56059,100,0,144,8,152,0,152,0.0,0.9473684210526315,0.05263157894736842,0.0,1.0,Velmanette Montgomery RECAP,1.0
56060,56060,100,0,56,3,59,0,59,0.0,0.9491525423728814,0.05084745762711865,0.0,1.0,Velmanette Montgomery RECAP,1.0
56061,56061,100,1,100,5,106,1,105,0.009433962264150943,0.9433962264150944,0.04716981132075472,0.009433962264150943,0.9905660377358491,Velmanette Montgomery RECAP,0.9905660377358491
56062,56062,100,0,200,7,207,0,207,0.0,0.966183574879227,0.033816425120772944,0.0,1.0,Velmanette Montgomery RECAP,1.0
56063,56063,100,0,144,6,150,0,150,0.0,0.96,0.04,0.0,1.0,Velmanette Montgomery RECAP,1.0
56064,56064,100,0,233,9,242,0,242,0.0,0.9628099173553719,0.0371900826446281,0.0,1.0,Velmanette Montgomery RECAP,1.0
56065,56065,100,0,107,12,119,0,119,0.0,0.8991596638655462,0.10084033613445378,0.0,1.0,Velmanette Montgomery RECAP,1.0
56066,56066,100,0,46,2,48,0,48,0.0,0.9583333333333334,0.041666666666666664,0.0,1.0,Velmanette Montgomery RECAP,1.0
56067,56067,100,0,65,5,70,0,70,0.0,0.9285714285714286,0.07142857142857142,0.0,1.0,Velmanette Montgomery RECAP,1.0
56068,56068,100,0,193,7,200,0,200,0.0,0.965,0.035,0.0,1.0,Velmanette Montgomery RECAP,1.0
56069,56069,100,0,166,23,189,0,189,0.0,0.8783068783068783,0.12169312169312169,0.0,1.0,Velmanette Montgomery RECAP,1.0
56070,56070,100,0,158,10,168,0,168,0.0,0.9404761904761905,0.05952380952380952,0.0,1.0,Velmanette Montgomery RECAP,1.0
56071,56071,100,0,190,15,205,0,205,0.0,0.926829268292683,0.07317073170731707,0.0,1.0,Velmanette Montgomery RECAP,1.0
56072,56072,100,0,255,28,283,0,283,0.0,0.901060070671378,0.0989399293286219,0.0,1.0,Velmanette Montgomery RECAP,1.0
56074,56074,100,0,127,9,136,0,136,0.0,0.9338235294117647,0.0661764705882353,0.0,1.0,Velmanette Montgomery RECAP,1.0
56079,56079,100,0,126,24,150,0,150,0.0,0.84,0.16,0.0,1.0,Velmanette Montgomery RECAP,1.0
56080,56080,100,0,103,25,128,0,128,0.0,0.8046875,0.1953125,0.0,1.0,Velmanette Montgomery RECAP,1.0
56082,56082,100,0,125,8,133,0,133,0.0,0.9398496240601504,0.06015037593984962,0.0,1.0,Velmanette Montgomery RECAP,1.0
57001,57001,100,0,120,3,123,0,123,0.0,0.975609756097561,0.024390243902439025,0.0,1.0,Velmanette Montgomery RECAP,1.0
57002,57002,100,0,149,5,154,0,154,0.0,0.9675324675324676,0.032467532467532464,0.0,1.0,Velmanette Montgomery RECAP,1.0
57003,57003,100,0,149,6,155,0,155,0.0,0.9612903225806452,0.03870967741935484,0.0,1.0,Velmanette Montgomery RECAP,1.0
57004,57004,100,0,57,20,77,0,77,0.0,0.7402597402597403,0.2597402597402597,0.0,1.0,Velmanette Montgomery RECAP,1.0
57005,57005,100,0,35,2,37,0,37,0.0,0.9459459459459459,0.05405405405405406,0.0,1.0,Velmanette Montgomery RECAP,1.0
57006,57006,100,0,164,7,171,0,171,0.0,0.9590643274853801,0.04093567251461988,0.0,1.0,Velmanette Montgomery RECAP,1.0
57007,57007,100,0,159,9,168,0,168,0.0,0.9464285714285714,0.05357142857142857,0.0,1.0,Velmanette Montgomery RECAP,1.0
57008,57008,100,0,118,9,127,0,127,0.0,0.9291338582677166,0.07086614173228346,0.0,1.0,Velmanette Montgomery RECAP,1.0
57009,57009,100,2,133,32,167,2,165,0.011976047904191617,0.7964071856287425,0.19161676646706588,0.011976047904191617,0.9880239520958084,Velmanette Montgomery RECAP,0.9880239520958084
57010,57010,100,2,218,56,276,2,274,0.007246376811594203,0.7898550724637681,0.2028985507246377,0.007246376811594203,0.9927536231884058,Velmanette Montgomery RECAP,0.9927536231884058
57011,57011,100,4,228,22,254,4,250,0.015748031496062992,0.8976377952755905,0.08661417322834646,0.015748031496062992,0.984251968503937,Velmanette Montgomery RECAP,0.984251968503937
57012,57012,100,0,164,16,180,0,180,0.0,0.9111111111111111,0.08888888888888889,0.0,1.0,Velmanette Montgomery RECAP,1.0
57013,57013,100,0,67,2,69,0,69,0.0,0.9710144927536232,0.028985507246376812,0.0,1.0,Velmanette Montgomery RECAP,1.0
57014,57014,100,2,86,32,120,2,118,0.016666666666666666,0.7166666666666667,0.26666666666666666,0.016666666666666666,0.9833333333333333,Velmanette Montgomery RECAP,0.9833333333333333
57015,57015,100,2,161,73,236,2,234,0.00847457627118644,0.6822033898305084,0.3093220338983051,0.00847457627118644,0.9915254237288136,Velmanette Montgomery RECAP,0.9915254237288136
57016,57016,100,0,216,82,298,0,298,0.0,0.7248322147651006,0.2751677852348993,0.0,1.0,Velmanette Montgomery RECAP,1.0
57017,57017,100,0,286,98,384,0,384,0.0,0.7447916666666666,0.2552083333333333,0.0,1.0,Velmanette Montgomery RECAP,1.0
57018,57018,100,1,361,50,412,1,411,0.0024271844660194173,0.8762135922330098,0.12135922330097088,0.0024271844660194173,0.9975728155339806,Velmanette Montgomery RECAP,0.9975728155339806
57019,57019,100,1,20,7,28,1,27,0.03571428571428571,0.7142857142857143,0.25,0.03571428571428571,0.9642857142857143,Velmanette Montgomery RECAP,0.9642857142857143
57020,57019,100,0,0,0,0,0,0,0,0,0,0,0,n/a,0
57021,57021,100,4,179,28,211,4,207,0.018957345971563982,0.8483412322274881,0.13270142180094788,0.018957345971563982,0.981042654028436,Velmanette Montgomery RECAP,0.981042654028436
57022,57022,100,0,145,30,175,0,175,0.0,0.8285714285714286,0.17142857142857143,0.0,1.0,Velmanette Montgomery RECAP,1.0
57023,57023,100,0,35,4,39,0,39,0.0,0.8974358974358975,0.10256410256410256,0.0,1.0,Velmanette Montgomery RECAP,1.0
57024,57024,100,1,219,73,293,1,292,0.0034129692832764505,0.7474402730375427,0.24914675767918087,0.0034129692832764505,0.9965870307167235,Velmanette Montgomery RECAP,0.9965870307167235
57025,57025,100,2,156,76,234,2,232,0.008547008547008548,0.6666666666666666,0.3247863247863248,0.008547008547008548,0.9914529914529915,Velmanette Montgomery RECAP,0.9914529914529915
57026,57026,100,4,223,80,307,4,303,0.013029315960912053,0.7263843648208469,0.26058631921824105,0.013029315960912053,0.9869706840390879,Velmanette Montgomery RECAP,0.9869706840390879
57027,57027,100,0,156,66,222,0,222,0.0,0.7027027027027027,0.2972972972972973,0.0,1.0,Velmanette Montgomery RECAP,1.0
57028,57028,100,1,170,54,225,1,224,0.0044444444444444444,0.7555555555555555,0.24,0.0044444444444444444,0.9955555555555555,Velmanette Montgomery RECAP,0.9955555555555555
57029,57029,100,2,164,84,250,2,248,0.008,0.656,0.336,0.008,0.992,Velmanette Montgomery RECAP,0.992
57030,57030,100,0,237,34,271,0,271,0.0,0.8745387453874539,0.12546125461254612,0.0,1.0,Velmanette Montgomery RECAP,1.0
57031,57031,100,1,383,33,417,1,416,0.002398081534772182,0.9184652278177458,0.07913669064748201,0.002398081534772182,0.9976019184652278,Velmanette Montgomery RECAP,0.9976019184652278
57032,57032,100,0,109,1,110,0,110,0.0,0.990909090909091,0.00909090909090909,0.0,1.0,Velmanette Montgomery RECAP,1.0
57033,57033,100,0,179,5,184,0,184,0.0,0.9728260869565217,0.02717391304347826,0.0,1.0,Velmanette Montgomery RECAP,1.0
57034,57034,100,2,286,102,390,2,388,0.005128205128205128,0.7333333333333333,0.26153846153846155,0.005128205128205128,0.9948717948717949,Velmanette Montgomery RECAP,0.9948717948717949
57035,57035,100,1,214,74,289,1,288,0.0034602076124567475,0.740484429065744,0.2560553633217993,0.0034602076124567475,0.9965397923875432,Velmanette Montgomery RECAP,0.9965397923875432
57036,57036,100,0,197,41,238,0,238,0.0,0.8277310924369747,0.1722689075630252,0.0,1.0,Velmanette Montgomery RECAP,1.0
57037,57037,100,0,173,30,203,0,203,0.0,0.8522167487684729,0.1477832512315271,0.0,1.0,Velmanette Montgomery RECAP,1.0
57038,57038,100,2,212,67,281,2,279,0.0071174377224199285,0.7544483985765125,0.23843416370106763,0.0071174377224199285,0.9928825622775801,Velmanette Montgomery RECAP,0.9928825622775801
57039,57039,100,1,241,69,311,1,310,0.003215434083601286,0.77491961414791,0.22186495176848875,0.003215434083601286,0.9967845659163987,Velmanette Montgomery RECAP,0.9967845659163987
57040,57040,100,1,207,89,297,1,296,0.003367003367003367,0.696969696969697,0.2996632996632997,0.003367003367003367,0.9966329966329966,Velmanette Montgomery RECAP,0.9966329966329966
57041,57041,100,0,203,70,273,0,273,0.0,0.7435897435897436,0.2564102564102564,0.0,1.0,Velmanette Montgomery RECAP,1.0
57042,57042,100,2,189,74,265,2,263,0.007547169811320755,0.7132075471698113,0.2792452830188679,0.007547169811320755,0.9924528301886792,Velmanette Montgomery RECAP,0.9924528301886792
57043,57043,100,2,189,82,273,2,271,0.007326007326007326,0.6923076923076923,0.30036630036630035,0.007326007326007326,0.9926739926739927,Velmanette Montgomery RECAP,0.9926739926739927
57044,57044,100,0,220,48,268,0,268,0.0,0.8208955223880597,0.1791044776119403,0.0,1.0,Velmanette Montgomery RECAP,1.0
57045,57045,100,0,210,27,237,0,237,0.0,0.8860759493670886,0.11392405063291139,0.0,1.0,Velmanette Montgomery RECAP,1.0
57046,57046,100,0,141,5,146,0,146,0.0,0.9657534246575342,0.03424657534246575,0.0,1.0,Velmanette Montgomery RECAP,1.0
57047,57047,100,0,213,88,301,0,301,0.0,0.707641196013289,0.292358803986711,0.0,1.0,Velmanette Montgomery RECAP,1.0
57048,57048,100,2,226,66,294,2,292,0.006802721088435374,0.7687074829931972,0.22448979591836735,0.006802721088435374,0.9931972789115646,Velmanette Montgomery RECAP,0.9931972789115646
57049,57049,100,0,105,37,142,0,142,0.0,0.7394366197183099,0.2605633802816901,0.0,1.0,Velmanette Montgomery RECAP,1.0
57050,57050,100,1,236,84,321,1,320,0.003115264797507788,0.735202492211838,0.2616822429906542,0.003115264797507788,0.9968847352024922,Velmanette Montgomery RECAP,0.9968847352024922
57051,57051,100,0,192,42,234,0,234,0.0,0.8205128205128205,0.1794871794871795,0.0,1.0,Velmanette Montgomery RECAP,1.0
57052,57052,100,0,192,22,214,0,214,0.0,0.897196261682243,0.102803738317757,0.0,1.0,Velmanette Montgomery RECAP,1.0
57053,57053,100,0,256,39,295,0,295,0.0,0.8677966101694915,0.13220338983050847,0.0,1.0,Velmanette Montgomery RECAP,1.0
57054,57054,100,0,133,29,162,0,162,0.0,0.8209876543209876,0.17901234567901234,0.0,1.0,Velmanette Montgomery RECAP,1.0
57055,57055,100,3,253,47,303,3,300,0.009900990099009901,0.834983498349835,0.1551155115511551,0.009900990099009901,0.9900990099009901,Velmanette Montgomery RECAP,0.9900990099009901
57056,57056,100,1,213,58,272,1,271,0.003676470588235294,0.7830882352941176,0.21323529411764705,0.003676470588235294,0.9963235294117647,Velmanette Montgomery RECAP,0.9963235294117647
57057,57057,100,0,186,40,226,0,226,0.0,0.8230088495575221,0.17699115044247787,0.0,1.0,Velmanette Montgomery RECAP,1.0
57058,57058,100,0,131,32,163,0,163,0.0,0.803680981595092,0.19631901840490798,0.0,1.0,Velmanette Montgomery RECAP,1.0
57059,57059,100,0,115,22,137,0,137,0.0,0.8394160583941606,0.16058394160583941,0.0,1.0,Velmanette Montgomery RECAP,1.0
57060,57060,100,1,137,54,192,1,191,0.005208333333333333,0.7135416666666666,0.28125,0.005208333333333333,0.9947916666666666,Velmanette Montgomery RECAP,0.9947916666666666
57061,57061,100,1,115,28,144,1,143,0.006944444444444444,0.7986111111111112,0.19444444444444445,0.006944444444444444,0.9930555555555556,Velmanette Montgomery RECAP,0.9930555555555556
57062,57062,100,0,7,6,13,0,13,0.0,0.5384615384615384,0.46153846153846156,0.0,1.0,Velmanette Montgomery RECAP,1.0
57063,57063,100,0,192,99,291,0,291,0.0,0.6597938144329897,0.3402061855670103,0.0,1.0,Velmanette Montgomery RECAP,1.0
57064,57064,100,2,165,79,246,2,244,0.008130081300813009,0.6707317073170732,0.32113821138211385,0.008130081300813009,0.991869918699187,Velmanette Montgomery RECAP,0.991869918699187
57065,57065,100,1,241,141,383,1,382,0.0026109660574412533,0.6292428198433421,0.3681462140992167,0.0026109660574412533,0.9973890339425587,Velmanette Montgomery RECAP,0.9973890339425587
57066,57066,100,0,195,60,255,0,255,0.0,0.7647058823529411,0.23529411764705882,0.0,1.0,Velmanette Montgomery RECAP,1.0
57094,57094,100,1,163,48,212,1,211,0.0047169811320754715,0.7688679245283019,0.22641509433962265,0.0047169811320754715,0.9952830188679245,Velmanette Montgomery RECAP,0.9952830188679245
57095,57095,100,1,96,55,152,1,151,0.006578947368421052,0.631578947368421,0.3618421052631579,0.006578947368421052,0.993421052631579,Velmanette Montgomery RECAP,0.993421052631579
