ED,Reported As,Reporting,Sheldon Silver (Democratic),Sheldon Silver (Working Families),Scattered,Maureen Koetz (Republican),Total Votes,Sheldon Silver RECAP,Scattered RECAP,Maureen Koetz RECAP,p_Sheldon Silver (Democratic),p_Sheldon Silver (Working Families),p_Scattered,p_Maureen Koetz (Republican),p_Sheldon Silver RECAP,p_Scattered RECAP,p_Maureen Koetz RECAP,winner,winner_p
65001,65001,100,59,4,0,31,94,63,0,31,0.6276595744680851,0.0425531914893617,0.0,0.32978723404255317,0.6702127659574468,0.0,0.32978723404255317,Sheldon Silver RECAP,0.6702127659574468
65002,65002,100,104,13,0,81,198,117,0,81,0.5252525252525253,0.06565656565656566,0.0,0.4090909090909091,0.5909090909090909,0.0,0.4090909090909091,Sheldon Silver RECAP,0.5909090909090909
65003,65003,100,40,6,0,34,80,46,0,34,0.5,0.075,0.0,0.425,0.575,0.0,0.425,Sheldon Silver RECAP,0.575
65004,65004,100,81,10,2,40,133,91,2,40,0.6090225563909775,0.07518796992481203,0.015037593984962405,0.3007518796992481,0.6842105263157895,0.015037593984962405,0.3007518796992481,Sheldon Silver RECAP,0.6842105263157895
65005,65005,100,92,4,1,20,117,96,1,20,0.7863247863247863,0.03418803418803419,0.008547008547008548,0.17094017094017094,0.8205128205128205,0.008547008547008548,0.17094017094017094,Sheldon Silver RECAP,0.8205128205128205
65006,65006,100,196,31,0,69,296,227,0,69,0.6621621621621622,0.10472972972972973,0.0,0.23310810810810811,0.7668918918918919,0.0,0.23310810810810811,Sheldon Silver RECAP,0.7668918918918919
65007,65007,100,138,23,1,53,215,161,1,53,0.641860465116279,0.10697674418604651,0.004651162790697674,0.24651162790697675,0.7488372093023256,0.004651162790697674,0.24651162790697675,Sheldon Silver RECAP,0.7488372093023256
65008,65008,100,206,40,2,95,343,246,2,95,0.6005830903790087,0.11661807580174927,0.0058309037900874635,0.27696793002915454,0.717201166180758,0.0058309037900874635,0.27696793002915454,Sheldon Silver RECAP,0.717201166180758
65009,65009,100,63,7,0,31,101,70,0,31,0.6237623762376238,0.06930693069306931,0.0,0.3069306930693069,0.693069306930693,0.0,0.3069306930693069,Sheldon Silver RECAP,0.693069306930693
65010,65010,100,101,16,0,27,144,117,0,27,0.7013888888888888,0.1111111111111111,0.0,0.1875,0.8125,0.0,0.1875,Sheldon Silver RECAP,0.8125
65011,65011,100,61,13,1,38,113,74,1,38,0.5398230088495575,0.11504424778761062,0.008849557522123894,0.336283185840708,0.6548672566371682,0.008849557522123894,0.336283185840708,Sheldon Silver RECAP,0.6548672566371682
65012,65012,100,102,9,0,65,176,111,0,65,0.5795454545454546,0.05113636363636364,0.0,0.3693181818181818,0.6306818181818182,0.0,0.3693181818181818,Sheldon Silver RECAP,0.6306818181818182
65013,65013,100,136,17,2,58,213,153,2,58,0.6384976525821596,0.07981220657276995,0.009389671361502348,0.27230046948356806,0.7183098591549296,0.009389671361502348,0.27230046948356806,Sheldon Silver RECAP,0.7183098591549296
65014,65014,100,171,27,0,99,297,198,0,99,0.5757575757575758,0.09090909090909091,0.0,0.3333333333333333,0.6666666666666666,0.0,0.3333333333333333,Sheldon Silver RECAP,0.6666666666666666
65015,65015,100,95,15,1,37,148,110,1,37,0.6418918918918919,0.10135135135135136,0.006756756756756757,0.25,0.7432432432432432,0.006756756756756757,0.25,Sheldon Silver RECAP,0.7432432432432432
65016,65016,100,160,20,1,56,237,180,1,56,0.6751054852320675,0.08438818565400844,0.004219409282700422,0.23628691983122363,0.759493670886076,0.004219409282700422,0.23628691983122363,Sheldon Silver RECAP,0.759493670886076
65017,65017,100,1,1,0,0,2,2,0,0,0.5,0.5,0.0,0.0,1.0,0.0,0.0,Sheldon Silver RECAP,1.0
65018,65018,100,96,3,0,5,104,99,0,5,0.9230769230769231,0.028846153846153848,0.0,0.04807692307692308,0.9519230769230769,0.0,0.04807692307692308,Sheldon Silver RECAP,0.9519230769230769
65019,65019,100,106,5,1,11,123,111,1,11,0.8617886178861789,0.04065040650406504,0.008130081300813009,0.08943089430894309,0.9024390243902439,0.008130081300813009,0.08943089430894309,Sheldon Silver RECAP,0.9024390243902439
65020,65020,100,105,6,0,9,120,111,0,9,0.875,0.05,0.0,0.075,0.925,0.0,0.075,Sheldon Silver RECAP,0.925
65021,65021,100,128,11,0,13,152,139,0,13,0.8421052631578947,0.07236842105263158,0.0,0.08552631578947369,0.9144736842105263,0.0,0.08552631578947369,Sheldon Silver RECAP,0.9144736842105263
65022,65022,100,126,22,1,64,213,148,1,64,0.5915492957746479,0.10328638497652583,0.004694835680751174,0.3004694835680751,0.6948356807511737,0.004694835680751174,0.3004694835680751,Sheldon Silver RECAP,0.6948356807511737
65023,65023,100,81,7,0,12,100,88,0,12,0.81,0.07,0.0,0.12,0.88,0.0,0.12,Sheldon Silver RECAP,0.88
65024,65024,100,94,4,1,32,131,98,1,32,0.7175572519083969,0.030534351145038167,0.007633587786259542,0.24427480916030533,0.7480916030534351,0.007633587786259542,0.24427480916030533,Sheldon Silver RECAP,0.7480916030534351
65025,65025,100,56,5,1,23,85,61,1,23,0.6588235294117647,0.058823529411764705,0.011764705882352941,0.27058823529411763,0.7176470588235294,0.011764705882352941,0.27058823529411763,Sheldon Silver RECAP,0.7176470588235294
65026,65026,100,67,7,0,22,96,74,0,22,0.6979166666666666,0.07291666666666667,0.0,0.22916666666666666,0.7708333333333334,0.0,0.22916666666666666,Sheldon Silver RECAP,0.7708333333333334
65027,65027,100,134,15,0,34,183,149,0,34,0.73224043715847,0.08196721311475409,0.0,0.18579234972677597,0.8142076502732241,0.0,0.18579234972677597,Sheldon Silver RECAP,0.8142076502732241
65028,65028,100,51,5,0,2,58,56,0,2,0.8793103448275862,0.08620689655172414,0.0,0.034482758620689655,0.9655172413793104,0.0,0.034482758620689655,Sheldon Silver RECAP,0.9655172413793104
65029,65029,100,52,6,0,14,72,58,0,14,0.7222222222222222,0.08333333333333333,0.0,0.19444444444444445,0.8055555555555556,0.0,0.19444444444444445,Sheldon Silver RECAP,0.8055555555555556
65030,65030,100,144,10,0,31,185,154,0,31,0.7783783783783784,0.05405405405405406,0.0,0.16756756756756758,0.8324324324324325,0.0,0.16756756756756758,Sheldon Silver RECAP,0.8324324324324325
65031,65031,100,196,7,0,45,248,203,0,45,0.7903225806451613,0.028225806451612902,0.0,0.1814516129032258,0.8185483870967742,0.0,0.1814516129032258,Sheldon Silver RECAP,0.8185483870967742
65032,65032,100,102,17,0,14,133,119,0,14,0.7669172932330827,0.12781954887218044,0.0,0.10526315789473684,0.8947368421052632,0.0,0.10526315789473684,Sheldon Silver RECAP,0.8947368421052632
65033,65033,100,141,5,2,8,156,146,2,8,0.9038461538461539,0.03205128205128205,0.01282051282051282,0.05128205128205128,0.9358974358974359,0.01282051282051282,0.05128205128205128,Sheldon Silver RECAP,0.9358974358974359
65034,65034,100,115,6,0,14,135,121,0,14,0.8518518518518519,0.044444444444444446,0.0,0.1037037037037037,0.8962962962962963,0.0,0.1037037037037037,Sheldon Silver RECAP,0.8962962962962963
65035,65035,100,104,2,0,15,121,106,0,15,0.859504132231405,0.01652892561983471,0.0,0.12396694214876033,0.8760330578512396,0.0,0.12396694214876033,Sheldon Silver RECAP,0.8760330578512396
65036,65036,100,139,2,0,13,154,141,0,13,0.9025974025974026,0.012987012987012988,0.0,0.08441558441558442,0.9155844155844156,0.0,0.08441558441558442,Sheldon Silver RECAP,0.9155844155844156
65037,65037,100,125,6,0,6,137,131,0,6,0.9124087591240876,0.043795620437956206,0.0,0.043795620437956206,0.9562043795620438,0.0,0.043795620437956206,Sheldon Silver RECAP,0.9562043795620438
65038,65038,100,126,12,0,17,155,138,0,17,0.8129032258064516,0.07741935483870968,0.0,0.10967741935483871,0.8903225806451613,0.0,0.10967741935483871,Sheldon Silver RECAP,0.8903225806451613
65039,65039,100,97,14,0,27,138,111,0,27,0.7028985507246377,0.10144927536231885,0.0,0.1956521739130435,0.8043478260869565,0.0,0.1956521739130435,Sheldon Silver RECAP,0.8043478260869565
65040,65040,100,102,9,1,5,117,111,1,5,0.8717948717948718,0.07692307692307693,0.008547008547008548,0.042735042735042736,0.9487179487179487,0.008547008547008548,0.042735042735042736,Sheldon Silver RECAP,0.9487179487179487
65041,65041,100,79,10,0,20,109,89,0,20,0.7247706422018348,0.09174311926605505,0.0,0.1834862385321101,0.8165137614678899,0.0,0.1834862385321101,Sheldon Silver RECAP,0.8165137614678899
65042,65042,100,97,15,0,13,125,112,0,13,0.776,0.12,0.0,0.104,0.896,0.0,0.104,Sheldon Silver RECAP,0.896
65043,65043,100,162,5,1,9,177,167,1,9,0.9152542372881356,0.02824858757062147,0.005649717514124294,0.05084745762711865,0.943502824858757,0.005649717514124294,0.05084745762711865,Sheldon Silver RECAP,0.943502824858757
65044,65044,100,261,45,2,45,353,306,2,45,0.7393767705382436,0.1274787535410765,0.0056657223796034,0.1274787535410765,0.8668555240793201,0.0056657223796034,0.1274787535410765,Sheldon Silver RECAP,0.8668555240793201
65045,65045,100,246,38,1,44,329,284,1,44,0.7477203647416414,0.11550151975683891,0.00303951367781155,0.1337386018237082,0.8632218844984803,0.00303951367781155,0.1337386018237082,Sheldon Silver RECAP,0.8632218844984803
65046,65046,100,190,29,6,28,253,219,6,28,0.7509881422924901,0.11462450592885376,0.023715415019762844,0.11067193675889328,0.8656126482213439,0.023715415019762844,0.11067193675889328,Sheldon Silver RECAP,0.8656126482213439
65047,65047,100,171,23,2,34,230,194,2,34,0.7434782608695653,0.1,0.008695652173913044,0.14782608695652175,0.8434782608695652,0.008695652173913044,0.14782608695652175,Sheldon Silver RECAP,0.8434782608695652
65048,65048,100,212,47,2,30,291,259,2,30,0.7285223367697594,0.16151202749140894,0.006872852233676976,0.10309278350515463,0.8900343642611683,0.006872852233676976,0.10309278350515463,Sheldon Silver RECAP,0.8900343642611683
65049,65049,100,181,12,1,35,229,193,1,35,0.7903930131004366,0.05240174672489083,0.004366812227074236,0.15283842794759825,0.8427947598253275,0.004366812227074236,0.15283842794759825,Sheldon Silver RECAP,0.8427947598253275
65050,65050,100,163,19,0,22,204,182,0,22,0.7990196078431373,0.09313725490196079,0.0,0.10784313725490197,0.8921568627450981,0.0,0.10784313725490197,Sheldon Silver RECAP,0.8921568627450981
65051,65051,100,206,36,2,49,293,242,2,49,0.7030716723549488,0.12286689419795221,0.006825938566552901,0.16723549488054607,0.825938566552901,0.006825938566552901,0.16723549488054607,Sheldon Silver RECAP,0.825938566552901
65052,65052,100,161,45,3,29,238,206,3,29,0.6764705882352942,0.18907563025210083,0.012605042016806723,0.12184873949579832,0.865546218487395,0.012605042016806723,0.12184873949579832,Sheldon Silver RECAP,0.865546218487395
65053,65053,100,184,29,2,39,254,213,2,39,0.7244094488188977,0.1141732283464567,0.007874015748031496,0.15354330708661418,0.8385826771653543,0.007874015748031496,0.15354330708661418,Sheldon Silver RECAP,0.8385826771653543
65054,65054,100,176,33,1,41,251,209,1,41,0.701195219123506,0.13147410358565736,0.00398406374501992,0.16334661354581673,0.8326693227091634,0.00398406374501992,0.16334661354581673,Sheldon Silver RECAP,0.8326693227091634
65055,65055,100,180,27,1,36,244,207,1,36,0.7377049180327869,0.11065573770491803,0.004098360655737705,0.14754098360655737,0.8483606557377049,0.004098360655737705,0.14754098360655737,Sheldon Silver RECAP,0.8483606557377049
65056,65056,100,131,7,0,7,145,138,0,7,0.903448275862069,0.04827586206896552,0.0,0.04827586206896552,0.9517241379310345,0.0,0.04827586206896552,Sheldon Silver RECAP,0.9517241379310345
65057,65057,100,95,6,1,13,115,101,1,13,0.8260869565217391,0.05217391304347826,0.008695652173913044,0.11304347826086956,0.8782608695652174,0.008695652173913044,0.11304347826086956,Sheldon Silver RECAP,0.8782608695652174
65058,65058,100,66,8,1,12,87,74,1,12,0.7586206896551724,0.09195402298850575,0.011494252873563218,0.13793103448275862,0.8505747126436781,0.011494252873563218,0.13793103448275862,Sheldon Silver RECAP,0.8505747126436781
65059,65059,100,105,15,4,25,149,120,4,25,0.7046979865771812,0.10067114093959731,0.026845637583892617,0.16778523489932887,0.8053691275167785,0.026845637583892617,0.16778523489932887,Sheldon Silver RECAP,0.8053691275167785
65060,65060,100,78,13,1,14,106,91,1,14,0.7358490566037735,0.12264150943396226,0.009433962264150943,0.1320754716981132,0.8584905660377359,0.009433962264150943,0.1320754716981132,Sheldon Silver RECAP,0.8584905660377359
65061,65061,100,105,16,0,11,132,121,0,11,0.7954545454545454,0.12121212121212122,0.0,0.08333333333333333,0.9166666666666666,0.0,0.08333333333333333,Sheldon Silver RECAP,0.9166666666666666
65062,65062,100,70,18,0,4,92,88,0,4,0.7608695652173914,0.1956521739130435,0.0,0.043478260869565216,0.9565217391304348,0.0,0.043478260869565216,Sheldon Silver RECAP,0.9565217391304348
65063,65063,100,98,12,1,35,146,110,1,35,0.6712328767123288,0.0821917808219178,0.00684931506849315,0.23972602739726026,0.7534246575342466,0.00684931506849315,0.23972602739726026,Sheldon Silver RECAP,0.7534246575342466
65064,65064,100,62,13,0,27,102,75,0,27,0.6078431372549019,0.12745098039215685,0.0,0.2647058823529412,0.7352941176470589,0.0,0.2647058823529412,Sheldon Silver RECAP,0.7352941176470589
65065,65065,100,41,10,1,8,60,51,1,8,0.6833333333333333,0.16666666666666666,0.016666666666666666,0.13333333333333333,0.85,0.016666666666666666,0.13333333333333333,Sheldon Silver RECAP,0.85
65066,65066,100,43,10,1,21,75,53,1,21,0.5733333333333334,0.13333333333333333,0.013333333333333334,0.28,0.7066666666666667,0.013333333333333334,0.28,Sheldon Silver RECAP,0.7066666666666667
65067,65067,100,20,10,0,5,35,30,0,5,0.5714285714285714,0.2857142857142857,0.0,0.14285714285714285,0.8571428571428571,0.0,0.14285714285714285,Sheldon Silver RECAP,0.8571428571428571
65068,65068,100,101,23,0,34,158,124,0,34,0.6392405063291139,0.14556962025316456,0.0,0.21518987341772153,0.7848101265822784,0.0,0.21518987341772153,Sheldon Silver RECAP,0.7848101265822784
65069,65069,100,78,13,1,15,107,91,1,15,0.7289719626168224,0.12149532710280374,0.009345794392523364,0.14018691588785046,0.8504672897196262,0.009345794392523364,0.14018691588785046,Sheldon Silver RECAP,0.8504672897196262
65070,65070,100,12,6,0,2,20,18,0,2,0.6,0.3,0.0,0.1,0.9,0.0,0.1,Sheldon Silver RECAP,0.9
65071,65071,100,90,26,0,25,141,116,0,25,0.6382978723404256,0.18439716312056736,0.0,0.1773049645390071,0.8226950354609929,0.0,0.1773049645390071,Sheldon Silver RECAP,0.8226950354609929
65072,65072,100,99,14,2,15,130,113,2,15,0.7615384615384615,0.1076923076923077,0.015384615384615385,0.11538461538461539,0.8692307692307693,0.015384615384615385,0.11538461538461539,Sheldon Silver RECAP,0.8692307692307693
65073,65073,100,167,29,0,12,208,196,0,12,0.8028846153846154,0.13942307692307693,0.0,0.057692307692307696,0.9423076923076923,0.0,0.057692307692307696,Sheldon Silver RECAP,0.9423076923076923
65074,65074,100,142,32,2,16,192,174,2,16,0.7395833333333334,0.16666666666666666,0.010416666666666666,0.08333333333333333,0.90625,0.010416666666666666,0.08333333333333333,Sheldon Silver RECAP,0.90625
65075,65075,100,87,17,0,9,113,104,0,9,0.7699115044247787,0.1504424778761062,0.0,0.07964601769911504,0.9203539823008849,0.0,0.07964601769911504,Sheldon Silver RECAP,0.9203539823008849
65076,65076,100,101,22,4,19,146,123,4,19,0.6917808219178082,0.1506849315068493,0.0273972602739726,0.13013698630136986,0.8424657534246576,0.0273972602739726,0.13013698630136986,Sheldon Silver RECAP,0.8424657534246576
65077,65077,100,154,37,1,23,215,191,1,23,0.7162790697674418,0.17209302325581396,0.004651162790697674,0.10697674418604651,0.8883720930232558,0.004651162790697674,0.10697674418604651,Sheldon Silver RECAP,0.8883720930232558
65078,65078,100,77,35,0,13,125,112,0,13,0.616,0.28,0.0,0.104,0.896,0.0,0.104,Sheldon Silver RECAP,0.896
65079,65079,100,128,66,1,24,219,194,1,24,0.5844748858447488,0.3013698630136986,0.0045662100456621,0.1095890410958904,0.8858447488584474,0.0045662100456621,0.1095890410958904,Sheldon Silver RECAP,0.8858447488584474
65080,65080,100,111,30,1,16,158,141,1,16,0.7025316455696202,0.189873417721519,0.006329113924050633,0.10126582278481013,0.8924050632911392,0.006329113924050633,0.10126582278481013,Sheldon Silver RECAP,0.8924050632911392
65081,65081,100,111,26,0,21,158,137,0,21,0.7025316455696202,0.16455696202531644,0.0,0.13291139240506328,0.8670886075949367,0.0,0.13291139240506328,Sheldon Silver RECAP,0.8670886075949367
65082,65082,100,0,0,0,0,0,0,0,0,0,0,0,0,0,0,0,n/a,0
65083,65083,100,54,3,0,2,59,57,0,2,0.9152542372881356,0.05084745762711865,0.0,0.03389830508474576,0.9661016949152542,0.0,0.03389830508474576,Sheldon Silver RECAP,0.9661016949152542
65084,65082,100,0,0,0,0,0,0,0,0,0,0,0,0,0,0,0,n/a,0
65085,65085,100,50,6,1,38,95,56,1,38,0.5263157894736842,0.06315789473684211,0.010526315789473684,0.4,0.5894736842105263,0.010526315789473684,0.4,Sheldon Silver RECAP,0.5894736842105263
65086,65086,100,51,12,0,17,80,63,0,17,0.6375,0.15,0.0,0.2125,0.7875,0.0,0.2125,Sheldon Silver RECAP,0.7875
65087,65087,100,61,7,0,30,98,68,0,30,0.6224489795918368,0.07142857142857142,0.0,0.30612244897959184,0.6938775510204082,0.0,0.30612244897959184,Sheldon Silver RECAP,0.6938775510204082
65088,65088,100,116,20,2,40,178,136,2,40,0.651685393258427,0.11235955056179775,0.011235955056179775,0.2247191011235955,0.7640449438202247,0.011235955056179775,0.2247191011235955,Sheldon Silver RECAP,0.7640449438202247
65089,65089,100,56,9,1,25,91,65,1,25,0.6153846153846154,0.0989010989010989,0.01098901098901099,0.27472527472527475,0.7142857142857143,0.01098901098901099,0.27472527472527475,Sheldon Silver RECAP,0.7142857142857143
65090,65090,100,104,20,1,57,182,124,1,57,0.5714285714285714,0.10989010989010989,0.005494505494505495,0.3131868131868132,0.6813186813186813,0.005494505494505495,0.3131868131868132,Sheldon Silver RECAP,0.6813186813186813
65091,65091,100,41,9,0,14,64,50,0,14,0.640625,0.140625,0.0,0.21875,0.78125,0.0,0.21875,Sheldon Silver RECAP,0.78125
65092,65092,100,44,10,0,28,82,54,0,28,0.5365853658536586,0.12195121951219512,0.0,0.34146341463414637,0.6585365853658537,0.0,0.34146341463414637,Sheldon Silver RECAP,0.6585365853658537
65093,65093,100,67,12,0,21,100,79,0,21,0.67,0.12,0.0,0.21,0.79,0.0,0.21,Sheldon Silver RECAP,0.79
65200,65200,100,0,0,0,0,0,0,0,0,0,0,0,0,0,0,0,n/a,0
65201,65201,100,0,0,0,0,0,0,0,0,0,0,0,0,0,0,0,n/a,0
65202,65202,100,0,0,0,0,0,0,0,0,0,0,0,0,0,0,0,n/a,0
65203,65203,100,0,0,0,0,0,0,0,0,0,0,0,0,0,0,0,n/a,0
65204,65204,100,0,0,0,0,0,0,0,0,0,0,0,0,0,0,0,n/a,0
