ED,Reported As,Reporting,Scattered,Leroy G. Comrie Jr. (Democratic),Leroy G. Comrie Jr. (Working Families),Total Votes,Scattered RECAP,Leroy G. Comrie Jr. RECAP,p_Scattered,p_Leroy G. Comrie Jr. (Democratic),p_Leroy G. Comrie Jr. (Working Families),p_Scattered RECAP,p_Leroy G. Comrie Jr. RECAP,winner,winner_p
24008,24008,100,0,39,4,43,0,43,0.0,0.9069767441860465,0.09302325581395349,0.0,1.0,Leroy G. Comrie Jr. RECAP,1.0
24009,24009,100,0,5,0,5,0,5,0.0,1.0,0.0,0.0,1.0,Leroy G. Comrie Jr. RECAP,1.0
24013,24013,100,1,161,10,172,1,171,0.005813953488372093,0.936046511627907,0.05813953488372093,0.005813953488372093,0.9941860465116279,Leroy G. Comrie Jr. RECAP,0.9941860465116279
24014,24014,100,0,123,14,137,0,137,0.0,0.8978102189781022,0.10218978102189781,0.0,1.0,Leroy G. Comrie Jr. RECAP,1.0
24027,24027,100,5,245,9,259,5,254,0.019305019305019305,0.9459459459459459,0.03474903474903475,0.019305019305019305,0.9806949806949807,Leroy G. Comrie Jr. RECAP,0.9806949806949807
24029,24029,100,1,309,17,327,1,326,0.0030581039755351682,0.944954128440367,0.05198776758409786,0.0030581039755351682,0.9969418960244648,Leroy G. Comrie Jr. RECAP,0.9969418960244648
24030,24030,100,0,273,26,299,0,299,0.0,0.9130434782608695,0.08695652173913043,0.0,1.0,Leroy G. Comrie Jr. RECAP,1.0
24031,24031,100,0,106,6,112,0,112,0.0,0.9464285714285714,0.05357142857142857,0.0,1.0,Leroy G. Comrie Jr. RECAP,1.0
24037,24037,100,2,169,12,183,2,181,0.01092896174863388,0.9234972677595629,0.06557377049180328,0.01092896174863388,0.9890710382513661,Leroy G. Comrie Jr. RECAP,0.9890710382513661
24039,24039,100,0,22,0,22,0,22,0.0,1.0,0.0,0.0,1.0,Leroy G. Comrie Jr. RECAP,1.0
24040,24040,100,1,196,22,219,1,218,0.0045662100456621,0.8949771689497716,0.1004566210045662,0.0045662100456621,0.9954337899543378,Leroy G. Comrie Jr. RECAP,0.9954337899543378
24041,24041,100,1,34,3,38,1,37,0.02631578947368421,0.8947368421052632,0.07894736842105263,0.02631578947368421,0.9736842105263158,Leroy G. Comrie Jr. RECAP,0.9736842105263158
24043,24043,100,0,207,11,218,0,218,0.0,0.9495412844036697,0.05045871559633028,0.0,1.0,Leroy G. Comrie Jr. RECAP,1.0
24044,24044,100,0,96,8,104,0,104,0.0,0.9230769230769231,0.07692307692307693,0.0,1.0,Leroy G. Comrie Jr. RECAP,1.0
24045,24045,100,2,93,20,115,2,113,0.017391304347826087,0.808695652173913,0.17391304347826086,0.017391304347826087,0.9826086956521739,Leroy G. Comrie Jr. RECAP,0.9826086956521739
24046,24046,100,2,105,12,119,2,117,0.01680672268907563,0.8823529411764706,0.10084033613445378,0.01680672268907563,0.9831932773109243,Leroy G. Comrie Jr. RECAP,0.9831932773109243
24047,24047,100,0,113,13,126,0,126,0.0,0.8968253968253969,0.10317460317460317,0.0,1.0,Leroy G. Comrie Jr. RECAP,1.0
24048,24048,100,1,44,0,45,1,44,0.022222222222222223,0.9777777777777777,0.0,0.022222222222222223,0.9777777777777777,Leroy G. Comrie Jr. RECAP,0.9777777777777777
24049,24049,100,4,221,32,257,4,253,0.01556420233463035,0.8599221789883269,0.1245136186770428,0.01556420233463035,0.9844357976653697,Leroy G. Comrie Jr. RECAP,0.9844357976653697
24056,24056,100,0,12,1,13,0,13,0.0,0.9230769230769231,0.07692307692307693,0.0,1.0,Leroy G. Comrie Jr. RECAP,1.0
24058,24058,100,0,1,0,1,0,1,0.0,1.0,0.0,0.0,1.0,Leroy G. Comrie Jr. RECAP,1.0
24059,24059,100,0,115,9,124,0,124,0.0,0.9274193548387096,0.07258064516129033,0.0,1.0,Leroy G. Comrie Jr. RECAP,1.0
24060,24060,100,0,28,0,28,0,28,0.0,1.0,0.0,0.0,1.0,Leroy G. Comrie Jr. RECAP,1.0
24062,24062,100,1,122,6,129,1,128,0.007751937984496124,0.9457364341085271,0.046511627906976744,0.007751937984496124,0.9922480620155039,Leroy G. Comrie Jr. RECAP,0.9922480620155039
24065,24065,100,0,133,3,136,0,136,0.0,0.9779411764705882,0.022058823529411766,0.0,1.0,Leroy G. Comrie Jr. RECAP,1.0
24066,24066,100,1,142,7,150,1,149,0.006666666666666667,0.9466666666666667,0.04666666666666667,0.006666666666666667,0.9933333333333333,Leroy G. Comrie Jr. RECAP,0.9933333333333333
24078,24078,100,0,135,11,146,0,146,0.0,0.9246575342465754,0.07534246575342465,0.0,1.0,Leroy G. Comrie Jr. RECAP,1.0
24080,24080,100,0,0,0,0,0,0,0,0,0,0,0,n/a,0
24081,24060,100,0,0,0,0,0,0,0,0,0,0,0,n/a,0
24083,24080,100,0,0,0,0,0,0,0,0,0,0,0,n/a,0
25002,25002,100,1,16,1,18,1,17,0.05555555555555555,0.8888888888888888,0.05555555555555555,0.05555555555555555,0.9444444444444444,Leroy G. Comrie Jr. RECAP,0.9444444444444444
25003,25003,100,2,146,12,160,2,158,0.0125,0.9125,0.075,0.0125,0.9875,Leroy G. Comrie Jr. RECAP,0.9875
25004,25004,100,1,130,23,154,1,153,0.006493506493506494,0.8441558441558441,0.14935064935064934,0.006493506493506494,0.9935064935064936,Leroy G. Comrie Jr. RECAP,0.9935064935064936
25005,25005,100,2,22,2,26,2,24,0.07692307692307693,0.8461538461538461,0.07692307692307693,0.07692307692307693,0.9230769230769231,Leroy G. Comrie Jr. RECAP,0.9230769230769231
25006,25006,100,1,101,5,107,1,106,0.009345794392523364,0.9439252336448598,0.04672897196261682,0.009345794392523364,0.9906542056074766,Leroy G. Comrie Jr. RECAP,0.9906542056074766
25007,25007,100,2,192,20,214,2,212,0.009345794392523364,0.897196261682243,0.09345794392523364,0.009345794392523364,0.9906542056074766,Leroy G. Comrie Jr. RECAP,0.9906542056074766
25008,25008,100,1,107,17,125,1,124,0.008,0.856,0.136,0.008,0.992,Leroy G. Comrie Jr. RECAP,0.992
25009,25009,100,2,34,3,39,2,37,0.05128205128205128,0.8717948717948718,0.07692307692307693,0.05128205128205128,0.9487179487179487,Leroy G. Comrie Jr. RECAP,0.9487179487179487
27002,27002,100,1,139,7,147,1,146,0.006802721088435374,0.9455782312925171,0.047619047619047616,0.006802721088435374,0.9931972789115646,Leroy G. Comrie Jr. RECAP,0.9931972789115646
27003,27003,100,3,120,20,143,3,140,0.02097902097902098,0.8391608391608392,0.13986013986013987,0.02097902097902098,0.9790209790209791,Leroy G. Comrie Jr. RECAP,0.9790209790209791
27004,27004,100,3,153,27,183,3,180,0.01639344262295082,0.8360655737704918,0.14754098360655737,0.01639344262295082,0.9836065573770492,Leroy G. Comrie Jr. RECAP,0.9836065573770492
27005,27005,100,2,157,24,183,2,181,0.01092896174863388,0.8579234972677595,0.13114754098360656,0.01092896174863388,0.9890710382513661,Leroy G. Comrie Jr. RECAP,0.9890710382513661
27006,27006,100,1,151,18,170,1,169,0.0058823529411764705,0.888235294117647,0.10588235294117647,0.0058823529411764705,0.9941176470588236,Leroy G. Comrie Jr. RECAP,0.9941176470588236
27007,27007,100,2,264,46,312,2,310,0.00641025641025641,0.8461538461538461,0.14743589743589744,0.00641025641025641,0.9935897435897436,Leroy G. Comrie Jr. RECAP,0.9935897435897436
27008,27008,100,3,142,17,162,3,159,0.018518518518518517,0.8765432098765432,0.10493827160493827,0.018518518518518517,0.9814814814814815,Leroy G. Comrie Jr. RECAP,0.9814814814814815
27009,27009,100,2,174,21,197,2,195,0.01015228426395939,0.883248730964467,0.1065989847715736,0.01015228426395939,0.9898477157360406,Leroy G. Comrie Jr. RECAP,0.9898477157360406
27011,27011,100,0,107,5,112,0,112,0.0,0.9553571428571429,0.044642857142857144,0.0,1.0,Leroy G. Comrie Jr. RECAP,1.0
27012,27012,100,1,153,28,182,1,181,0.005494505494505495,0.8406593406593407,0.15384615384615385,0.005494505494505495,0.9945054945054945,Leroy G. Comrie Jr. RECAP,0.9945054945054945
27013,27013,100,0,250,23,273,0,273,0.0,0.9157509157509157,0.08424908424908426,0.0,1.0,Leroy G. Comrie Jr. RECAP,1.0
27014,27014,100,1,204,38,243,1,242,0.00411522633744856,0.8395061728395061,0.15637860082304528,0.00411522633744856,0.9958847736625515,Leroy G. Comrie Jr. RECAP,0.9958847736625515
27015,27015,100,1,140,26,167,1,166,0.005988023952095809,0.8383233532934131,0.15568862275449102,0.005988023952095809,0.9940119760479041,Leroy G. Comrie Jr. RECAP,0.9940119760479041
27016,27016,100,0,57,9,66,0,66,0.0,0.8636363636363636,0.13636363636363635,0.0,1.0,Leroy G. Comrie Jr. RECAP,1.0
27017,27017,100,0,123,17,140,0,140,0.0,0.8785714285714286,0.12142857142857143,0.0,1.0,Leroy G. Comrie Jr. RECAP,1.0
27020,27020,100,0,145,23,168,0,168,0.0,0.8630952380952381,0.13690476190476192,0.0,1.0,Leroy G. Comrie Jr. RECAP,1.0
27021,27021,100,2,226,24,252,2,250,0.007936507936507936,0.8968253968253969,0.09523809523809523,0.007936507936507936,0.9920634920634921,Leroy G. Comrie Jr. RECAP,0.9920634920634921
27031,27031,100,0,14,1,15,0,15,0.0,0.9333333333333333,0.06666666666666667,0.0,1.0,Leroy G. Comrie Jr. RECAP,1.0
27032,27032,100,0,19,2,21,0,21,0.0,0.9047619047619048,0.09523809523809523,0.0,1.0,Leroy G. Comrie Jr. RECAP,1.0
27071,27071,100,0,0,0,0,0,0,0,0,0,0,0,n/a,0
28007,28007,100,0,57,16,73,0,73,0.0,0.7808219178082192,0.2191780821917808,0.0,1.0,Leroy G. Comrie Jr. RECAP,1.0
28011,28011,100,3,80,13,96,3,93,0.03125,0.8333333333333334,0.13541666666666666,0.03125,0.96875,Leroy G. Comrie Jr. RECAP,0.96875
28025,28025,100,6,171,22,199,6,193,0.03015075376884422,0.8592964824120602,0.11055276381909548,0.03015075376884422,0.9698492462311558,Leroy G. Comrie Jr. RECAP,0.9698492462311558
28026,28026,100,0,77,7,84,0,84,0.0,0.9166666666666666,0.08333333333333333,0.0,1.0,Leroy G. Comrie Jr. RECAP,1.0
29001,29001,100,0,91,4,95,0,95,0.0,0.9578947368421052,0.042105263157894736,0.0,1.0,Leroy G. Comrie Jr. RECAP,1.0
29002,29002,100,0,184,5,189,0,189,0.0,0.9735449735449735,0.026455026455026454,0.0,1.0,Leroy G. Comrie Jr. RECAP,1.0
29003,29003,100,0,127,9,136,0,136,0.0,0.9338235294117647,0.0661764705882353,0.0,1.0,Leroy G. Comrie Jr. RECAP,1.0
29006,29006,100,1,150,9,160,1,159,0.00625,0.9375,0.05625,0.00625,0.99375,Leroy G. Comrie Jr. RECAP,0.99375
29008,29008,100,0,116,2,118,0,118,0.0,0.9830508474576272,0.01694915254237288,0.0,1.0,Leroy G. Comrie Jr. RECAP,1.0
29012,29012,100,0,192,7,199,0,199,0.0,0.964824120603015,0.035175879396984924,0.0,1.0,Leroy G. Comrie Jr. RECAP,1.0
29013,29013,100,0,113,4,117,0,117,0.0,0.9658119658119658,0.03418803418803419,0.0,1.0,Leroy G. Comrie Jr. RECAP,1.0
29014,29014,100,0,144,6,150,0,150,0.0,0.96,0.04,0.0,1.0,Leroy G. Comrie Jr. RECAP,1.0
29015,29015,100,0,225,8,233,0,233,0.0,0.9656652360515021,0.034334763948497854,0.0,1.0,Leroy G. Comrie Jr. RECAP,1.0
29016,29016,100,1,119,5,125,1,124,0.008,0.952,0.04,0.008,0.992,Leroy G. Comrie Jr. RECAP,0.992
29017,29017,100,0,146,1,147,0,147,0.0,0.9931972789115646,0.006802721088435374,0.0,1.0,Leroy G. Comrie Jr. RECAP,1.0
29018,29018,100,0,182,2,184,0,184,0.0,0.9891304347826086,0.010869565217391304,0.0,1.0,Leroy G. Comrie Jr. RECAP,1.0
29019,29019,100,0,114,2,116,0,116,0.0,0.9827586206896551,0.017241379310344827,0.0,1.0,Leroy G. Comrie Jr. RECAP,1.0
29020,29020,100,1,226,11,238,1,237,0.004201680672268907,0.9495798319327731,0.046218487394957986,0.004201680672268907,0.9957983193277311,Leroy G. Comrie Jr. RECAP,0.9957983193277311
29021,29021,100,2,301,9,312,2,310,0.00641025641025641,0.9647435897435898,0.028846153846153848,0.00641025641025641,0.9935897435897436,Leroy G. Comrie Jr. RECAP,0.9935897435897436
29022,29022,100,1,289,18,308,1,307,0.003246753246753247,0.9383116883116883,0.05844155844155844,0.003246753246753247,0.9967532467532467,Leroy G. Comrie Jr. RECAP,0.9967532467532467
29023,29023,100,0,254,11,265,0,265,0.0,0.9584905660377359,0.04150943396226415,0.0,1.0,Leroy G. Comrie Jr. RECAP,1.0
29024,29024,100,2,316,8,326,2,324,0.006134969325153374,0.9693251533742331,0.024539877300613498,0.006134969325153374,0.9938650306748467,Leroy G. Comrie Jr. RECAP,0.9938650306748467
29025,29025,100,1,329,9,339,1,338,0.0029498525073746312,0.9705014749262537,0.02654867256637168,0.0029498525073746312,0.9970501474926253,Leroy G. Comrie Jr. RECAP,0.9970501474926253
29026,29026,100,0,326,12,338,0,338,0.0,0.9644970414201184,0.03550295857988166,0.0,1.0,Leroy G. Comrie Jr. RECAP,1.0
29027,29027,100,1,265,11,277,1,276,0.0036101083032490976,0.9566787003610109,0.039711191335740074,0.0036101083032490976,0.9963898916967509,Leroy G. Comrie Jr. RECAP,0.9963898916967509
29028,29028,100,0,275,7,282,0,282,0.0,0.975177304964539,0.024822695035460994,0.0,1.0,Leroy G. Comrie Jr. RECAP,1.0
29029,29029,100,0,349,6,355,0,355,0.0,0.9830985915492958,0.016901408450704224,0.0,1.0,Leroy G. Comrie Jr. RECAP,1.0
29030,29030,100,2,234,6,242,2,240,0.008264462809917356,0.9669421487603306,0.024793388429752067,0.008264462809917356,0.9917355371900827,Leroy G. Comrie Jr. RECAP,0.9917355371900827
29031,29031,100,0,316,8,324,0,324,0.0,0.9753086419753086,0.024691358024691357,0.0,1.0,Leroy G. Comrie Jr. RECAP,1.0
29032,29032,100,0,314,5,319,0,319,0.0,0.9843260188087775,0.01567398119122257,0.0,1.0,Leroy G. Comrie Jr. RECAP,1.0
29033,29033,100,1,291,11,303,1,302,0.0033003300330033004,0.9603960396039604,0.036303630363036306,0.0033003300330033004,0.9966996699669967,Leroy G. Comrie Jr. RECAP,0.9966996699669967
29034,29034,100,0,280,7,287,0,287,0.0,0.975609756097561,0.024390243902439025,0.0,1.0,Leroy G. Comrie Jr. RECAP,1.0
29036,29036,100,0,146,6,152,0,152,0.0,0.9605263157894737,0.039473684210526314,0.0,1.0,Leroy G. Comrie Jr. RECAP,1.0
29037,29037,100,0,152,7,159,0,159,0.0,0.9559748427672956,0.0440251572327044,0.0,1.0,Leroy G. Comrie Jr. RECAP,1.0
29038,29038,100,0,207,4,211,0,211,0.0,0.981042654028436,0.018957345971563982,0.0,1.0,Leroy G. Comrie Jr. RECAP,1.0
29039,29039,100,0,88,11,99,0,99,0.0,0.8888888888888888,0.1111111111111111,0.0,1.0,Leroy G. Comrie Jr. RECAP,1.0
29050,29050,100,0,279,8,287,0,287,0.0,0.9721254355400697,0.027874564459930314,0.0,1.0,Leroy G. Comrie Jr. RECAP,1.0
29051,29051,100,0,326,4,330,0,330,0.0,0.9878787878787879,0.012121212121212121,0.0,1.0,Leroy G. Comrie Jr. RECAP,1.0
29052,29052,100,0,268,8,276,0,276,0.0,0.9710144927536232,0.028985507246376812,0.0,1.0,Leroy G. Comrie Jr. RECAP,1.0
29053,29053,100,0,229,2,231,0,231,0.0,0.9913419913419913,0.008658008658008658,0.0,1.0,Leroy G. Comrie Jr. RECAP,1.0
29054,29054,100,1,287,12,300,1,299,0.0033333333333333335,0.9566666666666667,0.04,0.0033333333333333335,0.9966666666666667,Leroy G. Comrie Jr. RECAP,0.9966666666666667
29055,29055,100,0,297,11,308,0,308,0.0,0.9642857142857143,0.03571428571428571,0.0,1.0,Leroy G. Comrie Jr. RECAP,1.0
29056,29056,100,0,235,8,243,0,243,0.0,0.9670781893004116,0.03292181069958848,0.0,1.0,Leroy G. Comrie Jr. RECAP,1.0
29057,29057,100,1,209,3,213,1,212,0.004694835680751174,0.9812206572769953,0.014084507042253521,0.004694835680751174,0.9953051643192489,Leroy G. Comrie Jr. RECAP,0.9953051643192489
29058,29058,100,0,277,5,282,0,282,0.0,0.9822695035460993,0.01773049645390071,0.0,1.0,Leroy G. Comrie Jr. RECAP,1.0
29059,29059,100,1,365,6,372,1,371,0.002688172043010753,0.9811827956989247,0.016129032258064516,0.002688172043010753,0.9973118279569892,Leroy G. Comrie Jr. RECAP,0.9973118279569892
29060,29060,100,5,350,14,369,5,364,0.013550135501355014,0.948509485094851,0.037940379403794036,0.013550135501355014,0.986449864498645,Leroy G. Comrie Jr. RECAP,0.986449864498645
29061,29061,100,13,353,15,381,13,368,0.03412073490813648,0.926509186351706,0.03937007874015748,0.03412073490813648,0.9658792650918635,Leroy G. Comrie Jr. RECAP,0.9658792650918635
29062,29062,100,5,375,14,394,5,389,0.012690355329949238,0.9517766497461929,0.03553299492385787,0.012690355329949238,0.9873096446700508,Leroy G. Comrie Jr. RECAP,0.9873096446700508
29063,29063,100,7,308,5,320,7,313,0.021875,0.9625,0.015625,0.021875,0.978125,Leroy G. Comrie Jr. RECAP,0.978125
29064,29064,100,6,205,7,218,6,212,0.027522935779816515,0.9403669724770642,0.03211009174311927,0.027522935779816515,0.9724770642201835,Leroy G. Comrie Jr. RECAP,0.9724770642201835
29065,29065,100,1,208,10,219,1,218,0.0045662100456621,0.9497716894977168,0.045662100456621,0.0045662100456621,0.9954337899543378,Leroy G. Comrie Jr. RECAP,0.9954337899543378
29066,29066,100,3,226,5,234,3,231,0.01282051282051282,0.9658119658119658,0.021367521367521368,0.01282051282051282,0.9871794871794872,Leroy G. Comrie Jr. RECAP,0.9871794871794872
29067,29067,100,1,195,11,207,1,206,0.004830917874396135,0.9420289855072463,0.05314009661835749,0.004830917874396135,0.9951690821256038,Leroy G. Comrie Jr. RECAP,0.9951690821256038
29068,29068,100,2,239,10,251,2,249,0.00796812749003984,0.952191235059761,0.0398406374501992,0.00796812749003984,0.9920318725099602,Leroy G. Comrie Jr. RECAP,0.9920318725099602
29069,29069,100,0,91,1,92,0,92,0.0,0.9891304347826086,0.010869565217391304,0.0,1.0,Leroy G. Comrie Jr. RECAP,1.0
29070,29070,100,9,208,6,223,9,214,0.04035874439461883,0.9327354260089686,0.026905829596412557,0.04035874439461883,0.9596412556053812,Leroy G. Comrie Jr. RECAP,0.9596412556053812
31074,31074,100,0,0,0,0,0,0,0,0,0,0,0,n/a,0
32001,32001,100,0,205,3,208,0,208,0.0,0.9855769230769231,0.014423076923076924,0.0,1.0,Leroy G. Comrie Jr. RECAP,1.0
32003,32003,100,1,218,6,225,1,224,0.0044444444444444444,0.9688888888888889,0.02666666666666667,0.0044444444444444444,0.9955555555555555,Leroy G. Comrie Jr. RECAP,0.9955555555555555
32004,32004,100,2,219,9,230,2,228,0.008695652173913044,0.9521739130434783,0.0391304347826087,0.008695652173913044,0.991304347826087,Leroy G. Comrie Jr. RECAP,0.991304347826087
32005,32005,100,3,139,8,150,3,147,0.02,0.9266666666666666,0.05333333333333334,0.02,0.98,Leroy G. Comrie Jr. RECAP,0.98
32006,32006,100,0,180,5,185,0,185,0.0,0.972972972972973,0.02702702702702703,0.0,1.0,Leroy G. Comrie Jr. RECAP,1.0
32011,32011,100,0,58,3,61,0,61,0.0,0.9508196721311475,0.04918032786885246,0.0,1.0,Leroy G. Comrie Jr. RECAP,1.0
32014,32014,100,0,3,0,3,0,3,0.0,1.0,0.0,0.0,1.0,Leroy G. Comrie Jr. RECAP,1.0
32015,32015,100,0,170,4,174,0,174,0.0,0.9770114942528736,0.022988505747126436,0.0,1.0,Leroy G. Comrie Jr. RECAP,1.0
32016,32016,100,0,191,8,199,0,199,0.0,0.9597989949748744,0.04020100502512563,0.0,1.0,Leroy G. Comrie Jr. RECAP,1.0
32023,32023,100,0,126,3,129,0,129,0.0,0.9767441860465116,0.023255813953488372,0.0,1.0,Leroy G. Comrie Jr. RECAP,1.0
32024,32024,100,0,95,3,98,0,98,0.0,0.9693877551020408,0.030612244897959183,0.0,1.0,Leroy G. Comrie Jr. RECAP,1.0
32040,32040,100,2,281,4,287,2,285,0.006968641114982578,0.9790940766550522,0.013937282229965157,0.006968641114982578,0.9930313588850174,Leroy G. Comrie Jr. RECAP,0.9930313588850174
32041,32041,100,0,235,7,242,0,242,0.0,0.9710743801652892,0.028925619834710745,0.0,1.0,Leroy G. Comrie Jr. RECAP,1.0
32042,32042,100,0,281,3,284,0,284,0.0,0.9894366197183099,0.01056338028169014,0.0,1.0,Leroy G. Comrie Jr. RECAP,1.0
32043,32043,100,0,291,7,298,0,298,0.0,0.9765100671140939,0.02348993288590604,0.0,1.0,Leroy G. Comrie Jr. RECAP,1.0
32044,32044,100,1,102,2,105,1,104,0.009523809523809525,0.9714285714285714,0.01904761904761905,0.009523809523809525,0.9904761904761905,Leroy G. Comrie Jr. RECAP,0.9904761904761905
32045,32045,100,1,285,5,291,1,290,0.003436426116838488,0.979381443298969,0.01718213058419244,0.003436426116838488,0.9965635738831615,Leroy G. Comrie Jr. RECAP,0.9965635738831615
33016,33016,100,0,26,2,28,0,28,0.0,0.9285714285714286,0.07142857142857142,0.0,1.0,Leroy G. Comrie Jr. RECAP,1.0
33017,33017,100,1,147,13,161,1,160,0.006211180124223602,0.9130434782608695,0.08074534161490683,0.006211180124223602,0.9937888198757764,Leroy G. Comrie Jr. RECAP,0.9937888198757764
33018,33018,100,0,144,14,158,0,158,0.0,0.9113924050632911,0.08860759493670886,0.0,1.0,Leroy G. Comrie Jr. RECAP,1.0
33019,33019,100,1,157,16,174,1,173,0.005747126436781609,0.9022988505747126,0.09195402298850575,0.005747126436781609,0.9942528735632183,Leroy G. Comrie Jr. RECAP,0.9942528735632183
33020,33020,100,3,151,15,169,3,166,0.01775147928994083,0.893491124260355,0.08875739644970414,0.01775147928994083,0.9822485207100592,Leroy G. Comrie Jr. RECAP,0.9822485207100592
33021,33021,100,2,211,10,223,2,221,0.008968609865470852,0.9461883408071748,0.04484304932735426,0.008968609865470852,0.9910313901345291,Leroy G. Comrie Jr. RECAP,0.9910313901345291
33022,33022,100,4,161,4,169,4,165,0.023668639053254437,0.9526627218934911,0.023668639053254437,0.023668639053254437,0.9763313609467456,Leroy G. Comrie Jr. RECAP,0.9763313609467456
33023,33023,100,1,182,5,188,1,187,0.005319148936170213,0.9680851063829787,0.026595744680851064,0.005319148936170213,0.9946808510638298,Leroy G. Comrie Jr. RECAP,0.9946808510638298
33024,33024,100,1,174,7,182,1,181,0.005494505494505495,0.9560439560439561,0.038461538461538464,0.005494505494505495,0.9945054945054945,Leroy G. Comrie Jr. RECAP,0.9945054945054945
33025,33025,100,1,154,9,164,1,163,0.006097560975609756,0.9390243902439024,0.054878048780487805,0.006097560975609756,0.9939024390243902,Leroy G. Comrie Jr. RECAP,0.9939024390243902
33026,33026,100,0,111,7,118,0,118,0.0,0.940677966101695,0.059322033898305086,0.0,1.0,Leroy G. Comrie Jr. RECAP,1.0
33027,33027,100,0,183,5,188,0,188,0.0,0.973404255319149,0.026595744680851064,0.0,1.0,Leroy G. Comrie Jr. RECAP,1.0
33028,33028,100,0,185,7,192,0,192,0.0,0.9635416666666666,0.036458333333333336,0.0,1.0,Leroy G. Comrie Jr. RECAP,1.0
33029,33029,100,0,220,8,228,0,228,0.0,0.9649122807017544,0.03508771929824561,0.0,1.0,Leroy G. Comrie Jr. RECAP,1.0
33030,33030,100,1,261,13,275,1,274,0.0036363636363636364,0.9490909090909091,0.04727272727272727,0.0036363636363636364,0.9963636363636363,Leroy G. Comrie Jr. RECAP,0.9963636363636363
33031,33031,100,1,227,6,234,1,233,0.004273504273504274,0.9700854700854701,0.02564102564102564,0.004273504273504274,0.9957264957264957,Leroy G. Comrie Jr. RECAP,0.9957264957264957
33032,33032,100,1,268,7,276,1,275,0.0036231884057971015,0.9710144927536232,0.025362318840579712,0.0036231884057971015,0.9963768115942029,Leroy G. Comrie Jr. RECAP,0.9963768115942029
33033,33033,100,1,219,4,224,1,223,0.004464285714285714,0.9776785714285714,0.017857142857142856,0.004464285714285714,0.9955357142857143,Leroy G. Comrie Jr. RECAP,0.9955357142857143
33034,33034,100,1,239,7,247,1,246,0.004048582995951417,0.9676113360323887,0.02834008097165992,0.004048582995951417,0.9959514170040485,Leroy G. Comrie Jr. RECAP,0.9959514170040485
33035,33035,100,1,259,6,266,1,265,0.0037593984962406013,0.9736842105263158,0.022556390977443608,0.0037593984962406013,0.9962406015037594,Leroy G. Comrie Jr. RECAP,0.9962406015037594
33036,33036,100,0,236,9,245,0,245,0.0,0.963265306122449,0.036734693877551024,0.0,1.0,Leroy G. Comrie Jr. RECAP,1.0
33037,33037,100,1,241,22,264,1,263,0.003787878787878788,0.9128787878787878,0.08333333333333333,0.003787878787878788,0.9962121212121212,Leroy G. Comrie Jr. RECAP,0.9962121212121212
33038,33038,100,2,249,8,259,2,257,0.007722007722007722,0.9613899613899614,0.03088803088803089,0.007722007722007722,0.9922779922779923,Leroy G. Comrie Jr. RECAP,0.9922779922779923
33039,33039,100,0,192,11,203,0,203,0.0,0.9458128078817734,0.054187192118226604,0.0,1.0,Leroy G. Comrie Jr. RECAP,1.0
33040,33040,100,0,173,8,181,0,181,0.0,0.9558011049723757,0.04419889502762431,0.0,1.0,Leroy G. Comrie Jr. RECAP,1.0
33041,33041,100,0,227,5,232,0,232,0.0,0.978448275862069,0.021551724137931036,0.0,1.0,Leroy G. Comrie Jr. RECAP,1.0
33042,33042,100,0,231,3,234,0,234,0.0,0.9871794871794872,0.01282051282051282,0.0,1.0,Leroy G. Comrie Jr. RECAP,1.0
33043,33043,100,1,160,3,164,1,163,0.006097560975609756,0.975609756097561,0.018292682926829267,0.006097560975609756,0.9939024390243902,Leroy G. Comrie Jr. RECAP,0.9939024390243902
33044,33044,100,0,232,7,239,0,239,0.0,0.9707112970711297,0.029288702928870293,0.0,1.0,Leroy G. Comrie Jr. RECAP,1.0
33045,33045,100,2,275,8,285,2,283,0.007017543859649123,0.9649122807017544,0.028070175438596492,0.007017543859649123,0.9929824561403509,Leroy G. Comrie Jr. RECAP,0.9929824561403509
33046,33046,100,0,244,7,251,0,251,0.0,0.9721115537848606,0.027888446215139442,0.0,1.0,Leroy G. Comrie Jr. RECAP,1.0
33047,33047,100,0,215,9,224,0,224,0.0,0.9598214285714286,0.04017857142857143,0.0,1.0,Leroy G. Comrie Jr. RECAP,1.0
33048,33048,100,0,219,1,220,0,220,0.0,0.9954545454545455,0.004545454545454545,0.0,1.0,Leroy G. Comrie Jr. RECAP,1.0
33049,33049,100,3,246,15,264,3,261,0.011363636363636364,0.9318181818181818,0.056818181818181816,0.011363636363636364,0.9886363636363636,Leroy G. Comrie Jr. RECAP,0.9886363636363636
33050,33050,100,0,230,4,234,0,234,0.0,0.9829059829059829,0.017094017094017096,0.0,1.0,Leroy G. Comrie Jr. RECAP,1.0
33051,33051,100,3,238,9,250,3,247,0.012,0.952,0.036,0.012,0.988,Leroy G. Comrie Jr. RECAP,0.988
33052,33052,100,2,223,6,231,2,229,0.008658008658008658,0.9653679653679653,0.025974025974025976,0.008658008658008658,0.9913419913419913,Leroy G. Comrie Jr. RECAP,0.9913419913419913
33053,33053,100,2,241,5,248,2,246,0.008064516129032258,0.9717741935483871,0.020161290322580645,0.008064516129032258,0.9919354838709677,Leroy G. Comrie Jr. RECAP,0.9919354838709677
33054,33054,100,0,274,3,277,0,277,0.0,0.9891696750902527,0.010830324909747292,0.0,1.0,Leroy G. Comrie Jr. RECAP,1.0
33055,33055,100,3,278,8,289,3,286,0.010380622837370242,0.9619377162629758,0.02768166089965398,0.010380622837370242,0.9896193771626297,Leroy G. Comrie Jr. RECAP,0.9896193771626297
33056,33056,100,0,313,5,318,0,318,0.0,0.9842767295597484,0.015723270440251572,0.0,1.0,Leroy G. Comrie Jr. RECAP,1.0
33057,33057,100,1,313,18,332,1,331,0.0030120481927710845,0.9427710843373494,0.05421686746987952,0.0030120481927710845,0.9969879518072289,Leroy G. Comrie Jr. RECAP,0.9969879518072289
33058,33058,100,0,274,14,288,0,288,0.0,0.9513888888888888,0.04861111111111111,0.0,1.0,Leroy G. Comrie Jr. RECAP,1.0
33059,33059,100,1,281,13,295,1,294,0.003389830508474576,0.9525423728813559,0.04406779661016949,0.003389830508474576,0.9966101694915255,Leroy G. Comrie Jr. RECAP,0.9966101694915255
33060,33060,100,2,256,24,282,2,280,0.0070921985815602835,0.9078014184397163,0.0851063829787234,0.0070921985815602835,0.9929078014184397,Leroy G. Comrie Jr. RECAP,0.9929078014184397
33061,33061,100,1,195,17,213,1,212,0.004694835680751174,0.9154929577464789,0.07981220657276995,0.004694835680751174,0.9953051643192489,Leroy G. Comrie Jr. RECAP,0.9953051643192489
33062,33062,100,1,293,10,304,1,303,0.003289473684210526,0.9638157894736842,0.03289473684210526,0.003289473684210526,0.9967105263157895,Leroy G. Comrie Jr. RECAP,0.9967105263157895
33063,33063,100,1,277,15,293,1,292,0.0034129692832764505,0.9453924914675768,0.051194539249146756,0.0034129692832764505,0.9965870307167235,Leroy G. Comrie Jr. RECAP,0.9965870307167235
33064,33064,100,2,252,16,270,2,268,0.007407407407407408,0.9333333333333333,0.05925925925925926,0.007407407407407408,0.9925925925925926,Leroy G. Comrie Jr. RECAP,0.9925925925925926
33065,33065,100,1,397,17,415,1,414,0.0024096385542168677,0.9566265060240964,0.04096385542168675,0.0024096385542168677,0.9975903614457832,Leroy G. Comrie Jr. RECAP,0.9975903614457832
33066,33066,100,4,292,10,306,4,302,0.013071895424836602,0.954248366013072,0.032679738562091505,0.013071895424836602,0.9869281045751634,Leroy G. Comrie Jr. RECAP,0.9869281045751634
33067,33067,100,1,302,8,311,1,310,0.003215434083601286,0.9710610932475884,0.02572347266881029,0.003215434083601286,0.9967845659163987,Leroy G. Comrie Jr. RECAP,0.9967845659163987
33068,33068,100,0,349,6,355,0,355,0.0,0.9830985915492958,0.016901408450704224,0.0,1.0,Leroy G. Comrie Jr. RECAP,1.0
33069,33069,100,0,201,8,209,0,209,0.0,0.9617224880382775,0.03827751196172249,0.0,1.0,Leroy G. Comrie Jr. RECAP,1.0
33070,33070,100,1,208,7,216,1,215,0.004629629629629629,0.9629629629629629,0.032407407407407406,0.004629629629629629,0.9953703703703703,Leroy G. Comrie Jr. RECAP,0.9953703703703703
33071,33071,100,0,211,6,217,0,217,0.0,0.9723502304147466,0.027649769585253458,0.0,1.0,Leroy G. Comrie Jr. RECAP,1.0
33072,33072,100,1,186,12,199,1,198,0.005025125628140704,0.9346733668341709,0.06030150753768844,0.005025125628140704,0.9949748743718593,Leroy G. Comrie Jr. RECAP,0.9949748743718593
33073,33073,100,0,197,5,202,0,202,0.0,0.9752475247524752,0.024752475247524754,0.0,1.0,Leroy G. Comrie Jr. RECAP,1.0
