ED,Reported As,Reporting,Phillip Goldfeder (Democratic),Scattered,Phillip Goldfeder (Conservative),Total Votes,Phillip Goldfeder RECAP,Scattered RECAP,p_Phillip Goldfeder (Democratic),p_Scattered,p_Phillip Goldfeder (Conservative),p_Phillip Goldfeder RECAP,p_Scattered RECAP,winner,winner_p
23001,23001,100,154,3,196,353,350,3,0.43626062322946174,0.0084985835694051,0.5552407932011332,0.9915014164305949,0.0084985835694051,Phillip Goldfeder RECAP,0.9915014164305949
23002,23002,100,143,0,184,327,327,0,0.43730886850152906,0.0,0.5626911314984709,1.0,0.0,Phillip Goldfeder RECAP,1.0
23003,23003,100,148,0,159,307,307,0,0.4820846905537459,0.0,0.5179153094462541,1.0,0.0,Phillip Goldfeder RECAP,1.0
23004,23004,100,34,0,26,60,60,0,0.5666666666666667,0.0,0.43333333333333335,1.0,0.0,Phillip Goldfeder RECAP,1.0
23005,23005,100,180,1,90,271,270,1,0.6642066420664207,0.0036900369003690036,0.33210332103321033,0.996309963099631,0.0036900369003690036,Phillip Goldfeder RECAP,0.996309963099631
23006,23006,100,183,2,117,302,300,2,0.6059602649006622,0.006622516556291391,0.38741721854304634,0.9933774834437086,0.006622516556291391,Phillip Goldfeder RECAP,0.9933774834437086
23007,23007,100,171,4,166,341,337,4,0.501466275659824,0.011730205278592375,0.4868035190615836,0.9882697947214076,0.011730205278592375,Phillip Goldfeder RECAP,0.9882697947214076
23008,23008,100,158,1,113,272,271,1,0.5808823529411765,0.003676470588235294,0.41544117647058826,0.9963235294117647,0.003676470588235294,Phillip Goldfeder RECAP,0.9963235294117647
23009,23009,100,176,6,103,285,279,6,0.6175438596491228,0.021052631578947368,0.36140350877192984,0.9789473684210527,0.021052631578947368,Phillip Goldfeder RECAP,0.9789473684210527
23010,23010,100,184,0,98,282,282,0,0.6524822695035462,0.0,0.3475177304964539,1.0,0.0,Phillip Goldfeder RECAP,1.0
23011,23011,100,165,0,96,261,261,0,0.632183908045977,0.0,0.367816091954023,1.0,0.0,Phillip Goldfeder RECAP,1.0
23012,23012,100,156,1,31,188,187,1,0.8297872340425532,0.005319148936170213,0.16489361702127658,0.9946808510638298,0.005319148936170213,Phillip Goldfeder RECAP,0.9946808510638298
23013,23013,100,160,1,58,219,218,1,0.730593607305936,0.0045662100456621,0.2648401826484018,0.9954337899543378,0.0045662100456621,Phillip Goldfeder RECAP,0.9954337899543378
23014,23014,100,213,7,90,310,303,7,0.6870967741935484,0.02258064516129032,0.2903225806451613,0.9774193548387097,0.02258064516129032,Phillip Goldfeder RECAP,0.9774193548387097
23015,23015,100,227,3,49,279,276,3,0.8136200716845878,0.010752688172043012,0.17562724014336917,0.989247311827957,0.010752688172043012,Phillip Goldfeder RECAP,0.989247311827957
23016,23016,100,245,2,30,277,275,2,0.8844765342960289,0.007220216606498195,0.10830324909747292,0.9927797833935018,0.007220216606498195,Phillip Goldfeder RECAP,0.9927797833935018
23017,23017,100,144,0,13,157,157,0,0.9171974522292994,0.0,0.08280254777070063,1.0,0.0,Phillip Goldfeder RECAP,1.0
23018,23018,100,115,0,5,120,120,0,0.9583333333333334,0.0,0.041666666666666664,1.0,0.0,Phillip Goldfeder RECAP,1.0
23019,23019,100,207,0,32,239,239,0,0.8661087866108786,0.0,0.13389121338912133,1.0,0.0,Phillip Goldfeder RECAP,1.0
23020,23020,100,0,0,0,0,0,0,0,0,0,0,0,n/a,0
23021,23021,100,90,2,23,115,113,2,0.782608695652174,0.017391304347826087,0.2,0.9826086956521739,0.017391304347826087,Phillip Goldfeder RECAP,0.9826086956521739
23022,23022,100,1,0,0,1,1,0,1.0,0.0,0.0,1.0,0.0,Phillip Goldfeder RECAP,1.0
23023,23023,100,109,0,22,131,131,0,0.8320610687022901,0.0,0.16793893129770993,1.0,0.0,Phillip Goldfeder RECAP,1.0
23024,23024,100,188,0,19,207,207,0,0.9082125603864735,0.0,0.09178743961352658,1.0,0.0,Phillip Goldfeder RECAP,1.0
23025,23025,100,153,1,70,224,223,1,0.6830357142857143,0.004464285714285714,0.3125,0.9955357142857143,0.004464285714285714,Phillip Goldfeder RECAP,0.9955357142857143
23026,23026,100,224,1,25,250,249,1,0.896,0.004,0.1,0.996,0.004,Phillip Goldfeder RECAP,0.996
23027,23027,100,160,2,134,296,294,2,0.5405405405405406,0.006756756756756757,0.4527027027027027,0.9932432432432432,0.006756756756756757,Phillip Goldfeder RECAP,0.9932432432432432
23028,23028,100,199,1,92,292,291,1,0.6815068493150684,0.003424657534246575,0.3150684931506849,0.9965753424657534,0.003424657534246575,Phillip Goldfeder RECAP,0.9965753424657534
23029,23029,100,211,1,31,243,242,1,0.8683127572016461,0.00411522633744856,0.12757201646090535,0.9958847736625515,0.00411522633744856,Phillip Goldfeder RECAP,0.9958847736625515
23030,23030,100,211,0,22,233,233,0,0.9055793991416309,0.0,0.0944206008583691,1.0,0.0,Phillip Goldfeder RECAP,1.0
23031,23031,100,209,0,17,226,226,0,0.9247787610619469,0.0,0.0752212389380531,1.0,0.0,Phillip Goldfeder RECAP,1.0
23032,23032,100,129,0,4,133,133,0,0.9699248120300752,0.0,0.03007518796992481,1.0,0.0,Phillip Goldfeder RECAP,1.0
23033,23033,100,153,0,3,156,156,0,0.9807692307692307,0.0,0.019230769230769232,1.0,0.0,Phillip Goldfeder RECAP,1.0
23034,23034,100,102,0,5,107,107,0,0.9532710280373832,0.0,0.04672897196261682,1.0,0.0,Phillip Goldfeder RECAP,1.0
23035,23035,100,216,2,61,279,277,2,0.7741935483870968,0.007168458781362007,0.21863799283154123,0.992831541218638,0.007168458781362007,Phillip Goldfeder RECAP,0.992831541218638
23036,23036,100,165,1,59,225,224,1,0.7333333333333333,0.0044444444444444444,0.26222222222222225,0.9955555555555555,0.0044444444444444444,Phillip Goldfeder RECAP,0.9955555555555555
23037,23037,100,153,0,34,187,187,0,0.8181818181818182,0.0,0.18181818181818182,1.0,0.0,Phillip Goldfeder RECAP,1.0
23038,23038,100,26,0,1,27,27,0,0.9629629629629629,0.0,0.037037037037037035,1.0,0.0,Phillip Goldfeder RECAP,1.0
23039,23039,100,171,1,98,270,269,1,0.6333333333333333,0.003703703703703704,0.362962962962963,0.9962962962962963,0.003703703703703704,Phillip Goldfeder RECAP,0.9962962962962963
23040,23040,100,150,0,84,234,234,0,0.6410256410256411,0.0,0.358974358974359,1.0,0.0,Phillip Goldfeder RECAP,1.0
23041,23041,100,122,1,68,191,190,1,0.6387434554973822,0.005235602094240838,0.35602094240837695,0.9947643979057592,0.005235602094240838,Phillip Goldfeder RECAP,0.9947643979057592
23042,23042,100,206,1,10,217,216,1,0.9493087557603687,0.004608294930875576,0.04608294930875576,0.9953917050691244,0.004608294930875576,Phillip Goldfeder RECAP,0.9953917050691244
23043,23043,100,62,0,10,72,72,0,0.8611111111111112,0.0,0.1388888888888889,1.0,0.0,Phillip Goldfeder RECAP,1.0
23044,23044,100,122,0,66,188,188,0,0.648936170212766,0.0,0.35106382978723405,1.0,0.0,Phillip Goldfeder RECAP,1.0
23045,23045,100,140,1,81,222,221,1,0.6306306306306306,0.0045045045045045045,0.36486486486486486,0.9954954954954955,0.0045045045045045045,Phillip Goldfeder RECAP,0.9954954954954955
23046,23046,100,131,0,85,216,216,0,0.6064814814814815,0.0,0.39351851851851855,1.0,0.0,Phillip Goldfeder RECAP,1.0
23047,23047,100,84,0,41,125,125,0,0.672,0.0,0.328,1.0,0.0,Phillip Goldfeder RECAP,1.0
23048,23048,100,88,1,35,124,123,1,0.7096774193548387,0.008064516129032258,0.28225806451612906,0.9919354838709677,0.008064516129032258,Phillip Goldfeder RECAP,0.9919354838709677
23049,23049,100,155,2,81,238,236,2,0.6512605042016807,0.008403361344537815,0.3403361344537815,0.9915966386554622,0.008403361344537815,Phillip Goldfeder RECAP,0.9915966386554622
23050,23050,100,153,0,83,236,236,0,0.6483050847457628,0.0,0.3516949152542373,1.0,0.0,Phillip Goldfeder RECAP,1.0
23051,23051,100,132,1,99,232,231,1,0.5689655172413793,0.004310344827586207,0.4267241379310345,0.9956896551724138,0.004310344827586207,Phillip Goldfeder RECAP,0.9956896551724138
23052,23052,100,78,1,50,129,128,1,0.6046511627906976,0.007751937984496124,0.3875968992248062,0.9922480620155039,0.007751937984496124,Phillip Goldfeder RECAP,0.9922480620155039
23053,23053,100,146,1,26,173,172,1,0.8439306358381503,0.005780346820809248,0.15028901734104047,0.9942196531791907,0.005780346820809248,Phillip Goldfeder RECAP,0.9942196531791907
23054,23054,100,139,1,50,190,189,1,0.7315789473684211,0.005263157894736842,0.2631578947368421,0.9947368421052631,0.005263157894736842,Phillip Goldfeder RECAP,0.9947368421052631
23055,23055,100,43,0,6,49,49,0,0.8775510204081632,0.0,0.12244897959183673,1.0,0.0,Phillip Goldfeder RECAP,1.0
23056,23056,100,137,0,29,166,166,0,0.8253012048192772,0.0,0.1746987951807229,1.0,0.0,Phillip Goldfeder RECAP,1.0
23057,23057,100,152,0,38,190,190,0,0.8,0.0,0.2,1.0,0.0,Phillip Goldfeder RECAP,1.0
23058,23058,100,154,1,28,183,182,1,0.8415300546448088,0.00546448087431694,0.15300546448087432,0.994535519125683,0.00546448087431694,Phillip Goldfeder RECAP,0.994535519125683
23059,23059,100,143,0,17,160,160,0,0.89375,0.0,0.10625,1.0,0.0,Phillip Goldfeder RECAP,1.0
23060,23060,100,84,2,18,104,102,2,0.8076923076923077,0.019230769230769232,0.17307692307692307,0.9807692307692307,0.019230769230769232,Phillip Goldfeder RECAP,0.9807692307692307
23061,23061,100,184,0,59,243,243,0,0.757201646090535,0.0,0.24279835390946503,1.0,0.0,Phillip Goldfeder RECAP,1.0
23062,23062,100,244,0,80,324,324,0,0.7530864197530864,0.0,0.24691358024691357,1.0,0.0,Phillip Goldfeder RECAP,1.0
23063,23063,100,249,0,63,312,312,0,0.7980769230769231,0.0,0.20192307692307693,1.0,0.0,Phillip Goldfeder RECAP,1.0
23064,23064,100,241,0,84,325,325,0,0.7415384615384616,0.0,0.25846153846153846,1.0,0.0,Phillip Goldfeder RECAP,1.0
23065,23065,100,154,0,46,200,200,0,0.77,0.0,0.23,1.0,0.0,Phillip Goldfeder RECAP,1.0
23066,23066,100,82,0,3,85,85,0,0.9647058823529412,0.0,0.03529411764705882,1.0,0.0,Phillip Goldfeder RECAP,1.0
23067,23067,100,65,0,2,67,67,0,0.9701492537313433,0.0,0.029850746268656716,1.0,0.0,Phillip Goldfeder RECAP,1.0
23068,23068,100,94,0,8,102,102,0,0.9215686274509803,0.0,0.0784313725490196,1.0,0.0,Phillip Goldfeder RECAP,1.0
23069,23069,100,77,0,11,88,88,0,0.875,0.0,0.125,1.0,0.0,Phillip Goldfeder RECAP,1.0
23070,23070,100,93,0,5,98,98,0,0.9489795918367347,0.0,0.05102040816326531,1.0,0.0,Phillip Goldfeder RECAP,1.0
23071,23038,100,0,0,0,0,0,0,0,0,0,0,0,n/a,0
23072,23072,100,0,0,0,0,0,0,0,0,0,0,0,n/a,0
23073,23073,100,0,0,0,0,0,0,0,0,0,0,0,n/a,0
23074,23073,100,0,0,0,0,0,0,0,0,0,0,0,n/a,0
23075,23075,100,0,0,0,0,0,0,0,0,0,0,0,n/a,0
23076,23076,100,0,0,0,0,0,0,0,0,0,0,0,n/a,0
23077,23077,100,0,0,0,0,0,0,0,0,0,0,0,n/a,0
23078,23077,100,0,0,0,0,0,0,0,0,0,0,0,n/a,0
23079,23077,100,0,0,0,0,0,0,0,0,0,0,0,n/a,0
23080,23072,100,0,0,0,0,0,0,0,0,0,0,0,n/a,0
23081,23072,100,0,0,0,0,0,0,0,0,0,0,0,n/a,0
23082,23072,100,0,0,0,0,0,0,0,0,0,0,0,n/a,0
23083,23022,100,0,0,0,0,0,0,0,0,0,0,0,n/a,0
