ED,Reported As,Reporting,Edward C. Braunstein (Working Families),Edward C. Braunstein (Independence),Scattered,Edward C. Braunstein (Democratic),Total Votes,Edward C. Braunstein RECAP,Scattered RECAP,p_Edward C. Braunstein (Working Families),p_Edward C. Braunstein (Independence),p_Scattered,p_Edward C. Braunstein (Democratic),p_Edward C. Braunstein RECAP,p_Scattered RECAP,winner,winner_p
26001,26001,100,7,16,2,44,69,67,2,0.10144927536231885,0.2318840579710145,0.028985507246376812,0.6376811594202898,0.9710144927536232,0.028985507246376812,Edward C. Braunstein RECAP,0.9710144927536232
26002,26002,100,1,2,0,43,46,46,0,0.021739130434782608,0.043478260869565216,0.0,0.9347826086956522,1.0,0.0,Edward C. Braunstein RECAP,1.0
26003,26003,100,24,26,1,165,216,215,1,0.1111111111111111,0.12037037037037036,0.004629629629629629,0.7638888888888888,0.9953703703703703,0.004629629629629629,Edward C. Braunstein RECAP,0.9953703703703703
26004,26004,100,13,19,1,129,162,161,1,0.08024691358024691,0.11728395061728394,0.006172839506172839,0.7962962962962963,0.9938271604938271,0.006172839506172839,Edward C. Braunstein RECAP,0.9938271604938271
26005,26005,100,18,18,0,156,192,192,0,0.09375,0.09375,0.0,0.8125,1.0,0.0,Edward C. Braunstein RECAP,1.0
26006,26006,100,9,9,1,114,133,132,1,0.06766917293233082,0.06766917293233082,0.007518796992481203,0.8571428571428571,0.9924812030075187,0.007518796992481203,Edward C. Braunstein RECAP,0.9924812030075187
26007,26007,100,7,15,1,97,120,119,1,0.058333333333333334,0.125,0.008333333333333333,0.8083333333333333,0.9916666666666667,0.008333333333333333,Edward C. Braunstein RECAP,0.9916666666666667
26008,26008,100,22,30,2,216,270,268,2,0.08148148148148149,0.1111111111111111,0.007407407407407408,0.8,0.9925925925925926,0.007407407407407408,Edward C. Braunstein RECAP,0.9925925925925926
26009,26009,100,12,31,3,201,247,244,3,0.048582995951417005,0.12550607287449392,0.012145748987854251,0.8137651821862348,0.9878542510121457,0.012145748987854251,Edward C. Braunstein RECAP,0.9878542510121457
26010,26010,100,10,22,0,192,224,224,0,0.044642857142857144,0.09821428571428571,0.0,0.8571428571428571,1.0,0.0,Edward C. Braunstein RECAP,1.0
26011,26011,100,12,32,2,113,159,157,2,0.07547169811320754,0.20125786163522014,0.012578616352201259,0.710691823899371,0.9874213836477987,0.012578616352201259,Edward C. Braunstein RECAP,0.9874213836477987
26012,26012,100,12,30,0,97,139,139,0,0.08633093525179857,0.2158273381294964,0.0,0.697841726618705,1.0,0.0,Edward C. Braunstein RECAP,1.0
26013,26013,100,15,23,5,165,208,203,5,0.07211538461538461,0.11057692307692307,0.02403846153846154,0.7932692307692307,0.9759615384615384,0.02403846153846154,Edward C. Braunstein RECAP,0.9759615384615384
26014,26014,100,14,17,2,128,161,159,2,0.08695652173913043,0.10559006211180125,0.012422360248447204,0.7950310559006211,0.9875776397515528,0.012422360248447204,Edward C. Braunstein RECAP,0.9875776397515528
26015,26015,100,15,24,0,206,245,245,0,0.061224489795918366,0.09795918367346938,0.0,0.8408163265306122,1.0,0.0,Edward C. Braunstein RECAP,1.0
26016,26016,100,22,33,2,284,341,339,2,0.06451612903225806,0.0967741935483871,0.005865102639296188,0.8328445747800587,0.9941348973607038,0.005865102639296188,Edward C. Braunstein RECAP,0.9941348973607038
26017,26017,100,18,35,0,176,229,229,0,0.07860262008733625,0.15283842794759825,0.0,0.7685589519650655,1.0,0.0,Edward C. Braunstein RECAP,1.0
26018,26018,100,9,25,2,85,121,119,2,0.0743801652892562,0.2066115702479339,0.01652892561983471,0.7024793388429752,0.9834710743801653,0.01652892561983471,Edward C. Braunstein RECAP,0.9834710743801653
26019,26019,100,19,18,0,198,235,235,0,0.08085106382978724,0.07659574468085106,0.0,0.8425531914893617,1.0,0.0,Edward C. Braunstein RECAP,1.0
26020,26020,100,14,22,1,239,276,275,1,0.050724637681159424,0.07971014492753623,0.0036231884057971015,0.8659420289855072,0.9963768115942029,0.0036231884057971015,Edward C. Braunstein RECAP,0.9963768115942029
26021,26021,100,6,17,0,188,211,211,0,0.02843601895734597,0.08056872037914692,0.0,0.8909952606635071,1.0,0.0,Edward C. Braunstein RECAP,1.0
26022,26022,100,22,28,1,250,301,300,1,0.07308970099667775,0.09302325581395349,0.0033222591362126247,0.8305647840531561,0.9966777408637874,0.0033222591362126247,Edward C. Braunstein RECAP,0.9966777408637874
26023,26023,100,10,15,2,281,308,306,2,0.032467532467532464,0.048701298701298704,0.006493506493506494,0.9123376623376623,0.9935064935064936,0.006493506493506494,Edward C. Braunstein RECAP,0.9935064935064936
26024,26024,100,11,14,1,235,261,260,1,0.0421455938697318,0.05363984674329502,0.0038314176245210726,0.9003831417624522,0.9961685823754789,0.0038314176245210726,Edward C. Braunstein RECAP,0.9961685823754789
26025,26025,100,4,16,1,212,233,232,1,0.017167381974248927,0.06866952789699571,0.004291845493562232,0.9098712446351931,0.9957081545064378,0.004291845493562232,Edward C. Braunstein RECAP,0.9957081545064378
26026,26026,100,8,7,1,139,155,154,1,0.05161290322580645,0.04516129032258064,0.0064516129032258064,0.896774193548387,0.9935483870967742,0.0064516129032258064,Edward C. Braunstein RECAP,0.9935483870967742
26027,26027,100,14,21,0,234,269,269,0,0.05204460966542751,0.07806691449814127,0.0,0.8698884758364313,1.0,0.0,Edward C. Braunstein RECAP,1.0
26028,26028,100,14,31,2,161,208,206,2,0.0673076923076923,0.14903846153846154,0.009615384615384616,0.7740384615384616,0.9903846153846154,0.009615384615384616,Edward C. Braunstein RECAP,0.9903846153846154
26029,26029,100,23,31,0,168,222,222,0,0.1036036036036036,0.13963963963963963,0.0,0.7567567567567568,1.0,0.0,Edward C. Braunstein RECAP,1.0
26030,26030,100,30,26,4,230,290,286,4,0.10344827586206896,0.0896551724137931,0.013793103448275862,0.7931034482758621,0.9862068965517241,0.013793103448275862,Edward C. Braunstein RECAP,0.9862068965517241
26031,26031,100,23,40,0,204,267,267,0,0.08614232209737828,0.149812734082397,0.0,0.7640449438202247,1.0,0.0,Edward C. Braunstein RECAP,1.0
26032,26032,100,25,31,2,179,237,235,2,0.10548523206751055,0.1308016877637131,0.008438818565400843,0.7552742616033755,0.9915611814345991,0.008438818565400843,Edward C. Braunstein RECAP,0.9915611814345991
26033,26033,100,23,50,5,204,282,277,5,0.08156028368794327,0.1773049645390071,0.01773049645390071,0.723404255319149,0.9822695035460993,0.01773049645390071,Edward C. Braunstein RECAP,0.9822695035460993
26034,26034,100,15,20,0,83,118,118,0,0.1271186440677966,0.1694915254237288,0.0,0.7033898305084746,1.0,0.0,Edward C. Braunstein RECAP,1.0
26035,26035,100,20,24,2,164,210,208,2,0.09523809523809523,0.11428571428571428,0.009523809523809525,0.780952380952381,0.9904761904761905,0.009523809523809525,Edward C. Braunstein RECAP,0.9904761904761905
26036,26036,100,3,3,1,61,68,67,1,0.04411764705882353,0.04411764705882353,0.014705882352941176,0.8970588235294118,0.9852941176470589,0.014705882352941176,Edward C. Braunstein RECAP,0.9852941176470589
26037,26037,100,14,11,2,137,164,162,2,0.08536585365853659,0.06707317073170732,0.012195121951219513,0.8353658536585366,0.9878048780487805,0.012195121951219513,Edward C. Braunstein RECAP,0.9878048780487805
26038,26038,100,3,1,0,12,16,16,0,0.1875,0.0625,0.0,0.75,1.0,0.0,Edward C. Braunstein RECAP,1.0
26039,26039,100,9,3,1,106,119,118,1,0.07563025210084033,0.025210084033613446,0.008403361344537815,0.8907563025210085,0.9915966386554622,0.008403361344537815,Edward C. Braunstein RECAP,0.9915966386554622
26040,26040,100,11,6,0,81,98,98,0,0.11224489795918367,0.061224489795918366,0.0,0.826530612244898,1.0,0.0,Edward C. Braunstein RECAP,1.0
26041,26041,100,0,0,0,5,5,5,0,0.0,0.0,0.0,1.0,1.0,0.0,Edward C. Braunstein RECAP,1.0
26042,26042,100,13,12,1,93,119,118,1,0.1092436974789916,0.10084033613445378,0.008403361344537815,0.7815126050420168,0.9915966386554622,0.008403361344537815,Edward C. Braunstein RECAP,0.9915966386554622
26043,26043,100,8,6,2,64,80,78,2,0.1,0.075,0.025,0.8,0.975,0.025,Edward C. Braunstein RECAP,0.975
26044,26044,100,2,6,0,52,60,60,0,0.03333333333333333,0.1,0.0,0.8666666666666667,1.0,0.0,Edward C. Braunstein RECAP,1.0
26045,26045,100,21,16,1,227,265,264,1,0.07924528301886792,0.06037735849056604,0.0037735849056603774,0.8566037735849057,0.9962264150943396,0.0037735849056603774,Edward C. Braunstein RECAP,0.9962264150943396
26046,26046,100,18,21,1,233,273,272,1,0.06593406593406594,0.07692307692307693,0.003663003663003663,0.8534798534798534,0.9963369963369964,0.003663003663003663,Edward C. Braunstein RECAP,0.9963369963369964
26047,26047,100,23,25,0,284,332,332,0,0.06927710843373494,0.07530120481927711,0.0,0.8554216867469879,1.0,0.0,Edward C. Braunstein RECAP,1.0
26048,26048,100,11,16,1,105,133,132,1,0.08270676691729323,0.12030075187969924,0.007518796992481203,0.7894736842105263,0.9924812030075187,0.007518796992481203,Edward C. Braunstein RECAP,0.9924812030075187
26049,26049,100,13,18,0,108,139,139,0,0.09352517985611511,0.12949640287769784,0.0,0.7769784172661871,1.0,0.0,Edward C. Braunstein RECAP,1.0
26050,26050,100,15,13,4,147,179,175,4,0.08379888268156424,0.07262569832402235,0.0223463687150838,0.8212290502793296,0.9776536312849162,0.0223463687150838,Edward C. Braunstein RECAP,0.9776536312849162
26051,26051,100,4,11,2,93,110,108,2,0.03636363636363636,0.1,0.01818181818181818,0.8454545454545455,0.9818181818181818,0.01818181818181818,Edward C. Braunstein RECAP,0.9818181818181818
26052,26052,100,14,12,2,115,143,141,2,0.0979020979020979,0.08391608391608392,0.013986013986013986,0.8041958041958042,0.986013986013986,0.013986013986013986,Edward C. Braunstein RECAP,0.986013986013986
26053,26053,100,13,13,0,148,174,174,0,0.07471264367816093,0.07471264367816093,0.0,0.8505747126436781,1.0,0.0,Edward C. Braunstein RECAP,1.0
26054,26054,100,23,15,0,113,151,151,0,0.152317880794702,0.09933774834437085,0.0,0.7483443708609272,1.0,0.0,Edward C. Braunstein RECAP,1.0
26055,26055,100,7,10,1,102,120,119,1,0.058333333333333334,0.08333333333333333,0.008333333333333333,0.85,0.9916666666666667,0.008333333333333333,Edward C. Braunstein RECAP,0.9916666666666667
26056,26056,100,27,27,0,174,228,228,0,0.11842105263157894,0.11842105263157894,0.0,0.7631578947368421,1.0,0.0,Edward C. Braunstein RECAP,1.0
26057,26057,100,29,27,0,200,256,256,0,0.11328125,0.10546875,0.0,0.78125,1.0,0.0,Edward C. Braunstein RECAP,1.0
26058,26058,100,15,29,0,146,190,190,0,0.07894736842105263,0.15263157894736842,0.0,0.7684210526315789,1.0,0.0,Edward C. Braunstein RECAP,1.0
26059,26059,100,19,31,0,192,242,242,0,0.07851239669421488,0.128099173553719,0.0,0.7933884297520661,1.0,0.0,Edward C. Braunstein RECAP,1.0
26060,26060,100,18,31,3,150,202,199,3,0.0891089108910891,0.15346534653465346,0.01485148514851485,0.7425742574257426,0.9851485148514851,0.01485148514851485,Edward C. Braunstein RECAP,0.9851485148514851
26061,26061,100,10,16,2,139,167,165,2,0.059880239520958084,0.09580838323353294,0.011976047904191617,0.8323353293413174,0.9880239520958084,0.011976047904191617,Edward C. Braunstein RECAP,0.9880239520958084
26062,26062,100,16,18,0,156,190,190,0,0.08421052631578947,0.09473684210526316,0.0,0.8210526315789474,1.0,0.0,Edward C. Braunstein RECAP,1.0
26063,26063,100,16,26,1,186,229,228,1,0.06986899563318777,0.11353711790393013,0.004366812227074236,0.8122270742358079,0.9956331877729258,0.004366812227074236,Edward C. Braunstein RECAP,0.9956331877729258
26064,26064,100,16,23,0,138,177,177,0,0.0903954802259887,0.12994350282485875,0.0,0.7796610169491526,1.0,0.0,Edward C. Braunstein RECAP,1.0
26065,26065,100,21,22,3,159,205,202,3,0.1024390243902439,0.1073170731707317,0.014634146341463415,0.775609756097561,0.9853658536585366,0.014634146341463415,Edward C. Braunstein RECAP,0.9853658536585366
26066,26066,100,21,21,1,196,239,238,1,0.08786610878661087,0.08786610878661087,0.0041841004184100415,0.8200836820083682,0.99581589958159,0.0041841004184100415,Edward C. Braunstein RECAP,0.99581589958159
26067,26067,100,6,18,0,150,174,174,0,0.034482758620689655,0.10344827586206896,0.0,0.8620689655172413,1.0,0.0,Edward C. Braunstein RECAP,1.0
26068,26068,100,18,22,3,136,179,176,3,0.1005586592178771,0.12290502793296089,0.01675977653631285,0.7597765363128491,0.9832402234636871,0.01675977653631285,Edward C. Braunstein RECAP,0.9832402234636871
26069,26069,100,26,31,7,204,268,261,7,0.09701492537313433,0.11567164179104478,0.026119402985074626,0.7611940298507462,0.9738805970149254,0.026119402985074626,Edward C. Braunstein RECAP,0.9738805970149254
26070,26070,100,15,13,0,185,213,213,0,0.07042253521126761,0.06103286384976526,0.0,0.8685446009389671,1.0,0.0,Edward C. Braunstein RECAP,1.0
26071,26071,100,7,18,0,293,318,318,0,0.0220125786163522,0.05660377358490566,0.0,0.9213836477987422,1.0,0.0,Edward C. Braunstein RECAP,1.0
26072,26072,100,13,14,4,180,211,207,4,0.061611374407582936,0.06635071090047394,0.018957345971563982,0.8530805687203792,0.981042654028436,0.018957345971563982,Edward C. Braunstein RECAP,0.981042654028436
26073,26073,100,19,40,1,579,639,638,1,0.0297339593114241,0.06259780907668232,0.001564945226917058,0.9061032863849765,0.9984350547730829,0.001564945226917058,Edward C. Braunstein RECAP,0.9984350547730829
26074,26074,100,9,10,0,126,145,145,0,0.06206896551724138,0.06896551724137931,0.0,0.8689655172413793,1.0,0.0,Edward C. Braunstein RECAP,1.0
26075,26075,100,17,11,0,154,182,182,0,0.09340659340659341,0.06043956043956044,0.0,0.8461538461538461,1.0,0.0,Edward C. Braunstein RECAP,1.0
26076,26076,100,16,16,0,143,175,175,0,0.09142857142857143,0.09142857142857143,0.0,0.8171428571428572,1.0,0.0,Edward C. Braunstein RECAP,1.0
26077,26077,100,0,0,0,0,0,0,0,0,0,0,0,0,0,n/a,0
26078,26078,100,0,0,0,0,0,0,0,0,0,0,0,0,0,n/a,0
