ED,Reported As,Reporting,Michael E. Mcmahon (Democratic),Michael E. Mcmahon (Independence),Write-In,Total Votes,Michael E. Mcmahon RECAP,Write-In RECAP,p_Michael E. Mcmahon (Democratic),p_Michael E. Mcmahon (Independence),p_Write-In,p_Michael E. Mcmahon RECAP,p_Write-In RECAP,winner,winner_p
61001,61001,99.00,219,9,2,230,228,2,0.9521739130434783,0.0391304347826087,0.008695652173913044,0.991304347826087,0.008695652173913044,Michael E. Mcmahon RECAP,0.991304347826087
61002,61002,99.00,234,11,1,246,245,1,0.9512195121951219,0.044715447154471545,0.0040650406504065045,0.9959349593495935,0.0040650406504065045,Michael E. Mcmahon RECAP,0.9959349593495935
61003,61003,99.00,252,11,3,266,263,3,0.9473684210526315,0.041353383458646614,0.011278195488721804,0.9887218045112782,0.011278195488721804,Michael E. Mcmahon RECAP,0.9887218045112782
61004,61004,99.00,256,20,3,279,276,3,0.9175627240143369,0.07168458781362007,0.010752688172043012,0.989247311827957,0.010752688172043012,Michael E. Mcmahon RECAP,0.989247311827957
61005,61005,99.00,9,0,0,9,9,0,1.0,0.0,0.0,1.0,0.0,Michael E. Mcmahon RECAP,1.0
61006,61006,99.00,127,17,3,147,144,3,0.8639455782312925,0.11564625850340136,0.02040816326530612,0.9795918367346939,0.02040816326530612,Michael E. Mcmahon RECAP,0.9795918367346939
61007,61007,99.00,142,4,1,147,146,1,0.9659863945578231,0.027210884353741496,0.006802721088435374,0.9931972789115646,0.006802721088435374,Michael E. Mcmahon RECAP,0.9931972789115646
61008,61008,99.00,186,6,5,197,192,5,0.9441624365482234,0.030456852791878174,0.025380710659898477,0.9746192893401016,0.025380710659898477,Michael E. Mcmahon RECAP,0.9746192893401016
61009,61009,99.00,403,35,5,443,438,5,0.909706546275395,0.07900677200902935,0.011286681715575621,0.9887133182844243,0.011286681715575621,Michael E. Mcmahon RECAP,0.9887133182844243
61010,61010,99.00,175,14,3,192,189,3,0.9114583333333334,0.07291666666666667,0.015625,0.984375,0.015625,Michael E. Mcmahon RECAP,0.984375
61011,61011,99.00,13,0,1,14,13,1,0.9285714285714286,0.0,0.07142857142857142,0.9285714285714286,0.07142857142857142,Michael E. Mcmahon RECAP,0.9285714285714286
61012,61012,99.00,319,34,3,356,353,3,0.8960674157303371,0.09550561797752809,0.008426966292134831,0.9915730337078652,0.008426966292134831,Michael E. Mcmahon RECAP,0.9915730337078652
61013,61013,99.00,171,17,0,188,188,0,0.9095744680851063,0.09042553191489362,0.0,1.0,0.0,Michael E. Mcmahon RECAP,1.0
61014,61014,99.00,177,24,2,203,201,2,0.8719211822660099,0.11822660098522167,0.009852216748768473,0.9901477832512315,0.009852216748768473,Michael E. Mcmahon RECAP,0.9901477832512315
61015,61015,99.00,128,26,3,157,154,3,0.8152866242038217,0.16560509554140126,0.01910828025477707,0.9808917197452229,0.01910828025477707,Michael E. Mcmahon RECAP,0.9808917197452229
61016,61016,99.00,138,2,2,142,140,2,0.971830985915493,0.014084507042253521,0.014084507042253521,0.9859154929577465,0.014084507042253521,Michael E. Mcmahon RECAP,0.9859154929577465
61017,61017,75.00,124,9,1,134,133,1,0.9253731343283582,0.06716417910447761,0.007462686567164179,0.9925373134328358,0.007462686567164179,Michael E. Mcmahon RECAP,0.9925373134328358
61018,61018,99.00,276,60,6,342,336,6,0.8070175438596491,0.17543859649122806,0.017543859649122806,0.9824561403508771,0.017543859649122806,Michael E. Mcmahon RECAP,0.9824561403508771
61019,61019,75.00,175,19,3,197,194,3,0.8883248730964467,0.09644670050761421,0.015228426395939087,0.9847715736040609,0.015228426395939087,Michael E. Mcmahon RECAP,0.9847715736040609
61020,61020,75.00,141,24,3,168,165,3,0.8392857142857143,0.14285714285714285,0.017857142857142856,0.9821428571428571,0.017857142857142856,Michael E. Mcmahon RECAP,0.9821428571428571
61021,61021,99.00,162,5,0,167,167,0,0.9700598802395209,0.029940119760479042,0.0,1.0,0.0,Michael E. Mcmahon RECAP,1.0
61022,61022,99.00,158,10,1,169,168,1,0.9349112426035503,0.05917159763313609,0.005917159763313609,0.9940828402366864,0.005917159763313609,Michael E. Mcmahon RECAP,0.9940828402366864
61023,61023,99.00,122,11,0,133,133,0,0.9172932330827067,0.08270676691729323,0.0,1.0,0.0,Michael E. Mcmahon RECAP,1.0
61024,61024,99.00,133,22,1,156,155,1,0.8525641025641025,0.14102564102564102,0.00641025641025641,0.9935897435897436,0.00641025641025641,Michael E. Mcmahon RECAP,0.9935897435897436
61025,61025,99.00,142,14,2,158,156,2,0.8987341772151899,0.08860759493670886,0.012658227848101266,0.9873417721518988,0.012658227848101266,Michael E. Mcmahon RECAP,0.9873417721518988
61026,61026,50.00,133,11,1,145,144,1,0.9172413793103448,0.07586206896551724,0.006896551724137931,0.993103448275862,0.006896551724137931,Michael E. Mcmahon RECAP,0.993103448275862
61027,61027,50.00,136,6,2,144,142,2,0.9444444444444444,0.041666666666666664,0.013888888888888888,0.9861111111111112,0.013888888888888888,Michael E. Mcmahon RECAP,0.9861111111111112
61028,61028,99.00,184,27,6,217,211,6,0.847926267281106,0.12442396313364056,0.027649769585253458,0.9723502304147466,0.027649769585253458,Michael E. Mcmahon RECAP,0.9723502304147466
61029,61029,99.00,14,4,0,18,18,0,0.7777777777777778,0.2222222222222222,0.0,1.0,0.0,Michael E. Mcmahon RECAP,1.0
61030,61030,99.00,127,11,3,141,138,3,0.900709219858156,0.07801418439716312,0.02127659574468085,0.9787234042553191,0.02127659574468085,Michael E. Mcmahon RECAP,0.9787234042553191
61031,61031,50.00,111,16,0,127,127,0,0.8740157480314961,0.12598425196850394,0.0,1.0,0.0,Michael E. Mcmahon RECAP,1.0
61032,61032,50.00,122,4,0,126,126,0,0.9682539682539683,0.031746031746031744,0.0,1.0,0.0,Michael E. Mcmahon RECAP,1.0
61033,61033,62.50,130,9,1,140,139,1,0.9285714285714286,0.06428571428571428,0.007142857142857143,0.9928571428571429,0.007142857142857143,Michael E. Mcmahon RECAP,0.9928571428571429
61034,61034,99.00,271,67,5,343,338,5,0.7900874635568513,0.19533527696793002,0.014577259475218658,0.9854227405247813,0.014577259475218658,Michael E. Mcmahon RECAP,0.9854227405247813
61035,61035,99.00,164,53,3,220,217,3,0.7454545454545455,0.2409090909090909,0.013636363636363636,0.9863636363636363,0.013636363636363636,Michael E. Mcmahon RECAP,0.9863636363636363
61036,61036,99.00,12,1,0,13,13,0,0.9230769230769231,0.07692307692307693,0.0,1.0,0.0,Michael E. Mcmahon RECAP,1.0
61037,61037,57.14,351,52,16,419,403,16,0.837708830548926,0.12410501193317422,0.03818615751789976,0.9618138424821002,0.03818615751789976,Michael E. Mcmahon RECAP,0.9618138424821002
61038,61038,57.14,247,43,4,294,290,4,0.8401360544217688,0.14625850340136054,0.013605442176870748,0.9863945578231292,0.013605442176870748,Michael E. Mcmahon RECAP,0.9863945578231292
61039,61039,57.14,40,2,1,43,42,1,0.9302325581395349,0.046511627906976744,0.023255813953488372,0.9767441860465116,0.023255813953488372,Michael E. Mcmahon RECAP,0.9767441860465116
61040,61040,57.14,322,59,5,386,381,5,0.8341968911917098,0.15284974093264247,0.012953367875647668,0.9870466321243523,0.012953367875647668,Michael E. Mcmahon RECAP,0.9870466321243523
61041,61041,99.00,7,1,1,9,8,1,0.7777777777777778,0.1111111111111111,0.1111111111111111,0.8888888888888888,0.1111111111111111,Michael E. Mcmahon RECAP,0.8888888888888888
61042,61042,99.00,265,42,5,312,307,5,0.8493589743589743,0.1346153846153846,0.016025641025641024,0.9839743589743589,0.016025641025641024,Michael E. Mcmahon RECAP,0.9839743589743589
61043,61043,99.00,328,72,1,401,400,1,0.8179551122194514,0.17955112219451372,0.0024937655860349127,0.9975062344139651,0.0024937655860349127,Michael E. Mcmahon RECAP,0.9975062344139651
61044,61044,99.00,277,59,1,337,336,1,0.8219584569732937,0.17507418397626112,0.002967359050445104,0.9970326409495549,0.002967359050445104,Michael E. Mcmahon RECAP,0.9970326409495549
61045,61045,99.00,3,0,0,3,3,0,1.0,0.0,0.0,1.0,0.0,Michael E. Mcmahon RECAP,1.0
61046,61046,99.00,2,0,0,2,2,0,1.0,0.0,0.0,1.0,0.0,Michael E. Mcmahon RECAP,1.0
61047,61047,99.00,2,0,0,2,2,0,1.0,0.0,0.0,1.0,0.0,Michael E. Mcmahon RECAP,1.0
61048,61048,99.00,251,60,8,319,311,8,0.786833855799373,0.18808777429467086,0.025078369905956112,0.9749216300940439,0.025078369905956112,Michael E. Mcmahon RECAP,0.9749216300940439
61049,61049,99.00,208,18,2,228,226,2,0.9122807017543859,0.07894736842105263,0.008771929824561403,0.9912280701754386,0.008771929824561403,Michael E. Mcmahon RECAP,0.9912280701754386
61050,61050,99.00,182,17,2,201,199,2,0.9054726368159204,0.0845771144278607,0.009950248756218905,0.9900497512437811,0.009950248756218905,Michael E. Mcmahon RECAP,0.9900497512437811
61051,61051,99.00,24,3,1,28,27,1,0.8571428571428571,0.10714285714285714,0.03571428571428571,0.9642857142857143,0.03571428571428571,Michael E. Mcmahon RECAP,0.9642857142857143
61052,61052,99.00,153,28,1,182,181,1,0.8406593406593407,0.15384615384615385,0.005494505494505495,0.9945054945054945,0.005494505494505495,Michael E. Mcmahon RECAP,0.9945054945054945
61053,61053,99.00,140,3,0,143,143,0,0.9790209790209791,0.02097902097902098,0.0,1.0,0.0,Michael E. Mcmahon RECAP,1.0
61054,61054,99.00,85,6,3,94,91,3,0.9042553191489362,0.06382978723404255,0.031914893617021274,0.9680851063829787,0.031914893617021274,Michael E. Mcmahon RECAP,0.9680851063829787
61055,61055,99.00,141,5,1,147,146,1,0.9591836734693877,0.034013605442176874,0.006802721088435374,0.9931972789115646,0.006802721088435374,Michael E. Mcmahon RECAP,0.9931972789115646
61056,61056,99.00,109,9,1,119,118,1,0.9159663865546218,0.07563025210084033,0.008403361344537815,0.9915966386554622,0.008403361344537815,Michael E. Mcmahon RECAP,0.9915966386554622
61057,61057,99.00,144,18,2,164,162,2,0.8780487804878049,0.10975609756097561,0.012195121951219513,0.9878048780487805,0.012195121951219513,Michael E. Mcmahon RECAP,0.9878048780487805
61058,61058,62.50,201,10,1,212,211,1,0.9481132075471698,0.04716981132075472,0.0047169811320754715,0.9952830188679245,0.0047169811320754715,Michael E. Mcmahon RECAP,0.9952830188679245
61059,61059,62.50,9,0,1,10,9,1,0.9,0.0,0.1,0.9,0.1,Michael E. Mcmahon RECAP,0.9
61060,61060,62.50,107,11,2,120,118,2,0.8916666666666667,0.09166666666666666,0.016666666666666666,0.9833333333333333,0.016666666666666666,Michael E. Mcmahon RECAP,0.9833333333333333
61061,61061,62.50,111,4,0,115,115,0,0.9652173913043478,0.034782608695652174,0.0,1.0,0.0,Michael E. Mcmahon RECAP,1.0
61062,61062,99.00,115,22,1,138,137,1,0.8333333333333334,0.15942028985507245,0.007246376811594203,0.9927536231884058,0.007246376811594203,Michael E. Mcmahon RECAP,0.9927536231884058
61063,61063,99.00,30,9,1,40,39,1,0.75,0.225,0.025,0.975,0.025,Michael E. Mcmahon RECAP,0.975
61064,61064,99.00,7,0,0,7,7,0,1.0,0.0,0.0,1.0,0.0,Michael E. Mcmahon RECAP,1.0
61065,61065,99.00,151,16,6,173,167,6,0.8728323699421965,0.09248554913294797,0.03468208092485549,0.9653179190751445,0.03468208092485549,Michael E. Mcmahon RECAP,0.9653179190751445
61066,61066,99.00,164,15,3,182,179,3,0.9010989010989011,0.08241758241758242,0.016483516483516484,0.9835164835164835,0.016483516483516484,Michael E. Mcmahon RECAP,0.9835164835164835
61067,61067,99.00,150,6,2,158,156,2,0.9493670886075949,0.0379746835443038,0.012658227848101266,0.9873417721518988,0.012658227848101266,Michael E. Mcmahon RECAP,0.9873417721518988
61068,61068,99.00,116,15,0,131,131,0,0.8854961832061069,0.11450381679389313,0.0,1.0,0.0,Michael E. Mcmahon RECAP,1.0
61069,61069,99.00,109,8,0,117,117,0,0.9316239316239316,0.06837606837606838,0.0,1.0,0.0,Michael E. Mcmahon RECAP,1.0
61070,61070,99.00,96,3,0,99,99,0,0.9696969696969697,0.030303030303030304,0.0,1.0,0.0,Michael E. Mcmahon RECAP,1.0
61071,61071,99.00,9,0,0,9,9,0,1.0,0.0,0.0,1.0,0.0,Michael E. Mcmahon RECAP,1.0
61072,61072,57.14,29,2,1,32,31,1,0.90625,0.0625,0.03125,0.96875,0.03125,Michael E. Mcmahon RECAP,0.96875
61073,61073,62.50,141,7,0,148,148,0,0.9527027027027027,0.0472972972972973,0.0,1.0,0.0,Michael E. Mcmahon RECAP,1.0
61074,61074,99.00,7,0,1,8,7,1,0.875,0.0,0.125,0.875,0.125,Michael E. Mcmahon RECAP,0.875
61075,61075,99.00,88,13,2,103,101,2,0.8543689320388349,0.1262135922330097,0.019417475728155338,0.9805825242718447,0.019417475728155338,Michael E. Mcmahon RECAP,0.9805825242718447
61076,61076,99.00,159,13,2,174,172,2,0.9137931034482759,0.07471264367816093,0.011494252873563218,0.9885057471264368,0.011494252873563218,Michael E. Mcmahon RECAP,0.9885057471264368
61077,61077,99.00,9,1,1,11,10,1,0.8181818181818182,0.09090909090909091,0.09090909090909091,0.9090909090909091,0.09090909090909091,Michael E. Mcmahon RECAP,0.9090909090909091
61078,61078,99.00,7,1,0,8,8,0,0.875,0.125,0.0,1.0,0.0,Michael E. Mcmahon RECAP,1.0
61079,61079,99.00,0,0,0,0,0,0,0,0,0,0,0,n/a,0
62001,62001,99.00,83,33,2,118,116,2,0.7033898305084746,0.2796610169491525,0.01694915254237288,0.9830508474576272,0.01694915254237288,Michael E. Mcmahon RECAP,0.9830508474576272
62002,62002,99.00,121,66,7,194,187,7,0.6237113402061856,0.3402061855670103,0.03608247422680412,0.9639175257731959,0.03608247422680412,Michael E. Mcmahon RECAP,0.9639175257731959
62003,62003,57.14,105,72,1,178,177,1,0.5898876404494382,0.4044943820224719,0.0056179775280898875,0.9943820224719101,0.0056179775280898875,Michael E. Mcmahon RECAP,0.9943820224719101
62004,62004,99.00,97,38,4,139,135,4,0.697841726618705,0.2733812949640288,0.02877697841726619,0.9712230215827338,0.02877697841726619,Michael E. Mcmahon RECAP,0.9712230215827338
62005,62005,57.14,67,46,7,120,113,7,0.5583333333333333,0.38333333333333336,0.058333333333333334,0.9416666666666667,0.058333333333333334,Michael E. Mcmahon RECAP,0.9416666666666667
62006,62006,99.00,98,49,5,152,147,5,0.6447368421052632,0.3223684210526316,0.03289473684210526,0.9671052631578947,0.03289473684210526,Michael E. Mcmahon RECAP,0.9671052631578947
62007,62007,57.14,105,47,2,154,152,2,0.6818181818181818,0.3051948051948052,0.012987012987012988,0.987012987012987,0.012987012987012988,Michael E. Mcmahon RECAP,0.987012987012987
62008,62008,0.00,7,4,1,12,11,1,0.5833333333333334,0.3333333333333333,0.08333333333333333,0.9166666666666666,0.08333333333333333,Michael E. Mcmahon RECAP,0.9166666666666666
62009,62009,50.00,22,4,0,26,26,0,0.8461538461538461,0.15384615384615385,0.0,1.0,0.0,Michael E. Mcmahon RECAP,1.0
62010,62010,57.14,11,11,0,22,22,0,0.5,0.5,0.0,1.0,0.0,Michael E. Mcmahon RECAP,1.0
62011,62011,0.00,8,1,1,10,9,1,0.8,0.1,0.1,0.9,0.1,Michael E. Mcmahon RECAP,0.9
62012,62012,99.00,124,47,3,174,171,3,0.7126436781609196,0.27011494252873564,0.017241379310344827,0.9827586206896551,0.017241379310344827,Michael E. Mcmahon RECAP,0.9827586206896551
62013,62013,99.00,149,46,9,204,195,9,0.7303921568627451,0.22549019607843138,0.04411764705882353,0.9558823529411765,0.04411764705882353,Michael E. Mcmahon RECAP,0.9558823529411765
62014,62014,99.00,2,2,0,4,4,0,0.5,0.5,0.0,1.0,0.0,Michael E. Mcmahon RECAP,1.0
62015,62015,99.00,131,56,4,191,187,4,0.6858638743455497,0.2931937172774869,0.020942408376963352,0.9790575916230366,0.020942408376963352,Michael E. Mcmahon RECAP,0.9790575916230366
62016,62016,99.00,143,36,4,183,179,4,0.7814207650273224,0.19672131147540983,0.02185792349726776,0.9781420765027322,0.02185792349726776,Michael E. Mcmahon RECAP,0.9781420765027322
62017,62017,99.00,5,1,1,7,6,1,0.7142857142857143,0.14285714285714285,0.14285714285714285,0.8571428571428571,0.14285714285714285,Michael E. Mcmahon RECAP,0.8571428571428571
62018,62018,99.00,1,3,0,4,4,0,0.25,0.75,0.0,1.0,0.0,Michael E. Mcmahon RECAP,1.0
62019,62019,99.00,6,0,0,6,6,0,1.0,0.0,0.0,1.0,0.0,Michael E. Mcmahon RECAP,1.0
62020,62020,66.67,134,81,8,223,215,8,0.600896860986547,0.3632286995515695,0.03587443946188341,0.9641255605381166,0.03587443946188341,Michael E. Mcmahon RECAP,0.9641255605381166
62021,62021,66.67,129,52,4,185,181,4,0.6972972972972973,0.2810810810810811,0.021621621621621623,0.9783783783783784,0.021621621621621623,Michael E. Mcmahon RECAP,0.9783783783783784
62022,62022,66.67,154,72,4,230,226,4,0.6695652173913044,0.3130434782608696,0.017391304347826087,0.9826086956521739,0.017391304347826087,Michael E. Mcmahon RECAP,0.9826086956521739
62023,62023,66.67,11,4,0,15,15,0,0.7333333333333333,0.26666666666666666,0.0,1.0,0.0,Michael E. Mcmahon RECAP,1.0
62024,62024,66.67,13,3,2,18,16,2,0.7222222222222222,0.16666666666666666,0.1111111111111111,0.8888888888888888,0.1111111111111111,Michael E. Mcmahon RECAP,0.8888888888888888
62025,62025,66.67,16,5,0,21,21,0,0.7619047619047619,0.23809523809523808,0.0,1.0,0.0,Michael E. Mcmahon RECAP,1.0
62026,62026,99.00,111,27,1,139,138,1,0.7985611510791367,0.19424460431654678,0.007194244604316547,0.9928057553956835,0.007194244604316547,Michael E. Mcmahon RECAP,0.9928057553956835
62027,62027,99.00,104,37,2,143,141,2,0.7272727272727273,0.25874125874125875,0.013986013986013986,0.986013986013986,0.013986013986013986,Michael E. Mcmahon RECAP,0.986013986013986
62028,62028,99.00,72,39,2,113,111,2,0.6371681415929203,0.34513274336283184,0.017699115044247787,0.9823008849557522,0.017699115044247787,Michael E. Mcmahon RECAP,0.9823008849557522
62029,62029,0.00,6,0,0,6,6,0,1.0,0.0,0.0,1.0,0.0,Michael E. Mcmahon RECAP,1.0
62030,62030,0.00,10,3,0,13,13,0,0.7692307692307693,0.23076923076923078,0.0,1.0,0.0,Michael E. Mcmahon RECAP,1.0
62031,62031,0.00,15,5,1,21,20,1,0.7142857142857143,0.23809523809523808,0.047619047619047616,0.9523809523809523,0.047619047619047616,Michael E. Mcmahon RECAP,0.9523809523809523
62032,62032,99.00,76,35,1,112,111,1,0.6785714285714286,0.3125,0.008928571428571428,0.9910714285714286,0.008928571428571428,Michael E. Mcmahon RECAP,0.9910714285714286
62033,62033,99.00,82,41,2,125,123,2,0.656,0.328,0.016,0.984,0.016,Michael E. Mcmahon RECAP,0.984
62034,62034,99.00,80,44,4,128,124,4,0.625,0.34375,0.03125,0.96875,0.03125,Michael E. Mcmahon RECAP,0.96875
62035,62035,99.00,151,63,10,224,214,10,0.6741071428571429,0.28125,0.044642857142857144,0.9553571428571429,0.044642857142857144,Michael E. Mcmahon RECAP,0.9553571428571429
62036,62036,99.00,10,1,1,12,11,1,0.8333333333333334,0.08333333333333333,0.08333333333333333,0.9166666666666666,0.08333333333333333,Michael E. Mcmahon RECAP,0.9166666666666666
62037,62037,99.00,110,49,2,161,159,2,0.6832298136645962,0.30434782608695654,0.012422360248447204,0.9875776397515528,0.012422360248447204,Michael E. Mcmahon RECAP,0.9875776397515528
62038,62038,99.00,135,39,2,176,174,2,0.7670454545454546,0.2215909090909091,0.011363636363636364,0.9886363636363636,0.011363636363636364,Michael E. Mcmahon RECAP,0.9886363636363636
62039,62039,99.00,112,44,1,157,156,1,0.7133757961783439,0.2802547770700637,0.006369426751592357,0.9936305732484076,0.006369426751592357,Michael E. Mcmahon RECAP,0.9936305732484076
62040,62040,99.00,91,28,2,121,119,2,0.7520661157024794,0.23140495867768596,0.01652892561983471,0.9834710743801653,0.01652892561983471,Michael E. Mcmahon RECAP,0.9834710743801653
62041,62041,99.00,106,34,5,145,140,5,0.7310344827586207,0.23448275862068965,0.034482758620689655,0.9655172413793104,0.034482758620689655,Michael E. Mcmahon RECAP,0.9655172413793104
62042,62042,99.00,108,47,4,159,155,4,0.6792452830188679,0.29559748427672955,0.025157232704402517,0.9748427672955975,0.025157232704402517,Michael E. Mcmahon RECAP,0.9748427672955975
62043,62043,99.00,116,29,7,152,145,7,0.7631578947368421,0.19078947368421054,0.046052631578947366,0.9539473684210527,0.046052631578947366,Michael E. Mcmahon RECAP,0.9539473684210527
62044,62044,99.00,139,75,10,224,214,10,0.6205357142857143,0.33482142857142855,0.044642857142857144,0.9553571428571429,0.044642857142857144,Michael E. Mcmahon RECAP,0.9553571428571429
62045,62045,99.00,3,1,0,4,4,0,0.75,0.25,0.0,1.0,0.0,Michael E. Mcmahon RECAP,1.0
62046,62046,99.00,89,42,1,132,131,1,0.6742424242424242,0.3181818181818182,0.007575757575757576,0.9924242424242424,0.007575757575757576,Michael E. Mcmahon RECAP,0.9924242424242424
62047,62047,99.00,145,62,1,208,207,1,0.6971153846153846,0.2980769230769231,0.004807692307692308,0.9951923076923077,0.004807692307692308,Michael E. Mcmahon RECAP,0.9951923076923077
62048,62048,99.00,78,26,3,107,104,3,0.7289719626168224,0.24299065420560748,0.028037383177570093,0.9719626168224299,0.028037383177570093,Michael E. Mcmahon RECAP,0.9719626168224299
62049,62049,99.00,126,31,4,161,157,4,0.782608695652174,0.19254658385093168,0.024844720496894408,0.9751552795031055,0.024844720496894408,Michael E. Mcmahon RECAP,0.9751552795031055
62050,62050,99.00,124,37,7,168,161,7,0.7380952380952381,0.22023809523809523,0.041666666666666664,0.9583333333333334,0.041666666666666664,Michael E. Mcmahon RECAP,0.9583333333333334
62051,62051,99.00,91,38,3,132,129,3,0.6893939393939394,0.2878787878787879,0.022727272727272728,0.9772727272727273,0.022727272727272728,Michael E. Mcmahon RECAP,0.9772727272727273
62052,62052,99.00,127,28,4,159,155,4,0.7987421383647799,0.1761006289308176,0.025157232704402517,0.9748427672955975,0.025157232704402517,Michael E. Mcmahon RECAP,0.9748427672955975
62053,62053,99.00,108,42,4,154,150,4,0.7012987012987013,0.2727272727272727,0.025974025974025976,0.974025974025974,0.025974025974025976,Michael E. Mcmahon RECAP,0.974025974025974
62054,62054,99.00,88,29,2,119,117,2,0.7394957983193278,0.24369747899159663,0.01680672268907563,0.9831932773109243,0.01680672268907563,Michael E. Mcmahon RECAP,0.9831932773109243
62055,62055,99.00,90,50,5,145,140,5,0.6206896551724138,0.3448275862068966,0.034482758620689655,0.9655172413793104,0.034482758620689655,Michael E. Mcmahon RECAP,0.9655172413793104
62056,62056,99.00,80,31,2,113,111,2,0.7079646017699115,0.2743362831858407,0.017699115044247787,0.9823008849557522,0.017699115044247787,Michael E. Mcmahon RECAP,0.9823008849557522
62057,62057,99.00,71,35,7,113,106,7,0.6283185840707964,0.30973451327433627,0.061946902654867256,0.9380530973451328,0.061946902654867256,Michael E. Mcmahon RECAP,0.9380530973451328
62058,62058,99.00,97,48,4,149,145,4,0.6510067114093959,0.3221476510067114,0.026845637583892617,0.9731543624161074,0.026845637583892617,Michael E. Mcmahon RECAP,0.9731543624161074
62059,62059,99.00,68,29,1,98,97,1,0.6938775510204082,0.29591836734693877,0.01020408163265306,0.9897959183673469,0.01020408163265306,Michael E. Mcmahon RECAP,0.9897959183673469
62060,62060,99.00,112,44,4,160,156,4,0.7,0.275,0.025,0.975,0.025,Michael E. Mcmahon RECAP,0.975
62061,62061,99.00,121,44,7,172,165,7,0.7034883720930233,0.2558139534883721,0.040697674418604654,0.9593023255813954,0.040697674418604654,Michael E. Mcmahon RECAP,0.9593023255813954
62062,62062,99.00,99,38,4,141,137,4,0.7021276595744681,0.2695035460992908,0.028368794326241134,0.9716312056737588,0.028368794326241134,Michael E. Mcmahon RECAP,0.9716312056737588
62063,62063,99.00,180,63,3,246,243,3,0.7317073170731707,0.25609756097560976,0.012195121951219513,0.9878048780487805,0.012195121951219513,Michael E. Mcmahon RECAP,0.9878048780487805
62064,62064,99.00,59,16,6,81,75,6,0.7283950617283951,0.19753086419753085,0.07407407407407407,0.9259259259259259,0.07407407407407407,Michael E. Mcmahon RECAP,0.9259259259259259
62065,62065,99.00,133,43,5,181,176,5,0.7348066298342542,0.23756906077348067,0.027624309392265192,0.9723756906077348,0.027624309392265192,Michael E. Mcmahon RECAP,0.9723756906077348
62066,62066,99.00,189,69,5,263,258,5,0.7186311787072244,0.2623574144486692,0.019011406844106463,0.9809885931558935,0.019011406844106463,Michael E. Mcmahon RECAP,0.9809885931558935
62067,62067,99.00,198,69,11,278,267,11,0.7122302158273381,0.24820143884892087,0.039568345323741004,0.960431654676259,0.039568345323741004,Michael E. Mcmahon RECAP,0.960431654676259
62068,62068,99.00,203,55,12,270,258,12,0.7518518518518519,0.2037037037037037,0.044444444444444446,0.9555555555555556,0.044444444444444446,Michael E. Mcmahon RECAP,0.9555555555555556
62069,62069,99.00,10,11,1,22,21,1,0.45454545454545453,0.5,0.045454545454545456,0.9545454545454546,0.045454545454545456,Michael E. Mcmahon RECAP,0.9545454545454546
62070,62070,99.00,67,12,0,79,79,0,0.8481012658227848,0.1518987341772152,0.0,1.0,0.0,Michael E. Mcmahon RECAP,1.0
62071,62071,99.00,14,1,0,15,15,0,0.9333333333333333,0.06666666666666667,0.0,1.0,0.0,Michael E. Mcmahon RECAP,1.0
62072,62072,99.00,88,24,5,117,112,5,0.7521367521367521,0.20512820512820512,0.042735042735042736,0.9572649572649573,0.042735042735042736,Michael E. Mcmahon RECAP,0.9572649572649573
62073,62073,99.00,9,4,1,14,13,1,0.6428571428571429,0.2857142857142857,0.07142857142857142,0.9285714285714286,0.07142857142857142,Michael E. Mcmahon RECAP,0.9285714285714286
62074,62074,99.00,111,50,6,167,161,6,0.6646706586826348,0.2994011976047904,0.03592814371257485,0.9640718562874252,0.03592814371257485,Michael E. Mcmahon RECAP,0.9640718562874252
62075,62075,66.67,60,32,2,94,92,2,0.6382978723404256,0.3404255319148936,0.02127659574468085,0.9787234042553191,0.02127659574468085,Michael E. Mcmahon RECAP,0.9787234042553191
62076,62076,57.14,77,40,1,118,117,1,0.652542372881356,0.3389830508474576,0.00847457627118644,0.9915254237288136,0.00847457627118644,Michael E. Mcmahon RECAP,0.9915254237288136
62077,62077,99.00,80,43,3,126,123,3,0.6349206349206349,0.3412698412698413,0.023809523809523808,0.9761904761904762,0.023809523809523808,Michael E. Mcmahon RECAP,0.9761904761904762
62078,62078,0.00,5,2,0,7,7,0,0.7142857142857143,0.2857142857142857,0.0,1.0,0.0,Michael E. Mcmahon RECAP,1.0
62079,62079,99.00,114,63,4,181,177,4,0.6298342541436464,0.34806629834254144,0.022099447513812154,0.9779005524861878,0.022099447513812154,Michael E. Mcmahon RECAP,0.9779005524861878
62080,62080,99.00,62,30,5,97,92,5,0.6391752577319587,0.30927835051546393,0.05154639175257732,0.9484536082474226,0.05154639175257732,Michael E. Mcmahon RECAP,0.9484536082474226
62081,62081,99.00,58,54,1,113,112,1,0.5132743362831859,0.4778761061946903,0.008849557522123894,0.9911504424778761,0.008849557522123894,Michael E. Mcmahon RECAP,0.9911504424778761
62082,62082,99.00,10,5,1,16,15,1,0.625,0.3125,0.0625,0.9375,0.0625,Michael E. Mcmahon RECAP,0.9375
62083,62083,66.67,58,41,6,105,99,6,0.5523809523809524,0.3904761904761905,0.05714285714285714,0.9428571428571428,0.05714285714285714,Michael E. Mcmahon RECAP,0.9428571428571428
62084,62084,99.00,83,46,6,135,129,6,0.6148148148148148,0.34074074074074073,0.044444444444444446,0.9555555555555556,0.044444444444444446,Michael E. Mcmahon RECAP,0.9555555555555556
62085,62085,99.00,1,1,0,2,2,0,0.5,0.5,0.0,1.0,0.0,Michael E. Mcmahon RECAP,1.0
62086,62086,99.00,2,0,0,2,2,0,1.0,0.0,0.0,1.0,0.0,Michael E. Mcmahon RECAP,1.0
62087,62087,99.00,0,0,0,0,0,0,0,0,0,0,0,n/a,0
62088,62088,99.00,0,0,0,0,0,0,0,0,0,0,0,n/a,0
63001,63001,99.00,177,48,5,230,225,5,0.7695652173913043,0.20869565217391303,0.021739130434782608,0.9782608695652174,0.021739130434782608,Michael E. Mcmahon RECAP,0.9782608695652174
63002,63002,99.00,103,26,1,130,129,1,0.7923076923076923,0.2,0.007692307692307693,0.9923076923076923,0.007692307692307693,Michael E. Mcmahon RECAP,0.9923076923076923
63003,63003,99.00,9,3,0,12,12,0,0.75,0.25,0.0,1.0,0.0,Michael E. Mcmahon RECAP,1.0
63004,63004,99.00,56,35,2,93,91,2,0.6021505376344086,0.3763440860215054,0.021505376344086023,0.978494623655914,0.021505376344086023,Michael E. Mcmahon RECAP,0.978494623655914
63005,63005,99.00,153,50,7,210,203,7,0.7285714285714285,0.23809523809523808,0.03333333333333333,0.9666666666666667,0.03333333333333333,Michael E. Mcmahon RECAP,0.9666666666666667
63006,63006,99.00,4,3,1,8,7,1,0.5,0.375,0.125,0.875,0.125,Michael E. Mcmahon RECAP,0.875
63007,63007,0.00,3,1,0,4,4,0,0.75,0.25,0.0,1.0,0.0,Michael E. Mcmahon RECAP,1.0
63008,63008,99.00,79,17,4,100,96,4,0.79,0.17,0.04,0.96,0.04,Michael E. Mcmahon RECAP,0.96
63009,63009,99.00,10,2,0,12,12,0,0.8333333333333334,0.16666666666666666,0.0,1.0,0.0,Michael E. Mcmahon RECAP,1.0
63010,63010,99.00,124,25,4,153,149,4,0.8104575163398693,0.16339869281045752,0.026143790849673203,0.9738562091503268,0.026143790849673203,Michael E. Mcmahon RECAP,0.9738562091503268
63011,63011,99.00,156,40,4,200,196,4,0.78,0.2,0.02,0.98,0.02,Michael E. Mcmahon RECAP,0.98
63012,63012,99.00,4,0,0,4,4,0,1.0,0.0,0.0,1.0,0.0,Michael E. Mcmahon RECAP,1.0
63013,63013,99.00,114,32,1,147,146,1,0.7755102040816326,0.21768707482993196,0.006802721088435374,0.9931972789115646,0.006802721088435374,Michael E. Mcmahon RECAP,0.9931972789115646
63014,63014,99.00,80,25,0,105,105,0,0.7619047619047619,0.23809523809523808,0.0,1.0,0.0,Michael E. Mcmahon RECAP,1.0
63015,63015,99.00,97,32,2,131,129,2,0.7404580152671756,0.24427480916030533,0.015267175572519083,0.9847328244274809,0.015267175572519083,Michael E. Mcmahon RECAP,0.9847328244274809
63016,63016,99.00,140,38,0,178,178,0,0.7865168539325843,0.21348314606741572,0.0,1.0,0.0,Michael E. Mcmahon RECAP,1.0
63017,63017,99.00,1,0,0,1,1,0,1.0,0.0,0.0,1.0,0.0,Michael E. Mcmahon RECAP,1.0
63018,63018,99.00,180,61,4,245,241,4,0.7346938775510204,0.24897959183673468,0.0163265306122449,0.9836734693877551,0.0163265306122449,Michael E. Mcmahon RECAP,0.9836734693877551
63019,63019,99.00,4,1,0,5,5,0,0.8,0.2,0.0,1.0,0.0,Michael E. Mcmahon RECAP,1.0
63020,63020,99.00,83,19,1,103,102,1,0.8058252427184466,0.18446601941747573,0.009708737864077669,0.9902912621359223,0.009708737864077669,Michael E. Mcmahon RECAP,0.9902912621359223
63021,63021,99.00,62,22,0,84,84,0,0.7380952380952381,0.2619047619047619,0.0,1.0,0.0,Michael E. Mcmahon RECAP,1.0
63022,63022,99.00,87,31,2,120,118,2,0.725,0.25833333333333336,0.016666666666666666,0.9833333333333333,0.016666666666666666,Michael E. Mcmahon RECAP,0.9833333333333333
63023,63023,99.00,65,35,3,103,100,3,0.6310679611650486,0.33980582524271846,0.02912621359223301,0.970873786407767,0.02912621359223301,Michael E. Mcmahon RECAP,0.970873786407767
63024,63024,99.00,160,76,4,240,236,4,0.6666666666666666,0.31666666666666665,0.016666666666666666,0.9833333333333333,0.016666666666666666,Michael E. Mcmahon RECAP,0.9833333333333333
63025,63025,99.00,6,0,0,6,6,0,1.0,0.0,0.0,1.0,0.0,Michael E. Mcmahon RECAP,1.0
63026,63026,99.00,105,52,3,160,157,3,0.65625,0.325,0.01875,0.98125,0.01875,Michael E. Mcmahon RECAP,0.98125
63027,63027,99.00,127,41,2,170,168,2,0.7470588235294118,0.2411764705882353,0.011764705882352941,0.9882352941176471,0.011764705882352941,Michael E. Mcmahon RECAP,0.9882352941176471
63028,63028,99.00,3,1,0,4,4,0,0.75,0.25,0.0,1.0,0.0,Michael E. Mcmahon RECAP,1.0
63029,63029,99.00,153,62,4,219,215,4,0.6986301369863014,0.2831050228310502,0.0182648401826484,0.9817351598173516,0.0182648401826484,Michael E. Mcmahon RECAP,0.9817351598173516
63030,63030,99.00,109,14,3,126,123,3,0.8650793650793651,0.1111111111111111,0.023809523809523808,0.9761904761904762,0.023809523809523808,Michael E. Mcmahon RECAP,0.9761904761904762
63031,63031,99.00,126,33,3,162,159,3,0.7777777777777778,0.2037037037037037,0.018518518518518517,0.9814814814814815,0.018518518518518517,Michael E. Mcmahon RECAP,0.9814814814814815
63032,63032,99.00,93,24,2,119,117,2,0.7815126050420168,0.20168067226890757,0.01680672268907563,0.9831932773109243,0.01680672268907563,Michael E. Mcmahon RECAP,0.9831932773109243
63033,63033,99.00,123,55,8,186,178,8,0.6612903225806451,0.2956989247311828,0.043010752688172046,0.956989247311828,0.043010752688172046,Michael E. Mcmahon RECAP,0.956989247311828
63034,63034,99.00,95,30,2,127,125,2,0.7480314960629921,0.23622047244094488,0.015748031496062992,0.984251968503937,0.015748031496062992,Michael E. Mcmahon RECAP,0.984251968503937
63035,63035,99.00,144,38,7,189,182,7,0.7619047619047619,0.20105820105820105,0.037037037037037035,0.9629629629629629,0.037037037037037035,Michael E. Mcmahon RECAP,0.9629629629629629
63036,63036,99.00,180,38,5,223,218,5,0.8071748878923767,0.17040358744394618,0.02242152466367713,0.9775784753363229,0.02242152466367713,Michael E. Mcmahon RECAP,0.9775784753363229
63037,63037,99.00,170,14,4,188,184,4,0.9042553191489362,0.07446808510638298,0.02127659574468085,0.9787234042553191,0.02127659574468085,Michael E. Mcmahon RECAP,0.9787234042553191
63038,63038,99.00,146,11,1,158,157,1,0.9240506329113924,0.06962025316455696,0.006329113924050633,0.9936708860759493,0.006329113924050633,Michael E. Mcmahon RECAP,0.9936708860759493
63039,63039,99.00,74,12,0,86,86,0,0.8604651162790697,0.13953488372093023,0.0,1.0,0.0,Michael E. Mcmahon RECAP,1.0
63040,63040,99.00,2,2,0,4,4,0,0.5,0.5,0.0,1.0,0.0,Michael E. Mcmahon RECAP,1.0
63041,63041,50.00,68,2,4,74,70,4,0.918918918918919,0.02702702702702703,0.05405405405405406,0.9459459459459459,0.05405405405405406,Michael E. Mcmahon RECAP,0.9459459459459459
63042,63042,99.00,99,2,0,101,101,0,0.9801980198019802,0.019801980198019802,0.0,1.0,0.0,Michael E. Mcmahon RECAP,1.0
63043,63043,99.00,145,7,0,152,152,0,0.9539473684210527,0.046052631578947366,0.0,1.0,0.0,Michael E. Mcmahon RECAP,1.0
63044,63044,99.00,142,7,0,149,149,0,0.9530201342281879,0.04697986577181208,0.0,1.0,0.0,Michael E. Mcmahon RECAP,1.0
63045,63045,99.00,112,3,0,115,115,0,0.9739130434782609,0.02608695652173913,0.0,1.0,0.0,Michael E. Mcmahon RECAP,1.0
63046,63046,99.00,211,68,4,283,279,4,0.7455830388692579,0.24028268551236748,0.014134275618374558,0.9858657243816255,0.014134275618374558,Michael E. Mcmahon RECAP,0.9858657243816255
63047,63047,99.00,6,2,0,8,8,0,0.75,0.25,0.0,1.0,0.0,Michael E. Mcmahon RECAP,1.0
63048,63048,99.00,89,37,2,128,126,2,0.6953125,0.2890625,0.015625,0.984375,0.015625,Michael E. Mcmahon RECAP,0.984375
63049,63049,99.00,187,58,7,252,245,7,0.7420634920634921,0.23015873015873015,0.027777777777777776,0.9722222222222222,0.027777777777777776,Michael E. Mcmahon RECAP,0.9722222222222222
63050,63050,99.00,99,27,4,130,126,4,0.7615384615384615,0.2076923076923077,0.03076923076923077,0.9692307692307692,0.03076923076923077,Michael E. Mcmahon RECAP,0.9692307692307692
63051,63051,99.00,7,0,0,7,7,0,1.0,0.0,0.0,1.0,0.0,Michael E. Mcmahon RECAP,1.0
63052,63052,99.00,132,31,0,163,163,0,0.8098159509202454,0.1901840490797546,0.0,1.0,0.0,Michael E. Mcmahon RECAP,1.0
63053,63053,99.00,129,26,2,157,155,2,0.821656050955414,0.16560509554140126,0.012738853503184714,0.9872611464968153,0.012738853503184714,Michael E. Mcmahon RECAP,0.9872611464968153
63054,63054,99.00,118,36,5,159,154,5,0.7421383647798742,0.22641509433962265,0.031446540880503145,0.9685534591194969,0.031446540880503145,Michael E. Mcmahon RECAP,0.9685534591194969
63055,63055,99.00,79,32,3,114,111,3,0.6929824561403509,0.2807017543859649,0.02631578947368421,0.9736842105263158,0.02631578947368421,Michael E. Mcmahon RECAP,0.9736842105263158
63056,63056,99.00,1,0,0,1,1,0,1.0,0.0,0.0,1.0,0.0,Michael E. Mcmahon RECAP,1.0
63057,63057,99.00,205,81,3,289,286,3,0.7093425605536332,0.28027681660899656,0.010380622837370242,0.9896193771626297,0.010380622837370242,Michael E. Mcmahon RECAP,0.9896193771626297
63058,63058,99.00,97,35,7,139,132,7,0.697841726618705,0.2517985611510791,0.050359712230215826,0.9496402877697842,0.050359712230215826,Michael E. Mcmahon RECAP,0.9496402877697842
63059,63059,99.00,194,65,5,264,259,5,0.7348484848484849,0.24621212121212122,0.01893939393939394,0.9810606060606061,0.01893939393939394,Michael E. Mcmahon RECAP,0.9810606060606061
63060,63060,99.00,5,2,0,7,7,0,0.7142857142857143,0.2857142857142857,0.0,1.0,0.0,Michael E. Mcmahon RECAP,1.0
63061,63061,57.14,172,19,3,194,191,3,0.8865979381443299,0.0979381443298969,0.015463917525773196,0.9845360824742269,0.015463917525773196,Michael E. Mcmahon RECAP,0.9845360824742269
63062,63062,99.00,204,44,2,250,248,2,0.816,0.176,0.008,0.992,0.008,Michael E. Mcmahon RECAP,0.992
63063,63063,99.00,184,42,3,229,226,3,0.8034934497816594,0.18340611353711792,0.013100436681222707,0.9868995633187773,0.013100436681222707,Michael E. Mcmahon RECAP,0.9868995633187773
63064,63064,99.00,313,80,7,400,393,7,0.7825,0.2,0.0175,0.9825,0.0175,Michael E. Mcmahon RECAP,0.9825
63065,63065,99.00,151,37,2,190,188,2,0.7947368421052632,0.19473684210526315,0.010526315789473684,0.9894736842105263,0.010526315789473684,Michael E. Mcmahon RECAP,0.9894736842105263
63066,63066,99.00,6,2,0,8,8,0,0.75,0.25,0.0,1.0,0.0,Michael E. Mcmahon RECAP,1.0
63067,63067,99.00,188,43,1,232,231,1,0.8103448275862069,0.1853448275862069,0.004310344827586207,0.9956896551724138,0.004310344827586207,Michael E. Mcmahon RECAP,0.9956896551724138
63068,63068,99.00,2,2,0,4,4,0,0.5,0.5,0.0,1.0,0.0,Michael E. Mcmahon RECAP,1.0
63069,63069,99.00,5,2,1,8,7,1,0.625,0.25,0.125,0.875,0.125,Michael E. Mcmahon RECAP,0.875
63070,63070,99.00,4,1,0,5,5,0,0.8,0.2,0.0,1.0,0.0,Michael E. Mcmahon RECAP,1.0
63071,63071,99.00,98,7,2,107,105,2,0.9158878504672897,0.06542056074766354,0.018691588785046728,0.9813084112149533,0.018691588785046728,Michael E. Mcmahon RECAP,0.9813084112149533
63072,63072,99.00,147,32,2,181,179,2,0.8121546961325967,0.17679558011049723,0.011049723756906077,0.988950276243094,0.011049723756906077,Michael E. Mcmahon RECAP,0.988950276243094
63073,63073,99.00,105,30,3,138,135,3,0.7608695652173914,0.21739130434782608,0.021739130434782608,0.9782608695652174,0.021739130434782608,Michael E. Mcmahon RECAP,0.9782608695652174
63074,63074,99.00,8,1,0,9,9,0,0.8888888888888888,0.1111111111111111,0.0,1.0,0.0,Michael E. Mcmahon RECAP,1.0
63075,63075,99.00,58,6,0,64,64,0,0.90625,0.09375,0.0,1.0,0.0,Michael E. Mcmahon RECAP,1.0
63076,63076,99.00,92,32,4,128,124,4,0.71875,0.25,0.03125,0.96875,0.03125,Michael E. Mcmahon RECAP,0.96875
63077,63077,99.00,85,23,2,110,108,2,0.7727272727272727,0.20909090909090908,0.01818181818181818,0.9818181818181818,0.01818181818181818,Michael E. Mcmahon RECAP,0.9818181818181818
63078,63078,99.00,4,1,0,5,5,0,0.8,0.2,0.0,1.0,0.0,Michael E. Mcmahon RECAP,1.0
63079,63079,99.00,8,1,0,9,9,0,0.8888888888888888,0.1111111111111111,0.0,1.0,0.0,Michael E. Mcmahon RECAP,1.0
63080,63080,99.00,115,9,2,126,124,2,0.9126984126984127,0.07142857142857142,0.015873015873015872,0.9841269841269841,0.015873015873015872,Michael E. Mcmahon RECAP,0.9841269841269841
63081,63081,99.00,2,0,0,2,2,0,1.0,0.0,0.0,1.0,0.0,Michael E. Mcmahon RECAP,1.0
63082,63082,99.00,143,36,6,185,179,6,0.772972972972973,0.1945945945945946,0.032432432432432434,0.9675675675675676,0.032432432432432434,Michael E. Mcmahon RECAP,0.9675675675675676
63083,63083,99.00,176,37,5,218,213,5,0.8073394495412844,0.16972477064220184,0.022935779816513763,0.9770642201834863,0.022935779816513763,Michael E. Mcmahon RECAP,0.9770642201834863
63084,63084,99.00,89,23,6,118,112,6,0.7542372881355932,0.19491525423728814,0.05084745762711865,0.9491525423728814,0.05084745762711865,Michael E. Mcmahon RECAP,0.9491525423728814
63085,63085,0.00,3,1,0,4,4,0,0.75,0.25,0.0,1.0,0.0,Michael E. Mcmahon RECAP,1.0
63086,63086,99.00,0,0,0,0,0,0,0,0,0,0,0,n/a,0
63087,63087,99.00,0,0,0,0,0,0,0,0,0,0,0,n/a,0
63088,63088,99.00,0,0,0,0,0,0,0,0,0,0,0,n/a,0
63089,63089,99.00,0,0,0,0,0,0,0,0,0,0,0,n/a,0
63090,63090,99.00,0,0,0,0,0,0,0,0,0,0,0,n/a,0
64001,64001,50.00,60,32,1,93,92,1,0.6451612903225806,0.34408602150537637,0.010752688172043012,0.989247311827957,0.010752688172043012,Michael E. Mcmahon RECAP,0.989247311827957
64002,64002,50.00,101,27,4,132,128,4,0.7651515151515151,0.20454545454545456,0.030303030303030304,0.9696969696969697,0.030303030303030304,Michael E. Mcmahon RECAP,0.9696969696969697
64003,64003,99.00,180,66,4,250,246,4,0.72,0.264,0.016,0.984,0.016,Michael E. Mcmahon RECAP,0.984
64004,64004,99.00,4,1,0,5,5,0,0.8,0.2,0.0,1.0,0.0,Michael E. Mcmahon RECAP,1.0
64005,64005,99.00,199,72,3,274,271,3,0.7262773722627737,0.26277372262773724,0.010948905109489052,0.9890510948905109,0.010948905109489052,Michael E. Mcmahon RECAP,0.9890510948905109
64006,64006,50.00,109,48,3,160,157,3,0.68125,0.3,0.01875,0.98125,0.01875,Michael E. Mcmahon RECAP,0.98125
64007,64007,50.00,106,34,3,143,140,3,0.7412587412587412,0.23776223776223776,0.02097902097902098,0.9790209790209791,0.02097902097902098,Michael E. Mcmahon RECAP,0.9790209790209791
64008,64008,99.00,12,5,3,20,17,3,0.6,0.25,0.15,0.85,0.15,Michael E. Mcmahon RECAP,0.85
64009,64009,99.00,109,72,5,186,181,5,0.5860215053763441,0.3870967741935484,0.026881720430107527,0.9731182795698925,0.026881720430107527,Michael E. Mcmahon RECAP,0.9731182795698925
64010,64010,99.00,4,3,0,7,7,0,0.5714285714285714,0.42857142857142855,0.0,1.0,0.0,Michael E. Mcmahon RECAP,1.0
64011,64011,99.00,129,49,2,180,178,2,0.7166666666666667,0.2722222222222222,0.011111111111111112,0.9888888888888889,0.011111111111111112,Michael E. Mcmahon RECAP,0.9888888888888889
64012,64012,99.00,3,1,0,4,4,0,0.75,0.25,0.0,1.0,0.0,Michael E. Mcmahon RECAP,1.0
64013,64013,99.00,2,2,0,4,4,0,0.5,0.5,0.0,1.0,0.0,Michael E. Mcmahon RECAP,1.0
64014,64014,99.00,198,71,5,274,269,5,0.7226277372262774,0.2591240875912409,0.01824817518248175,0.9817518248175182,0.01824817518248175,Michael E. Mcmahon RECAP,0.9817518248175182
64015,64015,99.00,12,4,2,18,16,2,0.6666666666666666,0.2222222222222222,0.1111111111111111,0.8888888888888888,0.1111111111111111,Michael E. Mcmahon RECAP,0.8888888888888888
64016,64016,57.14,178,57,4,239,235,4,0.7447698744769874,0.2384937238493724,0.016736401673640166,0.9832635983263598,0.016736401673640166,Michael E. Mcmahon RECAP,0.9832635983263598
64017,64017,57.14,31,2,0,33,33,0,0.9393939393939394,0.06060606060606061,0.0,1.0,0.0,Michael E. Mcmahon RECAP,1.0
64018,64018,99.00,76,25,2,103,101,2,0.7378640776699029,0.24271844660194175,0.019417475728155338,0.9805825242718447,0.019417475728155338,Michael E. Mcmahon RECAP,0.9805825242718447
64019,64019,57.14,72,10,1,83,82,1,0.8674698795180723,0.12048192771084337,0.012048192771084338,0.9879518072289156,0.012048192771084338,Michael E. Mcmahon RECAP,0.9879518072289156
64020,64020,99.00,68,16,4,88,84,4,0.7727272727272727,0.18181818181818182,0.045454545454545456,0.9545454545454546,0.045454545454545456,Michael E. Mcmahon RECAP,0.9545454545454546
64021,64021,99.00,70,36,3,109,106,3,0.6422018348623854,0.3302752293577982,0.027522935779816515,0.9724770642201835,0.027522935779816515,Michael E. Mcmahon RECAP,0.9724770642201835
64022,64022,57.14,205,66,5,276,271,5,0.7427536231884058,0.2391304347826087,0.018115942028985508,0.9818840579710145,0.018115942028985508,Michael E. Mcmahon RECAP,0.9818840579710145
64023,64023,99.00,188,62,5,255,250,5,0.7372549019607844,0.24313725490196078,0.0196078431372549,0.9803921568627451,0.0196078431372549,Michael E. Mcmahon RECAP,0.9803921568627451
64024,64024,99.00,140,47,9,196,187,9,0.7142857142857143,0.23979591836734693,0.04591836734693878,0.9540816326530612,0.04591836734693878,Michael E. Mcmahon RECAP,0.9540816326530612
64025,64025,99.00,82,27,6,115,109,6,0.7130434782608696,0.23478260869565218,0.05217391304347826,0.9478260869565217,0.05217391304347826,Michael E. Mcmahon RECAP,0.9478260869565217
64026,64026,99.00,4,1,0,5,5,0,0.8,0.2,0.0,1.0,0.0,Michael E. Mcmahon RECAP,1.0
64027,64027,99.00,67,27,5,99,94,5,0.6767676767676768,0.2727272727272727,0.050505050505050504,0.9494949494949495,0.050505050505050504,Michael E. Mcmahon RECAP,0.9494949494949495
64028,64028,99.00,130,60,3,193,190,3,0.6735751295336787,0.31088082901554404,0.015544041450777202,0.9844559585492227,0.015544041450777202,Michael E. Mcmahon RECAP,0.9844559585492227
64029,64029,99.00,14,1,0,15,15,0,0.9333333333333333,0.06666666666666667,0.0,1.0,0.0,Michael E. Mcmahon RECAP,1.0
64030,64030,99.00,135,77,3,215,212,3,0.627906976744186,0.3581395348837209,0.013953488372093023,0.986046511627907,0.013953488372093023,Michael E. Mcmahon RECAP,0.986046511627907
64031,64031,99.00,7,2,0,9,9,0,0.7777777777777778,0.2222222222222222,0.0,1.0,0.0,Michael E. Mcmahon RECAP,1.0
64032,64032,99.00,164,51,9,224,215,9,0.7321428571428571,0.22767857142857142,0.04017857142857143,0.9598214285714286,0.04017857142857143,Michael E. Mcmahon RECAP,0.9598214285714286
64033,64033,99.00,67,25,2,94,92,2,0.7127659574468085,0.26595744680851063,0.02127659574468085,0.9787234042553191,0.02127659574468085,Michael E. Mcmahon RECAP,0.9787234042553191
64034,64034,99.00,6,2,0,8,8,0,0.75,0.25,0.0,1.0,0.0,Michael E. Mcmahon RECAP,1.0
64035,64035,99.00,91,24,2,117,115,2,0.7777777777777778,0.20512820512820512,0.017094017094017096,0.9829059829059829,0.017094017094017096,Michael E. Mcmahon RECAP,0.9829059829059829
64036,64036,99.00,157,47,8,212,204,8,0.7405660377358491,0.22169811320754718,0.03773584905660377,0.9622641509433962,0.03773584905660377,Michael E. Mcmahon RECAP,0.9622641509433962
64037,64037,99.00,146,48,8,202,194,8,0.7227722772277227,0.2376237623762376,0.039603960396039604,0.9603960396039604,0.039603960396039604,Michael E. Mcmahon RECAP,0.9603960396039604
64038,64038,99.00,90,29,3,122,119,3,0.7377049180327869,0.23770491803278687,0.02459016393442623,0.9754098360655737,0.02459016393442623,Michael E. Mcmahon RECAP,0.9754098360655737
64039,64039,99.00,4,3,0,7,7,0,0.5714285714285714,0.42857142857142855,0.0,1.0,0.0,Michael E. Mcmahon RECAP,1.0
64040,64040,99.00,108,16,0,124,124,0,0.8709677419354839,0.12903225806451613,0.0,1.0,0.0,Michael E. Mcmahon RECAP,1.0
64041,64041,99.00,120,41,6,167,161,6,0.718562874251497,0.24550898203592814,0.03592814371257485,0.9640718562874252,0.03592814371257485,Michael E. Mcmahon RECAP,0.9640718562874252
64042,64042,99.00,90,11,1,102,101,1,0.8823529411764706,0.10784313725490197,0.00980392156862745,0.9901960784313726,0.00980392156862745,Michael E. Mcmahon RECAP,0.9901960784313726
64043,64043,99.00,113,26,2,141,139,2,0.8014184397163121,0.18439716312056736,0.014184397163120567,0.9858156028368794,0.014184397163120567,Michael E. Mcmahon RECAP,0.9858156028368794
64044,64044,99.00,86,22,1,109,108,1,0.7889908256880734,0.2018348623853211,0.009174311926605505,0.9908256880733946,0.009174311926605505,Michael E. Mcmahon RECAP,0.9908256880733946
64045,64045,99.00,7,5,1,13,12,1,0.5384615384615384,0.38461538461538464,0.07692307692307693,0.9230769230769231,0.07692307692307693,Michael E. Mcmahon RECAP,0.9230769230769231
64046,64046,99.00,10,5,0,15,15,0,0.6666666666666666,0.3333333333333333,0.0,1.0,0.0,Michael E. Mcmahon RECAP,1.0
64047,64047,99.00,229,58,3,290,287,3,0.7896551724137931,0.2,0.010344827586206896,0.9896551724137931,0.010344827586206896,Michael E. Mcmahon RECAP,0.9896551724137931
64048,64048,99.00,93,44,3,140,137,3,0.6642857142857143,0.3142857142857143,0.02142857142857143,0.9785714285714285,0.02142857142857143,Michael E. Mcmahon RECAP,0.9785714285714285
64049,64049,99.00,125,35,0,160,160,0,0.78125,0.21875,0.0,1.0,0.0,Michael E. Mcmahon RECAP,1.0
64050,64050,99.00,5,0,1,6,5,1,0.8333333333333334,0.0,0.16666666666666666,0.8333333333333334,0.16666666666666666,Michael E. Mcmahon RECAP,0.8333333333333334
64051,64051,99.00,192,41,6,239,233,6,0.803347280334728,0.17154811715481172,0.02510460251046025,0.9748953974895398,0.02510460251046025,Michael E. Mcmahon RECAP,0.9748953974895398
64052,64052,99.00,5,1,0,6,6,0,0.8333333333333334,0.16666666666666666,0.0,1.0,0.0,Michael E. Mcmahon RECAP,1.0
64053,64053,99.00,164,25,1,190,189,1,0.8631578947368421,0.13157894736842105,0.005263157894736842,0.9947368421052631,0.005263157894736842,Michael E. Mcmahon RECAP,0.9947368421052631
64054,64054,99.00,108,35,6,149,143,6,0.7248322147651006,0.2348993288590604,0.040268456375838924,0.959731543624161,0.040268456375838924,Michael E. Mcmahon RECAP,0.959731543624161
64055,64055,99.00,90,32,2,124,122,2,0.7258064516129032,0.25806451612903225,0.016129032258064516,0.9838709677419355,0.016129032258064516,Michael E. Mcmahon RECAP,0.9838709677419355
64056,64056,57.14,18,8,0,26,26,0,0.6923076923076923,0.3076923076923077,0.0,1.0,0.0,Michael E. Mcmahon RECAP,1.0
64057,64057,99.00,4,1,0,5,5,0,0.8,0.2,0.0,1.0,0.0,Michael E. Mcmahon RECAP,1.0
64058,64058,50.00,67,34,3,104,101,3,0.6442307692307693,0.3269230769230769,0.028846153846153848,0.9711538461538461,0.028846153846153848,Michael E. Mcmahon RECAP,0.9711538461538461
64059,64059,99.00,67,22,3,92,89,3,0.7282608695652174,0.2391304347826087,0.03260869565217391,0.967391304347826,0.03260869565217391,Michael E. Mcmahon RECAP,0.967391304347826
64060,64060,99.00,5,3,0,8,8,0,0.625,0.375,0.0,1.0,0.0,Michael E. Mcmahon RECAP,1.0
64061,64061,99.00,5,1,0,6,6,0,0.8333333333333334,0.16666666666666666,0.0,1.0,0.0,Michael E. Mcmahon RECAP,1.0
64062,64062,99.00,91,29,4,124,120,4,0.7338709677419355,0.23387096774193547,0.03225806451612903,0.967741935483871,0.03225806451612903,Michael E. Mcmahon RECAP,0.967741935483871
64063,64063,99.00,85,22,1,108,107,1,0.7870370370370371,0.2037037037037037,0.009259259259259259,0.9907407407407407,0.009259259259259259,Michael E. Mcmahon RECAP,0.9907407407407407
64064,64064,99.00,0,0,0,0,0,0,0,0,0,0,0,n/a,0
64065,64065,99.00,0,0,0,0,0,0,0,0,0,0,0,n/a,0
64066,64066,99.00,0,0,0,0,0,0,0,0,0,0,0,n/a,0
64067,64067,99.00,0,0,0,0,0,0,0,0,0,0,0,n/a,0
64068,64068,99.00,0,0,0,0,0,0,0,0,0,0,0,n/a,0
64069,64069,99.00,0,0,0,0,0,0,0,0,0,0,0,n/a,0
64070,64070,99.00,0,0,0,0,0,0,0,0,0,0,0,n/a,0
