ED,Reported As,Reporting,Yes,No,Total Votes,p_Yes,p_No,winner,winner_p
65001,65001,99.00,123,40,163,0.754601226993865,0.24539877300613497,Yes,0.754601226993865
65002,65002,99.00,106,45,151,0.7019867549668874,0.2980132450331126,Yes,0.7019867549668874
65003,65003,75.00,171,50,221,0.7737556561085973,0.22624434389140272,Yes,0.7737556561085973
65004,65004,99.00,65,32,97,0.6701030927835051,0.32989690721649484,Yes,0.6701030927835051
65005,65005,75.00,0,0,0,0,0,n/a,0
65006,65006,99.00,276,89,365,0.7561643835616438,0.24383561643835616,Yes,0.7561643835616438
65007,65007,99.00,5,0,5,1.0,0.0,Yes,1.0
65008,65008,99.00,184,60,244,0.7540983606557377,0.2459016393442623,Yes,0.7540983606557377
65009,65009,99.00,112,48,160,0.7,0.3,Yes,0.7
65010,65010,99.00,107,52,159,0.6729559748427673,0.3270440251572327,Yes,0.6729559748427673
65011,65011,99.00,1,2,3,0.3333333333333333,0.6666666666666666,No,0.6666666666666666
65012,65012,99.00,87,39,126,0.6904761904761905,0.30952380952380953,Yes,0.6904761904761905
65013,65013,99.00,3,3,6,0.5,0.5,Tie,0.5
65014,65014,99.00,222,90,312,0.7115384615384616,0.28846153846153844,Yes,0.7115384615384616
65015,65015,99.00,185,71,256,0.72265625,0.27734375,Yes,0.72265625
65016,65016,99.00,116,56,172,0.6744186046511628,0.32558139534883723,Yes,0.6744186046511628
65017,65017,99.00,8,2,10,0.8,0.2,Yes,0.8
65018,65018,99.00,102,28,130,0.7846153846153846,0.2153846153846154,Yes,0.7846153846153846
65019,65019,99.00,87,18,105,0.8285714285714286,0.17142857142857143,Yes,0.8285714285714286
65020,65020,99.00,4,0,4,1.0,0.0,Yes,1.0
65021,65021,99.00,136,17,153,0.8888888888888888,0.1111111111111111,Yes,0.8888888888888888
65022,65022,99.00,139,41,180,0.7722222222222223,0.22777777777777777,Yes,0.7722222222222223
65023,65023,99.00,131,14,145,0.903448275862069,0.09655172413793103,Yes,0.903448275862069
65024,65024,99.00,86,17,103,0.8349514563106796,0.1650485436893204,Yes,0.8349514563106796
65025,65025,99.00,4,1,5,0.8,0.2,Yes,0.8
65026,65026,99.00,5,0,5,1.0,0.0,Yes,1.0
65027,65027,99.00,156,31,187,0.8342245989304813,0.1657754010695187,Yes,0.8342245989304813
65028,65028,99.00,8,1,9,0.8888888888888888,0.1111111111111111,Yes,0.8888888888888888
65029,65029,99.00,7,2,9,0.7777777777777778,0.2222222222222222,Yes,0.7777777777777778
65030,65030,99.00,241,46,287,0.8397212543554007,0.1602787456445993,Yes,0.8397212543554007
65031,65031,99.00,5,0,5,1.0,0.0,Yes,1.0
65032,65032,99.00,90,13,103,0.8737864077669902,0.1262135922330097,Yes,0.8737864077669902
65033,65033,99.00,85,16,101,0.8415841584158416,0.15841584158415842,Yes,0.8415841584158416
65034,65034,99.00,8,1,9,0.8888888888888888,0.1111111111111111,Yes,0.8888888888888888
65035,65035,99.00,55,7,62,0.8870967741935484,0.11290322580645161,Yes,0.8870967741935484
65036,65036,99.00,116,25,141,0.8226950354609929,0.1773049645390071,Yes,0.8226950354609929
65037,65037,99.00,45,5,50,0.9,0.1,Yes,0.9
65038,65038,99.00,9,1,10,0.9,0.1,Yes,0.9
65039,65039,99.00,157,28,185,0.8486486486486486,0.15135135135135136,Yes,0.8486486486486486
65040,65040,33.33,116,21,137,0.8467153284671532,0.15328467153284672,Yes,0.8467153284671532
65041,65041,33.33,25,2,27,0.9259259259259259,0.07407407407407407,Yes,0.9259259259259259
65042,65042,99.00,18,4,22,0.8181818181818182,0.18181818181818182,Yes,0.8181818181818182
65043,65043,33.33,100,24,124,0.8064516129032258,0.1935483870967742,Yes,0.8064516129032258
65044,65044,0.00,20,4,24,0.8333333333333334,0.16666666666666666,Yes,0.8333333333333334
65045,65045,99.00,185,57,242,0.7644628099173554,0.23553719008264462,Yes,0.7644628099173554
65046,65046,99.00,161,57,218,0.7385321100917431,0.26146788990825687,Yes,0.7385321100917431
65047,65047,99.00,137,47,184,0.7445652173913043,0.2554347826086957,Yes,0.7445652173913043
65048,65048,0.00,12,6,18,0.6666666666666666,0.3333333333333333,Yes,0.6666666666666666
65049,65049,99.00,230,41,271,0.8487084870848709,0.15129151291512916,Yes,0.8487084870848709
65050,65050,99.00,7,1,8,0.875,0.125,Yes,0.875
65051,65051,0.00,9,3,12,0.75,0.25,Yes,0.75
65052,65052,99.00,154,40,194,0.7938144329896907,0.20618556701030927,Yes,0.7938144329896907
65053,65053,50.00,73,22,95,0.7684210526315789,0.23157894736842105,Yes,0.7684210526315789
65054,65054,99.00,138,46,184,0.75,0.25,Yes,0.75
65055,65055,50.00,8,0,8,1.0,0.0,Yes,1.0
65056,65056,99.00,82,7,89,0.9213483146067416,0.07865168539325842,Yes,0.9213483146067416
65057,65057,50.00,120,46,166,0.7228915662650602,0.27710843373493976,Yes,0.7228915662650602
65058,65058,99.00,181,38,219,0.8264840182648402,0.1735159817351598,Yes,0.8264840182648402
65059,65059,99.00,175,34,209,0.8373205741626795,0.16267942583732056,Yes,0.8373205741626795
65060,65060,99.00,1,1,2,0.5,0.5,Tie,0.5
65061,65061,99.00,159,35,194,0.8195876288659794,0.18041237113402062,Yes,0.8195876288659794
65062,65062,99.00,5,0,5,1.0,0.0,Yes,1.0
65063,65063,99.00,135,33,168,0.8035714285714286,0.19642857142857142,Yes,0.8035714285714286
65064,65064,99.00,122,32,154,0.7922077922077922,0.2077922077922078,Yes,0.7922077922077922
65065,65065,99.00,5,3,8,0.625,0.375,Yes,0.625
65066,65066,99.00,2,0,2,1.0,0.0,Yes,1.0
65067,65067,99.00,3,0,3,1.0,0.0,Yes,1.0
65068,65068,99.00,227,69,296,0.7668918918918919,0.23310810810810811,Yes,0.7668918918918919
65069,65069,99.00,9,3,12,0.75,0.25,Yes,0.75
65070,65070,99.00,0,0,0,0,0,n/a,0
65071,65071,99.00,152,34,186,0.8172043010752689,0.1827956989247312,Yes,0.8172043010752689
65072,65072,99.00,162,24,186,0.8709677419354839,0.12903225806451613,Yes,0.8709677419354839
65073,65073,66.67,74,21,95,0.7789473684210526,0.22105263157894736,Yes,0.7789473684210526
65074,65074,99.00,5,0,5,1.0,0.0,Yes,1.0
65075,65075,66.67,4,0,4,1.0,0.0,Yes,1.0
65076,65076,66.67,62,18,80,0.775,0.225,Yes,0.775
65077,65077,99.00,161,33,194,0.8298969072164949,0.17010309278350516,Yes,0.8298969072164949
65078,65078,99.00,160,38,198,0.8080808080808081,0.1919191919191919,Yes,0.8080808080808081
65079,65079,99.00,275,82,357,0.7703081232492998,0.22969187675070027,Yes,0.7703081232492998
65080,65080,99.00,154,34,188,0.8191489361702128,0.18085106382978725,Yes,0.8191489361702128
65081,65081,99.00,123,24,147,0.8367346938775511,0.16326530612244897,Yes,0.8367346938775511
65082,65082,99.00,0,0,0,0,0,n/a,0
65083,65083,33.33,6,0,6,1.0,0.0,Yes,1.0
65084,65084,99.00,0,0,0,0,0,n/a,0
65085,65085,75.00,141,69,210,0.6714285714285714,0.32857142857142857,Yes,0.6714285714285714
65086,65086,75.00,3,1,4,0.75,0.25,Yes,0.75
65087,65087,99.00,97,23,120,0.8083333333333333,0.19166666666666668,Yes,0.8083333333333333
65088,65088,99.00,118,35,153,0.7712418300653595,0.22875816993464052,Yes,0.7712418300653595
65089,65089,99.00,2,1,3,0.6666666666666666,0.3333333333333333,Yes,0.6666666666666666
65090,65090,99.00,7,2,9,0.7777777777777778,0.2222222222222222,Yes,0.7777777777777778
65091,65091,99.00,143,31,174,0.8218390804597702,0.1781609195402299,Yes,0.8218390804597702
65092,65092,99.00,2,0,2,1.0,0.0,Yes,1.0
65093,65093,99.00,2,2,4,0.5,0.5,Tie,0.5
65094,65094,99.00,0,0,0,0,0,n/a,0
65095,65095,99.00,0,0,0,0,0,n/a,0
65096,65096,99.00,0,0,0,0,0,n/a,0
65097,65097,99.00,0,0,0,0,0,n/a,0
65098,65098,99.00,0,0,0,0,0,n/a,0
65099,65099,66.67,3,0,3,1.0,0.0,Yes,1.0
66001,66001,99.00,122,47,169,0.7218934911242604,0.2781065088757396,Yes,0.7218934911242604
66002,66002,99.00,4,0,4,1.0,0.0,Yes,1.0
66003,66003,99.00,160,84,244,0.6557377049180327,0.3442622950819672,Yes,0.6557377049180327
66004,66004,99.00,59,34,93,0.6344086021505376,0.3655913978494624,Yes,0.6344086021505376
66005,66005,99.00,166,92,258,0.6434108527131783,0.35658914728682173,Yes,0.6434108527131783
66006,66006,99.00,5,4,9,0.5555555555555556,0.4444444444444444,Yes,0.5555555555555556
66007,66007,99.00,7,1,8,0.875,0.125,Yes,0.875
66008,66008,99.00,159,63,222,0.7162162162162162,0.28378378378378377,Yes,0.7162162162162162
66009,66009,99.00,127,61,188,0.675531914893617,0.324468085106383,Yes,0.675531914893617
66010,66010,99.00,128,22,150,0.8533333333333334,0.14666666666666667,Yes,0.8533333333333334
66011,66011,99.00,151,48,199,0.7587939698492462,0.24120603015075376,Yes,0.7587939698492462
66012,66012,99.00,88,47,135,0.6518518518518519,0.34814814814814815,Yes,0.6518518518518519
66013,66013,99.00,179,51,230,0.7782608695652173,0.2217391304347826,Yes,0.7782608695652173
66014,66014,99.00,138,24,162,0.8518518518518519,0.14814814814814814,Yes,0.8518518518518519
66015,66015,99.00,10,3,13,0.7692307692307693,0.23076923076923078,Yes,0.7692307692307693
66016,66016,99.00,1,1,2,0.5,0.5,Tie,0.5
66017,66017,99.00,0,0,0,0,0,n/a,0
66018,66018,99.00,4,5,9,0.4444444444444444,0.5555555555555556,No,0.5555555555555556
66019,66019,99.00,11,2,13,0.8461538461538461,0.15384615384615385,Yes,0.8461538461538461
66020,66020,99.00,140,33,173,0.8092485549132948,0.1907514450867052,Yes,0.8092485549132948
66021,66021,99.00,239,64,303,0.7887788778877888,0.21122112211221122,Yes,0.7887788778877888
66022,66022,99.00,200,82,282,0.7092198581560284,0.2907801418439716,Yes,0.7092198581560284
66023,66023,99.00,272,74,346,0.7861271676300579,0.2138728323699422,Yes,0.7861271676300579
66024,66024,99.00,11,4,15,0.7333333333333333,0.26666666666666666,Yes,0.7333333333333333
66025,66025,99.00,6,1,7,0.8571428571428571,0.14285714285714285,Yes,0.8571428571428571
66026,66026,99.00,191,33,224,0.8526785714285714,0.14732142857142858,Yes,0.8526785714285714
66027,66027,99.00,5,0,5,1.0,0.0,Yes,1.0
66028,66028,99.00,130,26,156,0.8333333333333334,0.16666666666666666,Yes,0.8333333333333334
66029,66029,99.00,12,1,13,0.9230769230769231,0.07692307692307693,Yes,0.9230769230769231
66030,66030,99.00,154,30,184,0.8369565217391305,0.16304347826086957,Yes,0.8369565217391305
66031,66031,99.00,8,2,10,0.8,0.2,Yes,0.8
66032,66032,99.00,227,42,269,0.8438661710037175,0.15613382899628253,Yes,0.8438661710037175
66033,66033,99.00,3,6,9,0.3333333333333333,0.6666666666666666,No,0.6666666666666666
66034,66034,99.00,11,2,13,0.8461538461538461,0.15384615384615385,Yes,0.8461538461538461
66035,66035,99.00,254,61,315,0.8063492063492064,0.19365079365079366,Yes,0.8063492063492064
66036,66036,99.00,165,47,212,0.7783018867924528,0.22169811320754718,Yes,0.7783018867924528
66037,66037,99.00,133,29,162,0.8209876543209876,0.17901234567901234,Yes,0.8209876543209876
66038,66038,99.00,185,74,259,0.7142857142857143,0.2857142857142857,Yes,0.7142857142857143
66039,66039,33.33,58,11,69,0.8405797101449275,0.15942028985507245,Yes,0.8405797101449275
66040,66040,99.00,0,0,0,0,0,n/a,0
66041,66041,99.00,7,3,10,0.7,0.3,Yes,0.7
66042,66042,99.00,4,0,4,1.0,0.0,Yes,1.0
66043,66043,99.00,76,24,100,0.76,0.24,Yes,0.76
66044,66044,99.00,205,62,267,0.7677902621722846,0.23220973782771537,Yes,0.7677902621722846
66045,66045,99.00,225,74,299,0.7525083612040134,0.24749163879598662,Yes,0.7525083612040134
66046,66046,99.00,11,3,14,0.7857142857142857,0.21428571428571427,Yes,0.7857142857142857
66047,66047,87.50,194,83,277,0.7003610108303249,0.2996389891696751,Yes,0.7003610108303249
66048,66048,99.00,148,57,205,0.7219512195121951,0.2780487804878049,Yes,0.7219512195121951
66049,66049,99.00,110,49,159,0.6918238993710691,0.3081761006289308,Yes,0.6918238993710691
66050,66050,99.00,283,131,414,0.6835748792270532,0.3164251207729469,Yes,0.6835748792270532
66051,66051,99.00,30,23,53,0.5660377358490566,0.4339622641509434,Yes,0.5660377358490566
66052,66052,99.00,27,7,34,0.7941176470588235,0.20588235294117646,Yes,0.7941176470588235
66053,66053,99.00,27,13,40,0.675,0.325,Yes,0.675
66054,66054,99.00,251,112,363,0.6914600550964187,0.3085399449035813,Yes,0.6914600550964187
66055,66055,99.00,193,68,261,0.7394636015325671,0.26053639846743293,Yes,0.7394636015325671
66056,66056,99.00,31,13,44,0.7045454545454546,0.29545454545454547,Yes,0.7045454545454546
66057,66057,33.33,132,59,191,0.6910994764397905,0.3089005235602094,Yes,0.6910994764397905
66058,66058,87.50,11,4,15,0.7333333333333333,0.26666666666666666,Yes,0.7333333333333333
66059,66059,87.50,34,12,46,0.7391304347826086,0.2608695652173913,Yes,0.7391304347826086
66060,66060,87.50,18,13,31,0.5806451612903226,0.41935483870967744,Yes,0.5806451612903226
66061,66061,87.50,225,93,318,0.7075471698113207,0.29245283018867924,Yes,0.7075471698113207
66062,66062,87.50,17,2,19,0.8947368421052632,0.10526315789473684,Yes,0.8947368421052632
66063,66063,87.50,197,62,259,0.7606177606177607,0.23938223938223938,Yes,0.7606177606177607
66064,66064,87.50,10,7,17,0.5882352941176471,0.4117647058823529,Yes,0.5882352941176471
66065,66065,99.00,96,40,136,0.7058823529411765,0.29411764705882354,Yes,0.7058823529411765
66066,66066,99.00,16,4,20,0.8,0.2,Yes,0.8
66067,66067,99.00,208,78,286,0.7272727272727273,0.2727272727272727,Yes,0.7272727272727273
66068,66068,99.00,128,43,171,0.7485380116959064,0.25146198830409355,Yes,0.7485380116959064
66069,66069,99.00,11,3,14,0.7857142857142857,0.21428571428571427,Yes,0.7857142857142857
66070,66070,99.00,2,2,4,0.5,0.5,Tie,0.5
66071,66071,99.00,267,67,334,0.7994011976047904,0.20059880239520958,Yes,0.7994011976047904
66072,66072,99.00,7,3,10,0.7,0.3,Yes,0.7
66073,66073,99.00,158,44,202,0.7821782178217822,0.21782178217821782,Yes,0.7821782178217822
66074,66074,99.00,13,3,16,0.8125,0.1875,Yes,0.8125
66075,66075,99.00,226,60,286,0.7902097902097902,0.2097902097902098,Yes,0.7902097902097902
66076,66076,87.50,196,59,255,0.7686274509803922,0.23137254901960785,Yes,0.7686274509803922
66077,66077,99.00,291,80,371,0.784366576819407,0.215633423180593,Yes,0.784366576819407
66078,66078,99.00,308,87,395,0.779746835443038,0.22025316455696203,Yes,0.779746835443038
66079,66079,99.00,280,88,368,0.7608695652173914,0.2391304347826087,Yes,0.7608695652173914
66080,66080,99.00,19,8,27,0.7037037037037037,0.2962962962962963,Yes,0.7037037037037037
66081,66081,99.00,350,72,422,0.8293838862559242,0.17061611374407584,Yes,0.8293838862559242
66082,66082,99.00,12,3,15,0.8,0.2,Yes,0.8
66083,66083,99.00,21,2,23,0.9130434782608695,0.08695652173913043,Yes,0.9130434782608695
66084,66084,99.00,300,104,404,0.7425742574257426,0.25742574257425743,Yes,0.7425742574257426
66085,66085,87.50,238,89,327,0.72782874617737,0.27217125382262997,Yes,0.72782874617737
66086,66086,87.50,137,54,191,0.7172774869109948,0.28272251308900526,Yes,0.7172774869109948
66087,66087,87.50,156,69,225,0.6933333333333334,0.30666666666666664,Yes,0.6933333333333334
66088,66088,99.00,256,87,343,0.7463556851311953,0.2536443148688047,Yes,0.7463556851311953
66089,66089,99.00,10,8,18,0.5555555555555556,0.4444444444444444,Yes,0.5555555555555556
66090,66090,99.00,198,57,255,0.7764705882352941,0.2235294117647059,Yes,0.7764705882352941
66091,66091,99.00,126,71,197,0.6395939086294417,0.3604060913705584,Yes,0.6395939086294417
66092,66092,99.00,0,0,0,0,0,n/a,0
66093,66093,87.50,0,0,0,0,0,n/a,0
66094,66094,99.00,0,0,0,0,0,n/a,0
66095,66095,87.50,0,0,0,0,0,n/a,0
66096,66096,99.00,10,3,13,0.7692307692307693,0.23076923076923078,Yes,0.7692307692307693
66097,66097,99.00,15,5,20,0.75,0.25,Yes,0.75
66098,66098,99.00,227,62,289,0.7854671280276817,0.21453287197231835,Yes,0.7854671280276817
66099,66099,99.00,93,40,133,0.6992481203007519,0.3007518796992481,Yes,0.6992481203007519
66100,66100,99.00,4,2,6,0.6666666666666666,0.3333333333333333,Yes,0.6666666666666666
66101,66101,99.00,16,4,20,0.8,0.2,Yes,0.8
66102,66102,99.00,7,3,10,0.7,0.3,Yes,0.7
66103,66103,99.00,11,1,12,0.9166666666666666,0.08333333333333333,Yes,0.9166666666666666
66104,66104,99.00,2,1,3,0.6666666666666666,0.3333333333333333,Yes,0.6666666666666666
66105,66105,99.00,9,5,14,0.6428571428571429,0.35714285714285715,Yes,0.6428571428571429
66106,66106,99.00,149,38,187,0.7967914438502673,0.20320855614973263,Yes,0.7967914438502673
67001,67001,80.00,192,65,257,0.7470817120622568,0.2529182879377432,Yes,0.7470817120622568
67002,67002,99.00,200,67,267,0.7490636704119851,0.250936329588015,Yes,0.7490636704119851
67003,67003,80.00,3,0,3,1.0,0.0,Yes,1.0
67004,67004,99.00,15,4,19,0.7894736842105263,0.21052631578947367,Yes,0.7894736842105263
67005,67005,99.00,253,56,309,0.8187702265372169,0.18122977346278318,Yes,0.8187702265372169
67006,67006,99.00,197,62,259,0.7606177606177607,0.23938223938223938,Yes,0.7606177606177607
67007,67007,99.00,6,2,8,0.75,0.25,Yes,0.75
67008,67008,99.00,224,62,286,0.7832167832167832,0.21678321678321677,Yes,0.7832167832167832
67009,67009,99.00,8,5,13,0.6153846153846154,0.38461538461538464,Yes,0.6153846153846154
67010,67010,99.00,175,79,254,0.6889763779527559,0.3110236220472441,Yes,0.6889763779527559
67011,67011,99.00,157,53,210,0.7476190476190476,0.2523809523809524,Yes,0.7476190476190476
67012,67012,99.00,10,3,13,0.7692307692307693,0.23076923076923078,Yes,0.7692307692307693
67013,67013,99.00,220,88,308,0.7142857142857143,0.2857142857142857,Yes,0.7142857142857143
67014,67014,99.00,206,68,274,0.7518248175182481,0.24817518248175183,Yes,0.7518248175182481
67015,67015,99.00,29,13,42,0.6904761904761905,0.30952380952380953,Yes,0.6904761904761905
67016,67016,99.00,31,11,42,0.7380952380952381,0.2619047619047619,Yes,0.7380952380952381
67017,67017,99.00,22,10,32,0.6875,0.3125,Yes,0.6875
67018,67018,99.00,187,57,244,0.7663934426229508,0.2336065573770492,Yes,0.7663934426229508
67019,67019,99.00,108,28,136,0.7941176470588235,0.20588235294117646,Yes,0.7941176470588235
67020,67020,99.00,134,39,173,0.7745664739884393,0.2254335260115607,Yes,0.7745664739884393
67021,67021,99.00,11,2,13,0.8461538461538461,0.15384615384615385,Yes,0.8461538461538461
67022,67022,99.00,13,4,17,0.7647058823529411,0.23529411764705882,Yes,0.7647058823529411
67023,67023,99.00,164,71,235,0.6978723404255319,0.3021276595744681,Yes,0.6978723404255319
67024,67024,80.00,95,32,127,0.7480314960629921,0.25196850393700787,Yes,0.7480314960629921
67025,67025,99.00,133,21,154,0.8636363636363636,0.13636363636363635,Yes,0.8636363636363636
67026,67026,99.00,8,2,10,0.8,0.2,Yes,0.8
67027,67027,99.00,185,51,236,0.7838983050847458,0.21610169491525424,Yes,0.7838983050847458
67028,67028,80.00,111,35,146,0.7602739726027398,0.23972602739726026,Yes,0.7602739726027398
67029,67029,80.00,64,45,109,0.5871559633027523,0.41284403669724773,Yes,0.5871559633027523
67030,67030,99.00,75,39,114,0.6578947368421053,0.34210526315789475,Yes,0.6578947368421053
67031,67031,99.00,232,103,335,0.6925373134328359,0.3074626865671642,Yes,0.6925373134328359
67032,67032,80.00,143,77,220,0.65,0.35,Yes,0.65
67033,67033,99.00,181,62,243,0.7448559670781894,0.2551440329218107,Yes,0.7448559670781894
67034,67034,80.00,114,53,167,0.6826347305389222,0.31736526946107785,Yes,0.6826347305389222
67035,67035,80.00,19,6,25,0.76,0.24,Yes,0.76
67036,67036,99.00,6,2,8,0.75,0.25,Yes,0.75
67037,67037,99.00,149,38,187,0.7967914438502673,0.20320855614973263,Yes,0.7967914438502673
67038,67038,99.00,169,82,251,0.6733067729083665,0.32669322709163345,Yes,0.6733067729083665
67039,67039,99.00,6,2,8,0.75,0.25,Yes,0.75
67040,67040,99.00,6,7,13,0.46153846153846156,0.5384615384615384,No,0.5384615384615384
67041,67041,99.00,244,93,337,0.7240356083086054,0.27596439169139464,Yes,0.7240356083086054
67042,67042,99.00,285,112,397,0.7178841309823678,0.28211586901763225,Yes,0.7178841309823678
67043,67043,99.00,460,239,699,0.6580829756795422,0.3419170243204578,Yes,0.6580829756795422
67044,67044,99.00,175,49,224,0.78125,0.21875,Yes,0.78125
67045,67045,99.00,5,5,10,0.5,0.5,Tie,0.5
67046,67046,99.00,17,12,29,0.5862068965517241,0.41379310344827586,Yes,0.5862068965517241
67047,67047,99.00,161,62,223,0.7219730941704036,0.27802690582959644,Yes,0.7219730941704036
67048,67048,99.00,8,3,11,0.7272727272727273,0.2727272727272727,Yes,0.7272727272727273
67049,67049,99.00,252,120,372,0.6774193548387096,0.3225806451612903,Yes,0.6774193548387096
67050,67050,99.00,198,67,265,0.7471698113207547,0.2528301886792453,Yes,0.7471698113207547
67051,67051,80.00,113,32,145,0.7793103448275862,0.2206896551724138,Yes,0.7793103448275862
67052,67052,99.00,18,4,22,0.8181818181818182,0.18181818181818182,Yes,0.8181818181818182
67053,67053,99.00,175,84,259,0.6756756756756757,0.32432432432432434,Yes,0.6756756756756757
67054,67054,99.00,174,74,248,0.7016129032258065,0.29838709677419356,Yes,0.7016129032258065
67055,67055,99.00,3,2,5,0.6,0.4,Yes,0.6
67056,67056,99.00,134,59,193,0.694300518134715,0.30569948186528495,Yes,0.694300518134715
67057,67057,99.00,145,51,196,0.7397959183673469,0.2602040816326531,Yes,0.7397959183673469
67058,67058,99.00,13,5,18,0.7222222222222222,0.2777777777777778,Yes,0.7222222222222222
67059,67059,99.00,183,84,267,0.6853932584269663,0.3146067415730337,Yes,0.6853932584269663
67060,67060,99.00,250,96,346,0.7225433526011561,0.2774566473988439,Yes,0.7225433526011561
67061,67061,99.00,257,106,363,0.7079889807162535,0.29201101928374656,Yes,0.7079889807162535
67062,67062,99.00,8,2,10,0.8,0.2,Yes,0.8
67063,67063,99.00,5,2,7,0.7142857142857143,0.2857142857142857,Yes,0.7142857142857143
67064,67064,99.00,300,109,409,0.7334963325183375,0.2665036674816626,Yes,0.7334963325183375
67065,67065,99.00,10,3,13,0.7692307692307693,0.23076923076923078,Yes,0.7692307692307693
67066,67066,99.00,251,94,345,0.7275362318840579,0.27246376811594203,Yes,0.7275362318840579
67067,67067,99.00,245,107,352,0.6960227272727273,0.3039772727272727,Yes,0.6960227272727273
67068,67068,99.00,234,115,349,0.670487106017192,0.32951289398280803,Yes,0.670487106017192
67069,67069,99.00,8,6,14,0.5714285714285714,0.42857142857142855,Yes,0.5714285714285714
67070,67070,99.00,13,1,14,0.9285714285714286,0.07142857142857142,Yes,0.9285714285714286
67071,67071,99.00,230,119,349,0.6590257879656161,0.34097421203438394,Yes,0.6590257879656161
67072,67072,99.00,223,104,327,0.6819571865443425,0.3180428134556575,Yes,0.6819571865443425
67073,67073,99.00,9,5,14,0.6428571428571429,0.35714285714285715,Yes,0.6428571428571429
67074,67074,99.00,160,65,225,0.7111111111111111,0.28888888888888886,Yes,0.7111111111111111
67075,67075,99.00,258,106,364,0.7087912087912088,0.29120879120879123,Yes,0.7087912087912088
67076,67076,99.00,15,13,28,0.5357142857142857,0.4642857142857143,Yes,0.5357142857142857
67077,67077,99.00,272,121,393,0.6921119592875318,0.30788804071246817,Yes,0.6921119592875318
67078,67078,99.00,6,4,10,0.6,0.4,Yes,0.6
67079,67079,99.00,9,7,16,0.5625,0.4375,Yes,0.5625
67080,67080,99.00,142,91,233,0.6094420600858369,0.3905579399141631,Yes,0.6094420600858369
67081,67081,99.00,243,124,367,0.662125340599455,0.33787465940054495,Yes,0.662125340599455
67082,67082,99.00,17,2,19,0.8947368421052632,0.10526315789473684,Yes,0.8947368421052632
67083,67083,99.00,18,10,28,0.6428571428571429,0.35714285714285715,Yes,0.6428571428571429
67084,67084,99.00,191,75,266,0.7180451127819549,0.2819548872180451,Yes,0.7180451127819549
67085,67085,99.00,263,88,351,0.7492877492877493,0.25071225071225073,Yes,0.7492877492877493
67086,67086,99.00,17,7,24,0.7083333333333334,0.2916666666666667,Yes,0.7083333333333334
67087,67087,99.00,146,55,201,0.7263681592039801,0.2736318407960199,Yes,0.7263681592039801
67088,67088,99.00,235,98,333,0.7057057057057057,0.29429429429429427,Yes,0.7057057057057057
67089,67089,99.00,10,9,19,0.5263157894736842,0.47368421052631576,Yes,0.5263157894736842
67090,67090,99.00,147,53,200,0.735,0.265,Yes,0.735
67091,67091,99.00,332,149,481,0.6902286902286903,0.3097713097713098,Yes,0.6902286902286903
67092,67092,99.00,6,5,11,0.5454545454545454,0.45454545454545453,Yes,0.5454545454545454
67093,67093,99.00,273,127,400,0.6825,0.3175,Yes,0.6825
67094,67094,99.00,15,7,22,0.6818181818181818,0.3181818181818182,Yes,0.6818181818181818
67095,67095,99.00,7,4,11,0.6363636363636364,0.36363636363636365,Yes,0.6363636363636364
67096,67096,99.00,236,80,316,0.7468354430379747,0.25316455696202533,Yes,0.7468354430379747
67097,67097,99.00,3,4,7,0.42857142857142855,0.5714285714285714,No,0.5714285714285714
67098,67098,99.00,237,129,366,0.6475409836065574,0.3524590163934426,Yes,0.6475409836065574
67099,67099,99.00,274,164,438,0.6255707762557078,0.3744292237442922,Yes,0.6255707762557078
67100,67100,80.00,1,0,1,1.0,0.0,Yes,1.0
67101,67101,80.00,77,45,122,0.6311475409836066,0.36885245901639346,Yes,0.6311475409836066
67102,67102,99.00,0,0,0,0,0,n/a,0
67103,67103,80.00,0,0,0,0,0,n/a,0
67104,67104,99.00,0,0,0,0,0,n/a,0
67105,67105,99.00,6,1,7,0.8571428571428571,0.14285714285714285,Yes,0.8571428571428571
67106,67106,99.00,178,71,249,0.714859437751004,0.285140562248996,Yes,0.714859437751004
67107,67107,99.00,5,1,6,0.8333333333333334,0.16666666666666666,Yes,0.8333333333333334
67108,67108,99.00,125,52,177,0.7062146892655368,0.2937853107344633,Yes,0.7062146892655368
67109,67109,99.00,162,42,204,0.7941176470588235,0.20588235294117646,Yes,0.7941176470588235
67110,67110,99.00,86,24,110,0.7818181818181819,0.21818181818181817,Yes,0.7818181818181819
67111,67111,80.00,2,0,2,1.0,0.0,Yes,1.0
67112,67112,99.00,15,13,28,0.5357142857142857,0.4642857142857143,Yes,0.5357142857142857
67113,67113,99.00,32,37,69,0.463768115942029,0.5362318840579711,No,0.5362318840579711
67114,67114,99.00,15,5,20,0.75,0.25,Yes,0.75
68001,68001,99.00,149,53,202,0.7376237623762376,0.2623762376237624,Yes,0.7376237623762376
68002,68002,99.00,2,0,2,1.0,0.0,Yes,1.0
68003,68003,99.00,179,61,240,0.7458333333333333,0.25416666666666665,Yes,0.7458333333333333
68004,68004,99.00,120,54,174,0.6896551724137931,0.3103448275862069,Yes,0.6896551724137931
68005,68005,99.00,145,48,193,0.7512953367875648,0.24870466321243523,Yes,0.7512953367875648
68006,68006,99.00,3,0,3,1.0,0.0,Yes,1.0
68007,68007,99.00,229,97,326,0.7024539877300614,0.29754601226993865,Yes,0.7024539877300614
68008,68008,99.00,173,109,282,0.6134751773049646,0.38652482269503546,Yes,0.6134751773049646
68009,68009,99.00,3,3,6,0.5,0.5,Tie,0.5
68010,68010,99.00,7,10,17,0.4117647058823529,0.5882352941176471,No,0.5882352941176471
68011,68011,99.00,102,73,175,0.5828571428571429,0.41714285714285715,Yes,0.5828571428571429
68012,68012,99.00,3,1,4,0.75,0.25,Yes,0.75
68013,68013,99.00,1,1,2,0.5,0.5,Tie,0.5
68014,68014,99.00,6,2,8,0.75,0.25,Yes,0.75
68015,68015,99.00,164,41,205,0.8,0.2,Yes,0.8
68016,68016,99.00,106,23,129,0.8217054263565892,0.17829457364341086,Yes,0.8217054263565892
68017,68017,99.00,76,21,97,0.7835051546391752,0.21649484536082475,Yes,0.7835051546391752
68018,68018,99.00,2,0,2,1.0,0.0,Yes,1.0
68019,68019,99.00,3,2,5,0.6,0.4,Yes,0.6
68020,68020,99.00,3,2,5,0.6,0.4,Yes,0.6
68021,68021,99.00,55,6,61,0.9016393442622951,0.09836065573770492,Yes,0.9016393442622951
68022,68022,99.00,104,13,117,0.8888888888888888,0.1111111111111111,Yes,0.8888888888888888
68023,68023,99.00,130,22,152,0.8552631578947368,0.14473684210526316,Yes,0.8552631578947368
68024,68024,99.00,5,2,7,0.7142857142857143,0.2857142857142857,Yes,0.7142857142857143
68025,68025,99.00,127,33,160,0.79375,0.20625,Yes,0.79375
68026,68026,99.00,115,39,154,0.7467532467532467,0.2532467532467532,Yes,0.7467532467532467
68027,68027,99.00,5,0,5,1.0,0.0,Yes,1.0
68028,68028,36.36,96,17,113,0.8495575221238938,0.1504424778761062,Yes,0.8495575221238938
68029,68029,99.00,2,0,2,1.0,0.0,Yes,1.0
68030,68030,36.36,12,4,16,0.75,0.25,Yes,0.75
68031,68031,36.36,138,22,160,0.8625,0.1375,Yes,0.8625
68032,68032,36.36,12,1,13,0.9230769230769231,0.07692307692307693,Yes,0.9230769230769231
68033,68033,36.36,141,34,175,0.8057142857142857,0.19428571428571428,Yes,0.8057142857142857
68034,68034,99.00,184,46,230,0.8,0.2,Yes,0.8
68035,68035,99.00,175,29,204,0.8578431372549019,0.14215686274509803,Yes,0.8578431372549019
68036,68036,99.00,94,15,109,0.8623853211009175,0.13761467889908258,Yes,0.8623853211009175
68037,68037,99.00,131,25,156,0.8397435897435898,0.16025641025641027,Yes,0.8397435897435898
68038,68038,99.00,88,17,105,0.8380952380952381,0.1619047619047619,Yes,0.8380952380952381
68039,68039,99.00,157,19,176,0.8920454545454546,0.10795454545454546,Yes,0.8920454545454546
68040,68040,99.00,10,0,10,1.0,0.0,Yes,1.0
68041,68041,99.00,152,25,177,0.8587570621468926,0.14124293785310735,Yes,0.8587570621468926
68042,68042,99.00,228,35,263,0.8669201520912547,0.13307984790874525,Yes,0.8669201520912547
68043,68043,99.00,7,2,9,0.7777777777777778,0.2222222222222222,Yes,0.7777777777777778
68044,68044,99.00,2,3,5,0.4,0.6,No,0.6
68045,68045,99.00,2,0,2,1.0,0.0,Yes,1.0
68046,68046,99.00,119,29,148,0.8040540540540541,0.19594594594594594,Yes,0.8040540540540541
68047,68047,99.00,78,27,105,0.7428571428571429,0.2571428571428571,Yes,0.7428571428571429
68048,68048,99.00,0,0,0,0,0,n/a,0
68049,68049,99.00,49,5,54,0.9074074074074074,0.09259259259259259,Yes,0.9074074074074074
68050,68050,99.00,157,32,189,0.8306878306878307,0.1693121693121693,Yes,0.8306878306878307
68051,68051,99.00,3,0,3,1.0,0.0,Yes,1.0
68052,68052,66.67,198,38,236,0.8389830508474576,0.16101694915254236,Yes,0.8389830508474576
68053,68053,66.67,3,1,4,0.75,0.25,Yes,0.75
68054,68054,99.00,117,25,142,0.823943661971831,0.176056338028169,Yes,0.823943661971831
68055,68055,99.00,135,26,161,0.8385093167701864,0.16149068322981366,Yes,0.8385093167701864
68056,68056,99.00,92,20,112,0.8214285714285714,0.17857142857142858,Yes,0.8214285714285714
68057,68057,99.00,3,2,5,0.6,0.4,Yes,0.6
68058,68058,66.67,114,28,142,0.8028169014084507,0.19718309859154928,Yes,0.8028169014084507
68059,68059,99.00,0,1,1,0.0,1.0,No,1.0
68060,68060,66.67,66,24,90,0.7333333333333333,0.26666666666666666,Yes,0.7333333333333333
68061,68061,99.00,130,18,148,0.8783783783783784,0.12162162162162163,Yes,0.8783783783783784
68062,68062,66.67,3,0,3,1.0,0.0,Yes,1.0
68063,68063,99.00,161,36,197,0.817258883248731,0.18274111675126903,Yes,0.817258883248731
68064,68064,99.00,4,0,4,1.0,0.0,Yes,1.0
68065,68065,99.00,86,17,103,0.8349514563106796,0.1650485436893204,Yes,0.8349514563106796
68066,68066,99.00,57,17,74,0.7702702702702703,0.22972972972972974,Yes,0.7702702702702703
68067,68067,99.00,0,0,0,0,0,n/a,0
68068,68068,99.00,88,16,104,0.8461538461538461,0.15384615384615385,Yes,0.8461538461538461
68069,68069,99.00,3,2,5,0.6,0.4,Yes,0.6
68070,68070,99.00,0,0,0,0,0,n/a,0
68071,68071,99.00,126,31,157,0.802547770700637,0.19745222929936307,Yes,0.802547770700637
68072,68072,99.00,173,25,198,0.8737373737373737,0.12626262626262627,Yes,0.8737373737373737
68073,68073,99.00,3,3,6,0.5,0.5,Tie,0.5
68074,68074,99.00,9,0,9,1.0,0.0,Yes,1.0
68075,68075,99.00,140,23,163,0.8588957055214724,0.1411042944785276,Yes,0.8588957055214724
68076,68076,99.00,3,1,4,0.75,0.25,Yes,0.75
68077,68077,99.00,3,0,3,1.0,0.0,Yes,1.0
68078,68078,99.00,12,1,13,0.9230769230769231,0.07692307692307693,Yes,0.9230769230769231
68079,68079,99.00,108,28,136,0.7941176470588235,0.20588235294117646,Yes,0.7941176470588235
68080,68080,99.00,203,46,249,0.8152610441767069,0.18473895582329317,Yes,0.8152610441767069
68081,68081,99.00,35,11,46,0.7608695652173914,0.2391304347826087,Yes,0.7608695652173914
68082,68082,99.00,192,35,227,0.8458149779735683,0.15418502202643172,Yes,0.8458149779735683
68083,68083,99.00,122,20,142,0.8591549295774648,0.14084507042253522,Yes,0.8591549295774648
68084,68084,99.00,119,20,139,0.8561151079136691,0.14388489208633093,Yes,0.8561151079136691
68085,68085,99.00,71,15,86,0.8255813953488372,0.1744186046511628,Yes,0.8255813953488372
68086,68086,99.00,60,12,72,0.8333333333333334,0.16666666666666666,Yes,0.8333333333333334
68087,68087,99.00,1,3,4,0.25,0.75,No,0.75
68088,68088,99.00,1,0,1,1.0,0.0,Yes,1.0
68089,68089,99.00,105,23,128,0.8203125,0.1796875,Yes,0.8203125
68090,68090,99.00,89,18,107,0.8317757009345794,0.16822429906542055,Yes,0.8317757009345794
68091,68091,99.00,0,0,0,0,0,n/a,0
68092,68092,99.00,104,21,125,0.832,0.168,Yes,0.832
68093,68093,99.00,166,35,201,0.8258706467661692,0.17412935323383086,Yes,0.8258706467661692
68094,68094,99.00,16,0,16,1.0,0.0,Yes,1.0
68095,68095,36.36,0,0,0,0,0,n/a,0
68096,68096,99.00,170,35,205,0.8292682926829268,0.17073170731707318,Yes,0.8292682926829268
68097,68097,99.00,110,24,134,0.8208955223880597,0.1791044776119403,Yes,0.8208955223880597
68098,68098,36.36,48,18,66,0.7272727272727273,0.2727272727272727,Yes,0.7272727272727273
68099,68099,99.00,0,0,0,0,0,n/a,0
68100,68100,99.00,0,0,0,0,0,n/a,0
68101,68101,36.36,0,0,0,0,0,n/a,0
68102,68102,99.00,0,0,0,0,0,n/a,0
68103,68103,36.36,0,0,0,0,0,n/a,0
68104,68104,36.36,0,0,0,0,0,n/a,0
68105,68105,99.00,0,0,0,0,0,n/a,0
68106,68106,99.00,0,0,0,0,0,n/a,0
68107,68107,99.00,0,0,0,0,0,n/a,0
68108,68108,99.00,1,0,1,1.0,0.0,Yes,1.0
68109,68109,99.00,1,0,1,1.0,0.0,Yes,1.0
68110,68110,99.00,5,1,6,0.8333333333333334,0.16666666666666666,Yes,0.8333333333333334
68111,68111,99.00,3,3,6,0.5,0.5,Tie,0.5
68112,68112,99.00,169,40,209,0.8086124401913876,0.19138755980861244,Yes,0.8086124401913876
68113,68113,99.00,0,0,0,0,0,n/a,0
68114,68114,36.36,3,3,6,0.5,0.5,Tie,0.5
68115,68115,99.00,2,0,2,1.0,0.0,Yes,1.0
69001,69001,99.00,7,2,9,0.7777777777777778,0.2222222222222222,Yes,0.7777777777777778
69002,69002,99.00,2,6,8,0.25,0.75,No,0.75
69003,69003,99.00,235,70,305,0.7704918032786885,0.22950819672131148,Yes,0.7704918032786885
69004,69004,99.00,16,12,28,0.5714285714285714,0.42857142857142855,Yes,0.5714285714285714
69005,69005,99.00,8,4,12,0.6666666666666666,0.3333333333333333,Yes,0.6666666666666666
69006,69006,99.00,163,64,227,0.7180616740088106,0.28193832599118945,Yes,0.7180616740088106
69007,69007,99.00,208,96,304,0.6842105263157895,0.3157894736842105,Yes,0.6842105263157895
69008,69008,99.00,8,7,15,0.5333333333333333,0.4666666666666667,Yes,0.5333333333333333
69009,69009,99.00,228,86,314,0.7261146496815286,0.27388535031847133,Yes,0.7261146496815286
69010,69010,99.00,233,83,316,0.7373417721518988,0.2626582278481013,Yes,0.7373417721518988
69011,69011,99.00,15,16,31,0.4838709677419355,0.5161290322580645,No,0.5161290322580645
69012,69012,99.00,65,21,86,0.7558139534883721,0.2441860465116279,Yes,0.7558139534883721
69013,69013,99.00,165,72,237,0.6962025316455697,0.3037974683544304,Yes,0.6962025316455697
69014,69014,99.00,8,5,13,0.6153846153846154,0.38461538461538464,Yes,0.6153846153846154
69015,69015,99.00,144,60,204,0.7058823529411765,0.29411764705882354,Yes,0.7058823529411765
69016,69016,99.00,99,48,147,0.673469387755102,0.32653061224489793,Yes,0.673469387755102
69017,69017,99.00,125,40,165,0.7575757575757576,0.24242424242424243,Yes,0.7575757575757576
69018,69018,99.00,168,70,238,0.7058823529411765,0.29411764705882354,Yes,0.7058823529411765
69019,69019,99.00,9,6,15,0.6,0.4,Yes,0.6
69020,69020,99.00,252,91,343,0.7346938775510204,0.2653061224489796,Yes,0.7346938775510204
69021,69021,99.00,274,74,348,0.7873563218390804,0.21264367816091953,Yes,0.7873563218390804
69022,69022,99.00,274,125,399,0.6867167919799498,0.3132832080200501,Yes,0.6867167919799498
69023,69023,99.00,237,81,318,0.7452830188679245,0.25471698113207547,Yes,0.7452830188679245
69024,69024,99.00,144,62,206,0.6990291262135923,0.30097087378640774,Yes,0.6990291262135923
69025,69025,99.00,19,5,24,0.7916666666666666,0.20833333333333334,Yes,0.7916666666666666
69026,69026,99.00,45,10,55,0.8181818181818182,0.18181818181818182,Yes,0.8181818181818182
69027,69027,99.00,19,8,27,0.7037037037037037,0.2962962962962963,Yes,0.7037037037037037
69028,69028,99.00,8,2,10,0.8,0.2,Yes,0.8
69029,69029,99.00,341,98,439,0.7767653758542141,0.22323462414578588,Yes,0.7767653758542141
69030,69030,99.00,23,24,47,0.48936170212765956,0.5106382978723404,No,0.5106382978723404
69031,69031,99.00,20,9,29,0.6896551724137931,0.3103448275862069,Yes,0.6896551724137931
69032,69032,99.00,327,95,422,0.7748815165876777,0.22511848341232227,Yes,0.7748815165876777
69033,69033,99.00,179,93,272,0.6580882352941176,0.34191176470588236,Yes,0.6580882352941176
69034,69034,99.00,187,60,247,0.757085020242915,0.242914979757085,Yes,0.757085020242915
69035,69035,99.00,15,4,19,0.7894736842105263,0.21052631578947367,Yes,0.7894736842105263
69036,69036,99.00,1,1,2,0.5,0.5,Tie,0.5
69037,69037,99.00,179,58,237,0.7552742616033755,0.24472573839662448,Yes,0.7552742616033755
69038,69038,99.00,16,7,23,0.6956521739130435,0.30434782608695654,Yes,0.6956521739130435
69039,69039,99.00,264,107,371,0.7115902964959568,0.2884097035040431,Yes,0.7115902964959568
69040,69040,99.00,298,90,388,0.7680412371134021,0.23195876288659795,Yes,0.7680412371134021
69041,69041,99.00,22,13,35,0.6285714285714286,0.37142857142857144,Yes,0.6285714285714286
69042,69042,99.00,245,69,314,0.7802547770700637,0.2197452229299363,Yes,0.7802547770700637
69043,69043,99.00,158,61,219,0.7214611872146118,0.2785388127853881,Yes,0.7214611872146118
69044,69044,99.00,213,112,325,0.6553846153846153,0.3446153846153846,Yes,0.6553846153846153
69045,69045,99.00,289,142,431,0.6705336426914154,0.3294663573085847,Yes,0.6705336426914154
69046,69046,99.00,277,99,376,0.7367021276595744,0.2632978723404255,Yes,0.7367021276595744
69047,69047,99.00,21,8,29,0.7241379310344828,0.27586206896551724,Yes,0.7241379310344828
69048,69048,99.00,27,19,46,0.5869565217391305,0.41304347826086957,Yes,0.5869565217391305
69049,69049,47.06,163,72,235,0.6936170212765957,0.30638297872340425,Yes,0.6936170212765957
69050,69050,47.06,238,112,350,0.68,0.32,Yes,0.68
69051,69051,47.06,16,13,29,0.5517241379310345,0.4482758620689655,Yes,0.5517241379310345
69052,69052,47.06,149,49,198,0.7525252525252525,0.2474747474747475,Yes,0.7525252525252525
69053,69053,47.06,9,3,12,0.75,0.25,Yes,0.75
69054,69054,47.06,187,47,234,0.7991452991452992,0.20085470085470086,Yes,0.7991452991452992
69055,69055,99.00,201,60,261,0.7701149425287356,0.22988505747126436,Yes,0.7701149425287356
69056,69056,47.06,6,2,8,0.75,0.25,Yes,0.75
69057,69057,47.06,97,27,124,0.782258064516129,0.21774193548387097,Yes,0.782258064516129
69058,69058,47.06,15,9,24,0.625,0.375,Yes,0.625
69059,69059,47.06,12,6,18,0.6666666666666666,0.3333333333333333,Yes,0.6666666666666666
69060,69060,47.06,218,82,300,0.7266666666666667,0.2733333333333333,Yes,0.7266666666666667
69061,69061,47.06,258,88,346,0.7456647398843931,0.2543352601156069,Yes,0.7456647398843931
69062,69062,99.00,257,114,371,0.692722371967655,0.30727762803234504,Yes,0.692722371967655
69063,69063,99.00,269,82,351,0.7663817663817664,0.2336182336182336,Yes,0.7663817663817664
69064,69064,99.00,176,75,251,0.701195219123506,0.29880478087649404,Yes,0.701195219123506
69065,69065,99.00,38,17,55,0.6909090909090909,0.3090909090909091,Yes,0.6909090909090909
69066,69066,99.00,2,2,4,0.5,0.5,Tie,0.5
69067,69067,99.00,192,45,237,0.810126582278481,0.189873417721519,Yes,0.810126582278481
69068,69068,99.00,12,2,14,0.8571428571428571,0.14285714285714285,Yes,0.8571428571428571
69069,69069,99.00,236,78,314,0.7515923566878981,0.2484076433121019,Yes,0.7515923566878981
69070,69070,99.00,122,27,149,0.8187919463087249,0.18120805369127516,Yes,0.8187919463087249
69071,69071,99.00,9,2,11,0.8181818181818182,0.18181818181818182,Yes,0.8181818181818182
69072,69072,75.00,152,66,218,0.6972477064220184,0.30275229357798167,Yes,0.6972477064220184
69073,69073,75.00,148,41,189,0.783068783068783,0.21693121693121692,Yes,0.783068783068783
69074,69074,99.00,12,0,12,1.0,0.0,Yes,1.0
69075,69075,99.00,167,37,204,0.8186274509803921,0.18137254901960784,Yes,0.8186274509803921
69076,69076,99.00,7,1,8,0.875,0.125,Yes,0.875
69077,69077,75.00,25,10,35,0.7142857142857143,0.2857142857142857,Yes,0.7142857142857143
69078,69078,75.00,90,42,132,0.6818181818181818,0.3181818181818182,Yes,0.6818181818181818
69079,69079,75.00,22,4,26,0.8461538461538461,0.15384615384615385,Yes,0.8461538461538461
69080,69080,99.00,181,27,208,0.8701923076923077,0.12980769230769232,Yes,0.8701923076923077
69081,69081,99.00,271,78,349,0.7765042979942693,0.22349570200573066,Yes,0.7765042979942693
69082,69082,99.00,126,38,164,0.7682926829268293,0.23170731707317074,Yes,0.7682926829268293
69083,69083,99.00,4,1,5,0.8,0.2,Yes,0.8
69084,69084,75.00,137,52,189,0.7248677248677249,0.2751322751322751,Yes,0.7248677248677249
69085,69085,75.00,19,11,30,0.6333333333333333,0.36666666666666664,Yes,0.6333333333333333
69086,69086,75.00,41,18,59,0.6949152542372882,0.3050847457627119,Yes,0.6949152542372882
69087,69087,75.00,24,8,32,0.75,0.25,Yes,0.75
69088,69088,75.00,6,8,14,0.42857142857142855,0.5714285714285714,No,0.5714285714285714
69089,69089,50.00,101,18,119,0.8487394957983193,0.15126050420168066,Yes,0.8487394957983193
69090,69090,75.00,205,69,274,0.7481751824817519,0.2518248175182482,Yes,0.7481751824817519
69091,69091,75.00,17,11,28,0.6071428571428571,0.39285714285714285,Yes,0.6071428571428571
69092,69092,75.00,226,80,306,0.738562091503268,0.26143790849673204,Yes,0.738562091503268
69093,69093,99.00,234,105,339,0.6902654867256637,0.30973451327433627,Yes,0.6902654867256637
69094,69094,99.00,190,65,255,0.7450980392156863,0.2549019607843137,Yes,0.7450980392156863
69095,69095,99.00,163,63,226,0.7212389380530974,0.27876106194690264,Yes,0.7212389380530974
69096,69096,99.00,153,38,191,0.8010471204188482,0.19895287958115182,Yes,0.8010471204188482
69097,69097,99.00,10,1,11,0.9090909090909091,0.09090909090909091,Yes,0.9090909090909091
69098,69098,99.00,9,3,12,0.75,0.25,Yes,0.75
69099,69099,99.00,290,67,357,0.8123249299719888,0.1876750700280112,Yes,0.8123249299719888
69100,69100,99.00,209,58,267,0.7827715355805244,0.21722846441947566,Yes,0.7827715355805244
69101,69101,99.00,69,23,92,0.75,0.25,Yes,0.75
69102,69102,99.00,150,25,175,0.8571428571428571,0.14285714285714285,Yes,0.8571428571428571
69103,69103,47.06,0,0,0,0,0,n/a,0
69104,69104,99.00,0,0,0,0,0,n/a,0
69105,69105,99.00,0,0,0,0,0,n/a,0
69106,69106,47.06,0,0,0,0,0,n/a,0
69107,69107,99.00,0,0,0,0,0,n/a,0
69108,69108,99.00,3,0,3,1.0,0.0,Yes,1.0
69109,69109,99.00,6,5,11,0.5454545454545454,0.45454545454545453,Yes,0.5454545454545454
69110,69110,75.00,17,6,23,0.7391304347826086,0.2608695652173913,Yes,0.7391304347826086
69111,69111,99.00,17,7,24,0.7083333333333334,0.2916666666666667,Yes,0.7083333333333334
69112,69112,47.06,25,7,32,0.78125,0.21875,Yes,0.78125
69113,69113,99.00,8,4,12,0.6666666666666666,0.3333333333333333,Yes,0.6666666666666666
69114,69114,47.06,12,1,13,0.9230769230769231,0.07692307692307693,Yes,0.9230769230769231
69115,69115,99.00,237,73,310,0.7645161290322581,0.23548387096774193,Yes,0.7645161290322581
70001,70001,99.00,8,1,9,0.8888888888888888,0.1111111111111111,Yes,0.8888888888888888
70002,70002,99.00,180,44,224,0.8035714285714286,0.19642857142857142,Yes,0.8035714285714286
70003,70003,99.00,3,1,4,0.75,0.25,Yes,0.75
70004,70004,99.00,175,40,215,0.813953488372093,0.18604651162790697,Yes,0.813953488372093
70005,70005,99.00,7,1,8,0.875,0.125,Yes,0.875
70006,70006,99.00,10,2,12,0.8333333333333334,0.16666666666666666,Yes,0.8333333333333334
70007,70007,99.00,269,69,338,0.7958579881656804,0.20414201183431951,Yes,0.7958579881656804
70008,70008,99.00,230,45,275,0.8363636363636363,0.16363636363636364,Yes,0.8363636363636363
70009,70009,99.00,314,55,369,0.8509485094850948,0.14905149051490515,Yes,0.8509485094850948
70010,70010,99.00,7,0,7,1.0,0.0,Yes,1.0
70011,70011,99.00,152,40,192,0.7916666666666666,0.20833333333333334,Yes,0.7916666666666666
70012,70012,99.00,137,35,172,0.7965116279069767,0.20348837209302326,Yes,0.7965116279069767
70013,70013,99.00,2,0,2,1.0,0.0,Yes,1.0
70014,70014,99.00,131,28,159,0.8238993710691824,0.1761006289308176,Yes,0.8238993710691824
70015,70015,99.00,4,1,5,0.8,0.2,Yes,0.8
70016,70016,99.00,15,1,16,0.9375,0.0625,Yes,0.9375
70017,70017,99.00,192,41,233,0.8240343347639485,0.1759656652360515,Yes,0.8240343347639485
70018,70018,99.00,6,3,9,0.6666666666666666,0.3333333333333333,Yes,0.6666666666666666
70019,70019,99.00,282,112,394,0.7157360406091371,0.28426395939086296,Yes,0.7157360406091371
70020,70020,99.00,225,55,280,0.8035714285714286,0.19642857142857142,Yes,0.8035714285714286
70021,70021,99.00,170,43,213,0.7981220657276995,0.20187793427230047,Yes,0.7981220657276995
70022,70022,99.00,283,48,331,0.8549848942598187,0.14501510574018128,Yes,0.8549848942598187
70023,70023,99.00,269,58,327,0.8226299694189603,0.17737003058103976,Yes,0.8226299694189603
70024,70024,99.00,190,44,234,0.811965811965812,0.18803418803418803,Yes,0.811965811965812
70025,70025,99.00,90,15,105,0.8571428571428571,0.14285714285714285,Yes,0.8571428571428571
70026,70026,99.00,178,40,218,0.8165137614678899,0.1834862385321101,Yes,0.8165137614678899
70027,70027,99.00,135,18,153,0.8823529411764706,0.11764705882352941,Yes,0.8823529411764706
70028,70028,99.00,209,51,260,0.8038461538461539,0.19615384615384615,Yes,0.8038461538461539
70029,70029,99.00,11,3,14,0.7857142857142857,0.21428571428571427,Yes,0.7857142857142857
70030,70030,99.00,0,0,0,0,0,n/a,0
70031,70031,99.00,142,25,167,0.8502994011976048,0.1497005988023952,Yes,0.8502994011976048
70032,70032,99.00,7,0,7,1.0,0.0,Yes,1.0
70033,70033,99.00,109,21,130,0.8384615384615385,0.16153846153846155,Yes,0.8384615384615385
70034,70034,50.00,133,32,165,0.806060606060606,0.19393939393939394,Yes,0.806060606060606
70035,70035,50.00,172,38,210,0.819047619047619,0.18095238095238095,Yes,0.819047619047619
70036,70036,99.00,163,13,176,0.9261363636363636,0.07386363636363637,Yes,0.9261363636363636
70037,70037,99.00,132,12,144,0.9166666666666666,0.08333333333333333,Yes,0.9166666666666666
70038,70038,99.00,117,29,146,0.8013698630136986,0.19863013698630136,Yes,0.8013698630136986
70039,70039,99.00,4,0,4,1.0,0.0,Yes,1.0
70040,70040,50.00,214,28,242,0.8842975206611571,0.11570247933884298,Yes,0.8842975206611571
70041,70041,50.00,224,32,256,0.875,0.125,Yes,0.875
70042,70042,50.00,206,24,230,0.8956521739130435,0.10434782608695652,Yes,0.8956521739130435
70043,70043,50.00,166,27,193,0.8601036269430051,0.13989637305699482,Yes,0.8601036269430051
70044,70044,50.00,181,40,221,0.8190045248868778,0.18099547511312217,Yes,0.8190045248868778
70045,70045,50.00,140,21,161,0.8695652173913043,0.13043478260869565,Yes,0.8695652173913043
70046,70046,99.00,374,56,430,0.8697674418604651,0.13023255813953488,Yes,0.8697674418604651
70047,70047,99.00,4,2,6,0.6666666666666666,0.3333333333333333,Yes,0.6666666666666666
70048,70048,99.00,179,31,210,0.8523809523809524,0.14761904761904762,Yes,0.8523809523809524
70049,70049,99.00,4,1,5,0.8,0.2,Yes,0.8
70050,70050,99.00,276,50,326,0.8466257668711656,0.15337423312883436,Yes,0.8466257668711656
70051,70051,99.00,8,4,12,0.6666666666666666,0.3333333333333333,Yes,0.6666666666666666
70052,70052,99.00,192,31,223,0.8609865470852018,0.13901345291479822,Yes,0.8609865470852018
70053,70053,99.00,344,72,416,0.8269230769230769,0.17307692307692307,Yes,0.8269230769230769
70054,70054,99.00,23,1,24,0.9583333333333334,0.041666666666666664,Yes,0.9583333333333334
70055,70055,99.00,245,51,296,0.8277027027027027,0.17229729729729729,Yes,0.8277027027027027
70056,70056,99.00,12,0,12,1.0,0.0,Yes,1.0
70057,70057,99.00,9,3,12,0.75,0.25,Yes,0.75
70058,70058,99.00,178,34,212,0.839622641509434,0.16037735849056603,Yes,0.839622641509434
70059,70059,99.00,8,0,8,1.0,0.0,Yes,1.0
70060,70060,99.00,113,24,137,0.8248175182481752,0.17518248175182483,Yes,0.8248175182481752
70061,70061,99.00,1,1,2,0.5,0.5,Tie,0.5
70062,70062,99.00,199,44,243,0.8189300411522634,0.18106995884773663,Yes,0.8189300411522634
70063,70063,99.00,122,25,147,0.8299319727891157,0.17006802721088435,Yes,0.8299319727891157
70064,70064,99.00,0,2,2,0.0,1.0,No,1.0
70065,70065,99.00,154,60,214,0.719626168224299,0.2803738317757009,Yes,0.719626168224299
70066,70066,99.00,126,30,156,0.8076923076923077,0.19230769230769232,Yes,0.8076923076923077
70067,70067,50.00,4,3,7,0.5714285714285714,0.42857142857142855,Yes,0.5714285714285714
70068,70068,99.00,130,38,168,0.7738095238095238,0.2261904761904762,Yes,0.7738095238095238
70069,70069,85.71,106,13,119,0.8907563025210085,0.1092436974789916,Yes,0.8907563025210085
70070,70070,99.00,2,0,2,1.0,0.0,Yes,1.0
70071,70071,99.00,217,31,248,0.875,0.125,Yes,0.875
70072,70072,99.00,0,0,0,0,0,n/a,0
70073,70073,99.00,145,21,166,0.8734939759036144,0.12650602409638553,Yes,0.8734939759036144
70074,70074,99.00,315,53,368,0.8559782608695652,0.14402173913043478,Yes,0.8559782608695652
70075,70075,99.00,8,1,9,0.8888888888888888,0.1111111111111111,Yes,0.8888888888888888
70076,70076,99.00,234,46,280,0.8357142857142857,0.16428571428571428,Yes,0.8357142857142857
70077,70077,99.00,151,17,168,0.8988095238095238,0.10119047619047619,Yes,0.8988095238095238
70078,70078,99.00,0,1,1,0.0,1.0,No,1.0
70079,70079,99.00,1,2,3,0.3333333333333333,0.6666666666666666,No,0.6666666666666666
70080,70080,85.71,81,7,88,0.9204545454545454,0.07954545454545454,Yes,0.9204545454545454
70081,70081,99.00,119,12,131,0.9083969465648855,0.0916030534351145,Yes,0.9083969465648855
70082,70082,85.71,3,0,3,1.0,0.0,Yes,1.0
70083,70083,85.71,161,48,209,0.7703349282296651,0.22966507177033493,Yes,0.7703349282296651
70084,70084,99.00,1,1,2,0.5,0.5,Tie,0.5
70085,70085,99.00,276,54,330,0.8363636363636363,0.16363636363636364,Yes,0.8363636363636363
70086,70086,85.71,1,0,1,1.0,0.0,Yes,1.0
70087,70087,85.71,1,1,2,0.5,0.5,Tie,0.5
70088,70088,85.71,157,37,194,0.8092783505154639,0.19072164948453607,Yes,0.8092783505154639
70089,70089,99.00,10,3,13,0.7692307692307693,0.23076923076923078,Yes,0.7692307692307693
70090,70090,85.71,10,4,14,0.7142857142857143,0.2857142857142857,Yes,0.7142857142857143
70091,70091,99.00,253,65,318,0.7955974842767296,0.20440251572327045,Yes,0.7955974842767296
70092,70092,99.00,264,54,318,0.8301886792452831,0.16981132075471697,Yes,0.8301886792452831
70093,70093,99.00,8,1,9,0.8888888888888888,0.1111111111111111,Yes,0.8888888888888888
70094,70094,85.71,0,0,0,0,0,n/a,0
70095,70095,85.71,0,0,0,0,0,n/a,0
70096,70096,85.71,0,0,0,0,0,n/a,0
70097,70097,85.71,0,0,0,0,0,n/a,0
70098,70098,99.00,139,25,164,0.8475609756097561,0.1524390243902439,Yes,0.8475609756097561
70099,70099,85.71,163,28,191,0.8534031413612565,0.14659685863874344,Yes,0.8534031413612565
70100,70100,99.00,230,34,264,0.8712121212121212,0.12878787878787878,Yes,0.8712121212121212
70101,70101,99.00,8,5,13,0.6153846153846154,0.38461538461538464,Yes,0.6153846153846154
70102,70102,99.00,10,2,12,0.8333333333333334,0.16666666666666666,Yes,0.8333333333333334
70103,70103,99.00,3,3,6,0.5,0.5,Tie,0.5
70104,70104,99.00,3,0,3,1.0,0.0,Yes,1.0
70105,70105,99.00,10,3,13,0.7692307692307693,0.23076923076923078,Yes,0.7692307692307693
70106,70106,99.00,8,0,8,1.0,0.0,Yes,1.0
70107,70107,99.00,7,2,9,0.7777777777777778,0.2222222222222222,Yes,0.7777777777777778
70108,70108,99.00,193,38,231,0.8354978354978355,0.1645021645021645,Yes,0.8354978354978355
70109,70109,85.71,1,1,2,0.5,0.5,Tie,0.5
70110,70110,99.00,4,2,6,0.6666666666666666,0.3333333333333333,Yes,0.6666666666666666
70111,70111,99.00,3,1,4,0.75,0.25,Yes,0.75
71001,71001,99.00,116,27,143,0.8111888111888111,0.1888111888111888,Yes,0.8111888111888111
71002,71002,99.00,88,14,102,0.8627450980392157,0.13725490196078433,Yes,0.8627450980392157
71003,71003,99.00,3,2,5,0.6,0.4,Yes,0.6
71004,71004,99.00,131,31,162,0.808641975308642,0.19135802469135801,Yes,0.808641975308642
71005,71005,99.00,163,25,188,0.8670212765957447,0.13297872340425532,Yes,0.8670212765957447
71006,71006,99.00,117,20,137,0.8540145985401459,0.145985401459854,Yes,0.8540145985401459
71007,71007,99.00,2,2,4,0.5,0.5,Tie,0.5
71008,71008,99.00,237,39,276,0.8586956521739131,0.14130434782608695,Yes,0.8586956521739131
71009,71009,99.00,15,1,16,0.9375,0.0625,Yes,0.9375
71010,71010,99.00,174,48,222,0.7837837837837838,0.21621621621621623,Yes,0.7837837837837838
71011,71011,99.00,98,7,105,0.9333333333333333,0.06666666666666667,Yes,0.9333333333333333
71012,71012,99.00,217,26,243,0.8930041152263375,0.10699588477366255,Yes,0.8930041152263375
71013,71013,99.00,185,15,200,0.925,0.075,Yes,0.925
71014,71014,99.00,14,0,14,1.0,0.0,Yes,1.0
71015,71015,99.00,4,1,5,0.8,0.2,Yes,0.8
71016,71016,99.00,90,18,108,0.8333333333333334,0.16666666666666666,Yes,0.8333333333333334
71017,71017,99.00,8,0,8,1.0,0.0,Yes,1.0
71018,71018,99.00,216,26,242,0.8925619834710744,0.10743801652892562,Yes,0.8925619834710744
71019,71019,99.00,231,47,278,0.8309352517985612,0.16906474820143885,Yes,0.8309352517985612
71020,71020,99.00,220,34,254,0.8661417322834646,0.13385826771653545,Yes,0.8661417322834646
71021,71021,99.00,12,1,13,0.9230769230769231,0.07692307692307693,Yes,0.9230769230769231
71022,71022,99.00,217,33,250,0.868,0.132,Yes,0.868
71023,71023,99.00,128,17,145,0.8827586206896552,0.11724137931034483,Yes,0.8827586206896552
71024,71024,99.00,255,49,304,0.8388157894736842,0.1611842105263158,Yes,0.8388157894736842
71025,71025,99.00,91,18,109,0.8348623853211009,0.1651376146788991,Yes,0.8348623853211009
71026,71026,99.00,227,34,261,0.8697318007662835,0.13026819923371646,Yes,0.8697318007662835
71027,71027,99.00,13,0,13,1.0,0.0,Yes,1.0
71028,71028,99.00,95,8,103,0.9223300970873787,0.07766990291262135,Yes,0.9223300970873787
71029,71029,99.00,9,1,10,0.9,0.1,Yes,0.9
71030,71030,99.00,221,31,252,0.876984126984127,0.12301587301587301,Yes,0.876984126984127
71031,71031,99.00,270,49,319,0.8463949843260188,0.1536050156739812,Yes,0.8463949843260188
71032,71032,99.00,258,58,316,0.8164556962025317,0.18354430379746836,Yes,0.8164556962025317
71033,71033,99.00,147,22,169,0.8698224852071006,0.1301775147928994,Yes,0.8698224852071006
71034,71034,99.00,6,1,7,0.8571428571428571,0.14285714285714285,Yes,0.8571428571428571
71035,71035,99.00,1,2,3,0.3333333333333333,0.6666666666666666,No,0.6666666666666666
71036,71036,99.00,216,36,252,0.8571428571428571,0.14285714285714285,Yes,0.8571428571428571
71037,71037,99.00,3,0,3,1.0,0.0,Yes,1.0
71038,71038,99.00,78,12,90,0.8666666666666667,0.13333333333333333,Yes,0.8666666666666667
71039,71039,99.00,2,1,3,0.6666666666666666,0.3333333333333333,Yes,0.6666666666666666
71040,71040,99.00,4,1,5,0.8,0.2,Yes,0.8
71041,71041,99.00,339,60,399,0.849624060150376,0.15037593984962405,Yes,0.849624060150376
71042,71042,99.00,243,40,283,0.8586572438162544,0.1413427561837456,Yes,0.8586572438162544
71043,71043,99.00,132,31,163,0.8098159509202454,0.1901840490797546,Yes,0.8098159509202454
71044,71044,99.00,4,5,9,0.4444444444444444,0.5555555555555556,No,0.5555555555555556
71045,71045,99.00,180,35,215,0.8372093023255814,0.16279069767441862,Yes,0.8372093023255814
71046,71046,99.00,95,25,120,0.7916666666666666,0.20833333333333334,Yes,0.7916666666666666
71047,71047,99.00,279,54,333,0.8378378378378378,0.16216216216216217,Yes,0.8378378378378378
71048,71048,99.00,129,22,151,0.8543046357615894,0.1456953642384106,Yes,0.8543046357615894
71049,71049,99.00,66,8,74,0.8918918918918919,0.10810810810810811,Yes,0.8918918918918919
71050,71050,99.00,1,0,1,1.0,0.0,Yes,1.0
71051,71051,99.00,0,0,0,0,0,n/a,0
71052,71052,99.00,92,21,113,0.8141592920353983,0.18584070796460178,Yes,0.8141592920353983
71053,71053,99.00,4,1,5,0.8,0.2,Yes,0.8
71054,71054,99.00,1,0,1,1.0,0.0,Yes,1.0
71055,71055,99.00,102,17,119,0.8571428571428571,0.14285714285714285,Yes,0.8571428571428571
71056,71056,99.00,1,0,1,1.0,0.0,Yes,1.0
71057,71057,99.00,176,35,211,0.8341232227488151,0.16587677725118483,Yes,0.8341232227488151
71058,71058,99.00,45,10,55,0.8181818181818182,0.18181818181818182,Yes,0.8181818181818182
71059,71059,99.00,117,19,136,0.8602941176470589,0.13970588235294118,Yes,0.8602941176470589
71060,71060,99.00,122,17,139,0.8776978417266187,0.1223021582733813,Yes,0.8776978417266187
71061,71061,99.00,3,1,4,0.75,0.25,Yes,0.75
71062,71062,99.00,89,25,114,0.7807017543859649,0.21929824561403508,Yes,0.7807017543859649
71063,71063,99.00,175,16,191,0.9162303664921466,0.08376963350785341,Yes,0.9162303664921466
71064,71064,99.00,5,0,5,1.0,0.0,Yes,1.0
71065,71065,99.00,134,26,160,0.8375,0.1625,Yes,0.8375
71066,71066,99.00,161,23,184,0.875,0.125,Yes,0.875
71067,71067,99.00,118,30,148,0.7972972972972973,0.20270270270270271,Yes,0.7972972972972973
71068,71068,99.00,110,20,130,0.8461538461538461,0.15384615384615385,Yes,0.8461538461538461
71069,71069,99.00,1,2,3,0.3333333333333333,0.6666666666666666,No,0.6666666666666666
71070,71070,99.00,180,37,217,0.8294930875576036,0.17050691244239632,Yes,0.8294930875576036
71071,71071,99.00,8,5,13,0.6153846153846154,0.38461538461538464,Yes,0.6153846153846154
71072,71072,99.00,214,51,265,0.8075471698113208,0.19245283018867926,Yes,0.8075471698113208
71073,71073,99.00,13,0,13,1.0,0.0,Yes,1.0
71074,71074,99.00,259,43,302,0.8576158940397351,0.1423841059602649,Yes,0.8576158940397351
71075,71075,99.00,267,51,318,0.839622641509434,0.16037735849056603,Yes,0.839622641509434
71076,71076,99.00,4,0,4,1.0,0.0,Yes,1.0
71077,71077,99.00,416,127,543,0.7661141804788214,0.23388581952117865,Yes,0.7661141804788214
71078,71078,99.00,9,3,12,0.75,0.25,Yes,0.75
71079,71079,99.00,364,112,476,0.7647058823529411,0.23529411764705882,Yes,0.7647058823529411
71080,71080,99.00,2,2,4,0.5,0.5,Tie,0.5
71081,71081,99.00,307,93,400,0.7675,0.2325,Yes,0.7675
71082,71082,99.00,8,2,10,0.8,0.2,Yes,0.8
71083,71083,99.00,292,86,378,0.7724867724867724,0.2275132275132275,Yes,0.7724867724867724
71084,71084,99.00,6,2,8,0.75,0.25,Yes,0.75
71085,71085,99.00,329,94,423,0.7777777777777778,0.2222222222222222,Yes,0.7777777777777778
71086,71086,99.00,0,0,0,0,0,n/a,0
71087,71087,99.00,128,21,149,0.8590604026845637,0.14093959731543623,Yes,0.8590604026845637
71088,71088,99.00,0,0,0,0,0,n/a,0
71089,71089,99.00,128,27,155,0.8258064516129032,0.17419354838709677,Yes,0.8258064516129032
71090,71090,99.00,79,10,89,0.8876404494382022,0.11235955056179775,Yes,0.8876404494382022
71091,71091,99.00,0,0,0,0,0,n/a,0
71092,71092,99.00,3,0,3,1.0,0.0,Yes,1.0
71093,71093,99.00,5,0,5,1.0,0.0,Yes,1.0
71094,71094,99.00,0,0,0,0,0,n/a,0
71095,71095,99.00,0,0,0,0,0,n/a,0
71096,71096,99.00,0,0,0,0,0,n/a,0
71097,71097,99.00,9,2,11,0.8181818181818182,0.18181818181818182,Yes,0.8181818181818182
71098,71098,99.00,4,3,7,0.5714285714285714,0.42857142857142855,Yes,0.5714285714285714
71099,71099,99.00,5,0,5,1.0,0.0,Yes,1.0
71100,71100,99.00,2,0,2,1.0,0.0,Yes,1.0
71101,71101,99.00,0,0,0,0,0,n/a,0
71102,71102,99.00,9,0,9,1.0,0.0,Yes,1.0
71103,71103,99.00,180,26,206,0.8737864077669902,0.1262135922330097,Yes,0.8737864077669902
71104,71104,99.00,1,1,2,0.5,0.5,Tie,0.5
71105,71105,99.00,184,26,210,0.8761904761904762,0.12380952380952381,Yes,0.8761904761904762
71106,71106,99.00,4,1,5,0.8,0.2,Yes,0.8
71107,71107,99.00,224,52,276,0.8115942028985508,0.18840579710144928,Yes,0.8115942028985508
71108,71108,99.00,0,0,0,0,0,n/a,0
71109,71109,99.00,157,24,181,0.8674033149171271,0.13259668508287292,Yes,0.8674033149171271
72001,72001,99.00,89,18,107,0.8317757009345794,0.16822429906542055,Yes,0.8317757009345794
72002,72002,99.00,129,23,152,0.8486842105263158,0.1513157894736842,Yes,0.8486842105263158
72003,72003,99.00,54,13,67,0.8059701492537313,0.19402985074626866,Yes,0.8059701492537313
72004,72004,99.00,94,23,117,0.8034188034188035,0.19658119658119658,Yes,0.8034188034188035
72005,72005,99.00,4,0,4,1.0,0.0,Yes,1.0
72006,72006,99.00,0,0,0,0,0,n/a,0
72007,72007,99.00,52,16,68,0.7647058823529411,0.23529411764705882,Yes,0.7647058823529411
72008,72008,99.00,4,1,5,0.8,0.2,Yes,0.8
72009,72009,99.00,53,9,62,0.8548387096774194,0.14516129032258066,Yes,0.8548387096774194
72010,72010,99.00,115,18,133,0.8646616541353384,0.13533834586466165,Yes,0.8646616541353384
72011,72011,99.00,2,2,4,0.5,0.5,Tie,0.5
72012,72012,99.00,42,10,52,0.8076923076923077,0.19230769230769232,Yes,0.8076923076923077
72013,72013,99.00,95,11,106,0.8962264150943396,0.10377358490566038,Yes,0.8962264150943396
72014,72014,99.00,6,1,7,0.8571428571428571,0.14285714285714285,Yes,0.8571428571428571
72015,72015,99.00,131,18,149,0.8791946308724832,0.12080536912751678,Yes,0.8791946308724832
72016,72016,99.00,0,0,0,0,0,n/a,0
72017,72017,99.00,189,47,236,0.8008474576271186,0.19915254237288135,Yes,0.8008474576271186
72018,72018,99.00,6,5,11,0.5454545454545454,0.45454545454545453,Yes,0.5454545454545454
72019,72019,99.00,230,71,301,0.7641196013289037,0.23588039867109634,Yes,0.7641196013289037
72020,72020,99.00,124,28,152,0.8157894736842105,0.18421052631578946,Yes,0.8157894736842105
72021,72021,99.00,105,12,117,0.8974358974358975,0.10256410256410256,Yes,0.8974358974358975
72022,72022,99.00,63,14,77,0.8181818181818182,0.18181818181818182,Yes,0.8181818181818182
72023,72023,99.00,101,42,143,0.7062937062937062,0.2937062937062937,Yes,0.7062937062937062
72024,72024,33.33,69,11,80,0.8625,0.1375,Yes,0.8625
72025,72025,33.33,1,0,1,1.0,0.0,Yes,1.0
72026,72026,99.00,115,16,131,0.8778625954198473,0.12213740458015267,Yes,0.8778625954198473
72027,72027,33.33,6,2,8,0.75,0.25,Yes,0.75
72028,72028,99.00,6,1,7,0.8571428571428571,0.14285714285714285,Yes,0.8571428571428571
72029,72029,99.00,126,54,180,0.7,0.3,Yes,0.7
72030,72030,33.33,97,11,108,0.8981481481481481,0.10185185185185185,Yes,0.8981481481481481
72031,72031,99.00,75,10,85,0.8823529411764706,0.11764705882352941,Yes,0.8823529411764706
72032,72032,0.00,11,2,13,0.8461538461538461,0.15384615384615385,Yes,0.8461538461538461
72033,72033,99.00,4,0,4,1.0,0.0,Yes,1.0
72034,72034,33.33,4,0,4,1.0,0.0,Yes,1.0
72035,72035,33.33,72,15,87,0.8275862068965517,0.1724137931034483,Yes,0.8275862068965517
72036,72036,0.00,11,2,13,0.8461538461538461,0.15384615384615385,Yes,0.8461538461538461
72037,72037,99.00,7,1,8,0.875,0.125,Yes,0.875
72038,72038,99.00,146,51,197,0.7411167512690355,0.25888324873096447,Yes,0.7411167512690355
72039,72039,80.00,5,3,8,0.625,0.375,Yes,0.625
72040,72040,80.00,166,32,198,0.8383838383838383,0.16161616161616163,Yes,0.8383838383838383
72041,72041,99.00,253,54,307,0.8241042345276873,0.1758957654723127,Yes,0.8241042345276873
72042,72042,99.00,121,33,154,0.7857142857142857,0.21428571428571427,Yes,0.7857142857142857
72043,72043,80.00,89,16,105,0.8476190476190476,0.1523809523809524,Yes,0.8476190476190476
72044,72044,80.00,103,17,120,0.8583333333333333,0.14166666666666666,Yes,0.8583333333333333
72045,72045,80.00,5,1,6,0.8333333333333334,0.16666666666666666,Yes,0.8333333333333334
72046,72046,80.00,157,24,181,0.8674033149171271,0.13259668508287292,Yes,0.8674033149171271
72047,72047,99.00,221,43,264,0.8371212121212122,0.16287878787878787,Yes,0.8371212121212122
72048,72048,99.00,70,6,76,0.9210526315789473,0.07894736842105263,Yes,0.9210526315789473
72049,72049,99.00,138,16,154,0.8961038961038961,0.1038961038961039,Yes,0.8961038961038961
72050,72050,99.00,79,14,93,0.8494623655913979,0.15053763440860216,Yes,0.8494623655913979
72051,72051,99.00,3,0,3,1.0,0.0,Yes,1.0
72052,72052,99.00,62,15,77,0.8051948051948052,0.19480519480519481,Yes,0.8051948051948052
72053,72053,99.00,115,22,137,0.8394160583941606,0.16058394160583941,Yes,0.8394160583941606
72054,72054,99.00,3,0,3,1.0,0.0,Yes,1.0
72055,72055,99.00,89,16,105,0.8476190476190476,0.1523809523809524,Yes,0.8476190476190476
72056,72056,99.00,125,13,138,0.9057971014492754,0.09420289855072464,Yes,0.9057971014492754
72057,72057,99.00,9,2,11,0.8181818181818182,0.18181818181818182,Yes,0.8181818181818182
72058,72058,99.00,372,65,437,0.851258581235698,0.14874141876430205,Yes,0.851258581235698
72059,72059,99.00,4,0,4,1.0,0.0,Yes,1.0
72060,72060,99.00,215,32,247,0.8704453441295547,0.12955465587044535,Yes,0.8704453441295547
72061,72061,99.00,3,1,4,0.75,0.25,Yes,0.75
72062,72062,99.00,6,0,6,1.0,0.0,Yes,1.0
72063,72063,99.00,134,23,157,0.8535031847133758,0.1464968152866242,Yes,0.8535031847133758
72064,72064,99.00,269,45,314,0.856687898089172,0.14331210191082802,Yes,0.856687898089172
72065,72065,99.00,100,14,114,0.8771929824561403,0.12280701754385964,Yes,0.8771929824561403
72066,72066,99.00,393,60,453,0.8675496688741722,0.13245033112582782,Yes,0.8675496688741722
72067,72067,99.00,7,2,9,0.7777777777777778,0.2222222222222222,Yes,0.7777777777777778
72068,72068,99.00,281,67,348,0.8074712643678161,0.1925287356321839,Yes,0.8074712643678161
72069,72069,99.00,191,42,233,0.8197424892703863,0.18025751072961374,Yes,0.8197424892703863
72070,72070,99.00,147,34,181,0.8121546961325967,0.1878453038674033,Yes,0.8121546961325967
72071,72071,99.00,83,16,99,0.8383838383838383,0.16161616161616163,Yes,0.8383838383838383
72072,72072,99.00,0,0,0,0,0,n/a,0
72073,72073,99.00,6,1,7,0.8571428571428571,0.14285714285714285,Yes,0.8571428571428571
72074,72074,0.00,1,0,1,1.0,0.0,Yes,1.0
72075,72075,0.00,7,0,7,1.0,0.0,Yes,1.0
72076,72076,80.00,4,0,4,1.0,0.0,Yes,1.0
72077,72077,99.00,70,9,79,0.8860759493670886,0.11392405063291139,Yes,0.8860759493670886
72078,72078,99.00,1,1,2,0.5,0.5,Tie,0.5
72079,72079,99.00,2,0,2,1.0,0.0,Yes,1.0
72080,72080,99.00,0,0,0,0,0,n/a,0
72081,72081,99.00,0,0,0,0,0,n/a,0
72082,72082,99.00,0,0,0,0,0,n/a,0
72083,72083,99.00,0,0,0,0,0,n/a,0
72084,72084,99.00,0,0,0,0,0,n/a,0
72085,72085,99.00,0,0,0,0,0,n/a,0
72086,72086,99.00,56,8,64,0.875,0.125,Yes,0.875
72087,72087,33.33,60,8,68,0.8823529411764706,0.11764705882352941,Yes,0.8823529411764706
72088,72088,33.33,3,0,3,1.0,0.0,Yes,1.0
72089,72089,99.00,3,0,3,1.0,0.0,Yes,1.0
72090,72090,99.00,7,0,7,1.0,0.0,Yes,1.0
72091,72091,99.00,6,2,8,0.75,0.25,Yes,0.75
72092,72092,99.00,2,0,2,1.0,0.0,Yes,1.0
72093,72093,99.00,158,11,169,0.9349112426035503,0.0650887573964497,Yes,0.9349112426035503
72094,72094,99.00,125,13,138,0.9057971014492754,0.09420289855072464,Yes,0.9057971014492754
72095,72095,99.00,2,0,2,1.0,0.0,Yes,1.0
72096,72096,99.00,0,0,0,0,0,n/a,0
72097,72097,99.00,24,5,29,0.8275862068965517,0.1724137931034483,Yes,0.8275862068965517
73001,73001,53.85,119,52,171,0.695906432748538,0.30409356725146197,Yes,0.695906432748538
73002,73002,53.85,15,10,25,0.6,0.4,Yes,0.6
73003,73003,53.85,137,50,187,0.732620320855615,0.26737967914438504,Yes,0.732620320855615
73004,73004,99.00,140,74,214,0.6542056074766355,0.34579439252336447,Yes,0.6542056074766355
73005,73005,99.00,25,8,33,0.7575757575757576,0.24242424242424243,Yes,0.7575757575757576
73006,73006,99.00,84,39,123,0.6829268292682927,0.3170731707317073,Yes,0.6829268292682927
73007,73007,99.00,141,80,221,0.6380090497737556,0.36199095022624433,Yes,0.6380090497737556
73008,73008,99.00,2,0,2,1.0,0.0,Yes,1.0
73009,73009,53.85,114,62,176,0.6477272727272727,0.3522727272727273,Yes,0.6477272727272727
73010,73010,53.85,149,54,203,0.7339901477832512,0.2660098522167488,Yes,0.7339901477832512
73011,73011,53.85,157,59,216,0.7268518518518519,0.27314814814814814,Yes,0.7268518518518519
73012,73012,99.00,138,47,185,0.745945945945946,0.25405405405405407,Yes,0.745945945945946
73013,73013,50.00,85,44,129,0.6589147286821705,0.34108527131782945,Yes,0.6589147286821705
73014,73014,91.67,129,53,182,0.7087912087912088,0.29120879120879123,Yes,0.7087912087912088
73015,73015,91.67,11,0,11,1.0,0.0,Yes,1.0
73016,73016,99.00,119,58,177,0.672316384180791,0.327683615819209,Yes,0.672316384180791
73017,73017,99.00,4,0,4,1.0,0.0,Yes,1.0
73018,73018,99.00,11,10,21,0.5238095238095238,0.47619047619047616,Yes,0.5238095238095238
73019,73019,99.00,75,27,102,0.7352941176470589,0.2647058823529412,Yes,0.7352941176470589
73020,73020,99.00,0,0,0,0,0,n/a,0
73021,73021,99.00,133,77,210,0.6333333333333333,0.36666666666666664,Yes,0.6333333333333333
73022,73022,99.00,20,5,25,0.8,0.2,Yes,0.8
73023,73023,99.00,184,78,262,0.7022900763358778,0.29770992366412213,Yes,0.7022900763358778
73024,73024,0.00,8,1,9,0.8888888888888888,0.1111111111111111,Yes,0.8888888888888888
73025,73025,99.00,15,6,21,0.7142857142857143,0.2857142857142857,Yes,0.7142857142857143
73026,73026,99.00,144,108,252,0.5714285714285714,0.42857142857142855,Yes,0.5714285714285714
73027,73027,91.67,12,4,16,0.75,0.25,Yes,0.75
73028,73028,91.67,133,70,203,0.6551724137931034,0.3448275862068966,Yes,0.6551724137931034
73029,73029,91.67,173,80,253,0.6837944664031621,0.31620553359683795,Yes,0.6837944664031621
73030,73030,99.00,176,69,245,0.7183673469387755,0.2816326530612245,Yes,0.7183673469387755
73031,73031,99.00,16,10,26,0.6153846153846154,0.38461538461538464,Yes,0.6153846153846154
73032,73032,91.67,5,5,10,0.5,0.5,Tie,0.5
73033,73033,91.67,112,49,161,0.6956521739130435,0.30434782608695654,Yes,0.6956521739130435
73034,73034,91.67,7,3,10,0.7,0.3,Yes,0.7
73035,73035,91.67,186,96,282,0.6595744680851063,0.3404255319148936,Yes,0.6595744680851063
73036,73036,91.67,176,91,267,0.6591760299625468,0.3408239700374532,Yes,0.6591760299625468
73037,73037,91.67,5,5,10,0.5,0.5,Tie,0.5
73038,73038,91.67,92,37,129,0.7131782945736435,0.2868217054263566,Yes,0.7131782945736435
73039,73039,91.67,87,53,140,0.6214285714285714,0.37857142857142856,Yes,0.6214285714285714
73040,73040,91.67,4,1,5,0.8,0.2,Yes,0.8
73041,73041,91.67,201,93,294,0.6836734693877551,0.3163265306122449,Yes,0.6836734693877551
73042,73042,99.00,6,1,7,0.8571428571428571,0.14285714285714285,Yes,0.8571428571428571
73043,73043,99.00,104,42,146,0.7123287671232876,0.2876712328767123,Yes,0.7123287671232876
73044,73044,99.00,13,4,17,0.7647058823529411,0.23529411764705882,Yes,0.7647058823529411
73045,73045,99.00,47,27,74,0.6351351351351351,0.36486486486486486,Yes,0.6351351351351351
73046,73046,99.00,27,20,47,0.574468085106383,0.425531914893617,Yes,0.574468085106383
73047,73047,91.67,96,44,140,0.6857142857142857,0.3142857142857143,Yes,0.6857142857142857
73048,73048,91.67,10,0,10,1.0,0.0,Yes,1.0
73049,73049,50.00,64,27,91,0.7032967032967034,0.2967032967032967,Yes,0.7032967032967034
73050,73050,99.00,122,59,181,0.6740331491712708,0.3259668508287293,Yes,0.6740331491712708
73051,73051,99.00,68,44,112,0.6071428571428571,0.39285714285714285,Yes,0.6071428571428571
73052,73052,99.00,5,9,14,0.35714285714285715,0.6428571428571429,No,0.6428571428571429
73053,73053,99.00,129,62,191,0.675392670157068,0.32460732984293195,Yes,0.675392670157068
73054,73054,99.00,146,82,228,0.6403508771929824,0.35964912280701755,Yes,0.6403508771929824
73055,73055,99.00,21,5,26,0.8076923076923077,0.19230769230769232,Yes,0.8076923076923077
73056,73056,99.00,67,63,130,0.5153846153846153,0.4846153846153846,Yes,0.5153846153846153
73057,73057,99.00,133,82,215,0.6186046511627907,0.3813953488372093,Yes,0.6186046511627907
73058,73058,99.00,17,0,17,1.0,0.0,Yes,1.0
73059,73059,99.00,18,19,37,0.4864864864864865,0.5135135135135135,No,0.5135135135135135
73060,73060,99.00,15,13,28,0.5357142857142857,0.4642857142857143,Yes,0.5357142857142857
73061,73061,99.00,112,61,173,0.6473988439306358,0.35260115606936415,Yes,0.6473988439306358
73062,73062,99.00,111,69,180,0.6166666666666667,0.38333333333333336,Yes,0.6166666666666667
73063,73063,99.00,88,48,136,0.6470588235294118,0.35294117647058826,Yes,0.6470588235294118
73064,73064,99.00,26,21,47,0.5531914893617021,0.44680851063829785,Yes,0.5531914893617021
73065,73065,46.67,191,97,288,0.6631944444444444,0.3368055555555556,Yes,0.6631944444444444
73066,73066,99.00,18,18,36,0.5,0.5,Tie,0.5
73067,73067,99.00,134,61,195,0.6871794871794872,0.3128205128205128,Yes,0.6871794871794872
73068,73068,46.67,126,75,201,0.6268656716417911,0.373134328358209,Yes,0.6268656716417911
73069,73069,46.67,127,56,183,0.6939890710382514,0.30601092896174864,Yes,0.6939890710382514
73070,73070,46.67,27,14,41,0.6585365853658537,0.34146341463414637,Yes,0.6585365853658537
73071,73071,99.00,100,89,189,0.5291005291005291,0.4708994708994709,Yes,0.5291005291005291
73072,73072,99.00,2,4,6,0.3333333333333333,0.6666666666666666,No,0.6666666666666666
73073,73073,99.00,8,10,18,0.4444444444444444,0.5555555555555556,No,0.5555555555555556
73074,73074,99.00,199,115,314,0.6337579617834395,0.3662420382165605,Yes,0.6337579617834395
73075,73075,90.00,123,64,187,0.6577540106951871,0.3422459893048128,Yes,0.6577540106951871
73076,73076,0.00,10,11,21,0.47619047619047616,0.5238095238095238,No,0.5238095238095238
73077,73077,99.00,119,103,222,0.536036036036036,0.46396396396396394,Yes,0.536036036036036
73078,73078,0.00,16,10,26,0.6153846153846154,0.38461538461538464,Yes,0.6153846153846154
73079,73079,0.00,18,11,29,0.6206896551724138,0.3793103448275862,Yes,0.6206896551724138
73080,73080,0.00,8,11,19,0.42105263157894735,0.5789473684210527,No,0.5789473684210527
73081,73081,0.00,11,3,14,0.7857142857142857,0.21428571428571427,Yes,0.7857142857142857
73082,73082,0.00,14,6,20,0.7,0.3,Yes,0.7
73083,73083,0.00,16,9,25,0.64,0.36,Yes,0.64
73084,73084,0.00,12,3,15,0.8,0.2,Yes,0.8
73085,73085,0.00,12,7,19,0.631578947368421,0.3684210526315789,Yes,0.631578947368421
73086,73086,0.00,14,5,19,0.7368421052631579,0.2631578947368421,Yes,0.7368421052631579
73087,73087,0.00,6,7,13,0.46153846153846156,0.5384615384615384,No,0.5384615384615384
73088,73088,99.00,132,91,223,0.5919282511210763,0.4080717488789238,Yes,0.5919282511210763
73089,73089,50.00,5,3,8,0.625,0.375,Yes,0.625
73090,73090,99.00,315,153,468,0.6730769230769231,0.3269230769230769,Yes,0.6730769230769231
73091,73091,99.00,5,1,6,0.8333333333333334,0.16666666666666666,Yes,0.8333333333333334
73092,73092,0.00,3,0,3,1.0,0.0,Yes,1.0
73093,73093,99.00,270,83,353,0.7648725212464589,0.23512747875354106,Yes,0.7648725212464589
73094,73094,99.00,3,3,6,0.5,0.5,Tie,0.5
73095,73095,0.00,19,6,25,0.76,0.24,Yes,0.76
73096,73096,99.00,10,9,19,0.5263157894736842,0.47368421052631576,Yes,0.5263157894736842
73097,73097,0.00,12,5,17,0.7058823529411765,0.29411764705882354,Yes,0.7058823529411765
73098,73098,0.00,6,12,18,0.3333333333333333,0.6666666666666666,No,0.6666666666666666
73099,73099,90.00,15,6,21,0.7142857142857143,0.2857142857142857,Yes,0.7142857142857143
73100,73100,91.67,123,60,183,0.6721311475409836,0.32786885245901637,Yes,0.6721311475409836
73101,73101,91.67,3,3,6,0.5,0.5,Tie,0.5
73102,73102,99.00,132,79,211,0.6255924170616114,0.3744075829383886,Yes,0.6255924170616114
73103,73103,99.00,10,2,12,0.8333333333333334,0.16666666666666666,Yes,0.8333333333333334
73104,73104,99.00,176,98,274,0.6423357664233577,0.35766423357664234,Yes,0.6423357664233577
73105,73105,99.00,13,12,25,0.52,0.48,Yes,0.52
73106,73106,99.00,111,27,138,0.8043478260869565,0.1956521739130435,Yes,0.8043478260869565
73107,73107,99.00,86,33,119,0.7226890756302521,0.2773109243697479,Yes,0.7226890756302521
74001,74001,99.00,29,9,38,0.7631578947368421,0.23684210526315788,Yes,0.7631578947368421
74002,74002,66.67,85,12,97,0.8762886597938144,0.12371134020618557,Yes,0.8762886597938144
74003,74003,66.67,2,1,3,0.6666666666666666,0.3333333333333333,Yes,0.6666666666666666
74004,74004,66.67,0,0,0,0,0,n/a,0
74005,74005,66.67,85,11,96,0.8854166666666666,0.11458333333333333,Yes,0.8854166666666666
74006,74006,99.00,1,0,1,1.0,0.0,Yes,1.0
74007,74007,66.67,94,33,127,0.7401574803149606,0.25984251968503935,Yes,0.7401574803149606
74008,74008,99.00,132,30,162,0.8148148148148148,0.18518518518518517,Yes,0.8148148148148148
74009,74009,99.00,2,1,3,0.6666666666666666,0.3333333333333333,Yes,0.6666666666666666
74010,74010,99.00,168,33,201,0.835820895522388,0.16417910447761194,Yes,0.835820895522388
74011,74011,99.00,74,19,93,0.7956989247311828,0.20430107526881722,Yes,0.7956989247311828
74012,74012,99.00,1,0,1,1.0,0.0,Yes,1.0
74013,74013,99.00,106,23,129,0.8217054263565892,0.17829457364341086,Yes,0.8217054263565892
74014,74014,99.00,70,15,85,0.8235294117647058,0.17647058823529413,Yes,0.8235294117647058
74015,74015,99.00,7,0,7,1.0,0.0,Yes,1.0
74016,74016,99.00,8,0,8,1.0,0.0,Yes,1.0
74017,74017,99.00,69,14,83,0.8313253012048193,0.1686746987951807,Yes,0.8313253012048193
74018,74018,99.00,0,0,0,0,0,n/a,0
74019,74019,99.00,279,68,347,0.8040345821325648,0.19596541786743515,Yes,0.8040345821325648
74020,74020,99.00,6,1,7,0.8571428571428571,0.14285714285714285,Yes,0.8571428571428571
74021,74021,99.00,157,21,178,0.8820224719101124,0.11797752808988764,Yes,0.8820224719101124
74022,74022,99.00,236,55,291,0.8109965635738832,0.18900343642611683,Yes,0.8109965635738832
74023,74023,99.00,145,21,166,0.8734939759036144,0.12650602409638553,Yes,0.8734939759036144
74024,74024,99.00,2,3,5,0.4,0.6,No,0.6
74025,74025,99.00,69,17,86,0.8023255813953488,0.19767441860465115,Yes,0.8023255813953488
74026,74026,99.00,2,0,2,1.0,0.0,Yes,1.0
74027,74027,99.00,100,22,122,0.819672131147541,0.18032786885245902,Yes,0.819672131147541
74028,74028,99.00,0,0,0,0,0,n/a,0
74029,74029,99.00,89,14,103,0.8640776699029126,0.13592233009708737,Yes,0.8640776699029126
74030,74030,99.00,2,1,3,0.6666666666666666,0.3333333333333333,Yes,0.6666666666666666
74031,74031,99.00,165,32,197,0.8375634517766497,0.16243654822335024,Yes,0.8375634517766497
74032,74032,99.00,261,42,303,0.8613861386138614,0.13861386138613863,Yes,0.8613861386138614
74033,74033,99.00,154,48,202,0.7623762376237624,0.2376237623762376,Yes,0.7623762376237624
74034,74034,99.00,153,29,182,0.8406593406593407,0.15934065934065933,Yes,0.8406593406593407
74035,74035,99.00,118,31,149,0.7919463087248322,0.2080536912751678,Yes,0.7919463087248322
74036,74036,99.00,61,18,79,0.7721518987341772,0.22784810126582278,Yes,0.7721518987341772
74037,74037,99.00,5,3,8,0.625,0.375,Yes,0.625
74038,74038,99.00,6,1,7,0.8571428571428571,0.14285714285714285,Yes,0.8571428571428571
74039,74039,99.00,264,75,339,0.7787610619469026,0.22123893805309736,Yes,0.7787610619469026
74040,74040,99.00,173,62,235,0.7361702127659574,0.26382978723404255,Yes,0.7361702127659574
74041,74041,99.00,167,53,220,0.759090909090909,0.2409090909090909,Yes,0.759090909090909
74042,74042,99.00,21,2,23,0.9130434782608695,0.08695652173913043,Yes,0.9130434782608695
74043,74043,99.00,347,123,470,0.7382978723404255,0.26170212765957446,Yes,0.7382978723404255
74044,74044,99.00,20,7,27,0.7407407407407407,0.25925925925925924,Yes,0.7407407407407407
74045,74045,99.00,179,75,254,0.7047244094488189,0.2952755905511811,Yes,0.7047244094488189
74046,74046,99.00,262,82,344,0.7616279069767442,0.23837209302325582,Yes,0.7616279069767442
74047,74047,99.00,178,60,238,0.7478991596638656,0.25210084033613445,Yes,0.7478991596638656
74048,74048,99.00,18,7,25,0.72,0.28,Yes,0.72
74049,74049,99.00,273,109,382,0.7146596858638743,0.28534031413612565,Yes,0.7146596858638743
74050,74050,99.00,8,5,13,0.6153846153846154,0.38461538461538464,Yes,0.6153846153846154
74051,74051,99.00,245,139,384,0.6380208333333334,0.3619791666666667,Yes,0.6380208333333334
74052,74052,99.00,7,7,14,0.5,0.5,Tie,0.5
74053,74053,99.00,100,26,126,0.7936507936507936,0.20634920634920634,Yes,0.7936507936507936
74054,74054,99.00,201,98,299,0.6722408026755853,0.3277591973244147,Yes,0.6722408026755853
74055,74055,99.00,37,23,60,0.6166666666666667,0.38333333333333336,Yes,0.6166666666666667
74056,74056,33.33,115,43,158,0.7278481012658228,0.2721518987341772,Yes,0.7278481012658228
74057,74057,99.00,157,58,215,0.7302325581395349,0.26976744186046514,Yes,0.7302325581395349
74058,74058,99.00,36,17,53,0.6792452830188679,0.32075471698113206,Yes,0.6792452830188679
74059,74059,99.00,158,73,231,0.683982683982684,0.31601731601731603,Yes,0.683982683982684
74060,74060,33.33,90,57,147,0.6122448979591837,0.3877551020408163,Yes,0.6122448979591837
74061,74061,99.00,215,62,277,0.776173285198556,0.22382671480144403,Yes,0.776173285198556
74062,74062,80.00,175,69,244,0.7172131147540983,0.2827868852459016,Yes,0.7172131147540983
74063,74063,80.00,9,6,15,0.6,0.4,Yes,0.6
74064,74064,80.00,166,77,243,0.6831275720164609,0.3168724279835391,Yes,0.6831275720164609
74065,74065,80.00,10,1,11,0.9090909090909091,0.09090909090909091,Yes,0.9090909090909091
74066,74066,80.00,164,76,240,0.6833333333333333,0.31666666666666665,Yes,0.6833333333333333
74067,74067,99.00,224,77,301,0.7441860465116279,0.2558139534883721,Yes,0.7441860465116279
74068,74068,99.00,24,7,31,0.7741935483870968,0.22580645161290322,Yes,0.7741935483870968
74069,74069,99.00,68,13,81,0.8395061728395061,0.16049382716049382,Yes,0.8395061728395061
74070,74070,99.00,153,53,206,0.7427184466019418,0.25728155339805825,Yes,0.7427184466019418
74071,74071,99.00,9,4,13,0.6923076923076923,0.3076923076923077,Yes,0.6923076923076923
74072,74072,99.00,168,53,221,0.7601809954751131,0.2398190045248869,Yes,0.7601809954751131
74073,74073,99.00,121,60,181,0.6685082872928176,0.3314917127071823,Yes,0.6685082872928176
74074,74074,99.00,8,4,12,0.6666666666666666,0.3333333333333333,Yes,0.6666666666666666
74075,74075,99.00,24,10,34,0.7058823529411765,0.29411764705882354,Yes,0.7058823529411765
74076,74076,99.00,250,97,347,0.7204610951008645,0.27953890489913547,Yes,0.7204610951008645
74077,74077,99.00,13,4,17,0.7647058823529411,0.23529411764705882,Yes,0.7647058823529411
74078,74078,99.00,169,38,207,0.8164251207729468,0.18357487922705315,Yes,0.8164251207729468
74079,74079,99.00,185,69,254,0.7283464566929134,0.27165354330708663,Yes,0.7283464566929134
74080,74080,99.00,6,1,7,0.8571428571428571,0.14285714285714285,Yes,0.8571428571428571
74081,74081,99.00,1,6,7,0.14285714285714285,0.8571428571428571,No,0.8571428571428571
74082,74082,53.85,18,18,36,0.5,0.5,Tie,0.5
74083,74083,99.00,300,89,389,0.7712082262210797,0.22879177377892032,Yes,0.7712082262210797
74084,74084,99.00,33,17,50,0.66,0.34,Yes,0.66
74085,74085,99.00,5,3,8,0.625,0.375,Yes,0.625
74086,74086,99.00,4,2,6,0.6666666666666666,0.3333333333333333,Yes,0.6666666666666666
74087,74087,99.00,173,68,241,0.7178423236514523,0.2821576763485477,Yes,0.7178423236514523
74088,74088,99.00,269,84,353,0.7620396600566572,0.23796033994334279,Yes,0.7620396600566572
74089,74089,99.00,14,2,16,0.875,0.125,Yes,0.875
74090,74090,99.00,118,37,155,0.7612903225806451,0.23870967741935484,Yes,0.7612903225806451
74091,74091,99.00,166,49,215,0.772093023255814,0.22790697674418606,Yes,0.772093023255814
74092,74092,99.00,19,7,26,0.7307692307692307,0.2692307692307692,Yes,0.7307692307692307
74093,74093,99.00,0,0,0,0,0,n/a,0
74094,74094,99.00,0,0,0,0,0,n/a,0
74095,74095,99.00,0,0,0,0,0,n/a,0
74096,74096,99.00,0,0,0,0,0,n/a,0
74097,74097,99.00,0,0,0,0,0,n/a,0
74098,74098,80.00,18,3,21,0.8571428571428571,0.14285714285714285,Yes,0.8571428571428571
74099,74099,99.00,13,4,17,0.7647058823529411,0.23529411764705882,Yes,0.7647058823529411
74100,74100,99.00,7,1,8,0.875,0.125,Yes,0.875
74101,74101,53.85,164,80,244,0.6721311475409836,0.32786885245901637,Yes,0.6721311475409836
74102,74102,53.85,20,8,28,0.7142857142857143,0.2857142857142857,Yes,0.7142857142857143
74103,74103,99.00,18,6,24,0.75,0.25,Yes,0.75
74104,74104,99.00,115,46,161,0.7142857142857143,0.2857142857142857,Yes,0.7142857142857143
74105,74105,99.00,228,41,269,0.8475836431226765,0.1524163568773234,Yes,0.8475836431226765
74106,74106,99.00,7,3,10,0.7,0.3,Yes,0.7
74107,74107,99.00,12,5,17,0.7058823529411765,0.29411764705882354,Yes,0.7058823529411765
75001,75001,33.33,197,75,272,0.7242647058823529,0.2757352941176471,Yes,0.7242647058823529
75002,75002,99.00,193,79,272,0.7095588235294118,0.29044117647058826,Yes,0.7095588235294118
75003,75003,99.00,84,30,114,0.7368421052631579,0.2631578947368421,Yes,0.7368421052631579
75004,75004,99.00,22,14,36,0.6111111111111112,0.3888888888888889,Yes,0.6111111111111112
75005,75005,33.33,17,8,25,0.68,0.32,Yes,0.68
75006,75006,33.33,248,100,348,0.7126436781609196,0.28735632183908044,Yes,0.7126436781609196
75007,75007,99.00,146,43,189,0.7724867724867724,0.2275132275132275,Yes,0.7724867724867724
75008,75008,99.00,135,55,190,0.7105263157894737,0.2894736842105263,Yes,0.7105263157894737
75009,75009,99.00,90,37,127,0.7086614173228346,0.29133858267716534,Yes,0.7086614173228346
75010,75010,99.00,102,63,165,0.6181818181818182,0.38181818181818183,Yes,0.6181818181818182
75011,75011,99.00,101,41,142,0.7112676056338029,0.2887323943661972,Yes,0.7112676056338029
75012,75012,99.00,119,42,161,0.7391304347826086,0.2608695652173913,Yes,0.7391304347826086
75013,75013,99.00,208,51,259,0.803088803088803,0.1969111969111969,Yes,0.803088803088803
75014,75014,99.00,48,13,61,0.7868852459016393,0.21311475409836064,Yes,0.7868852459016393
75015,75015,99.00,183,60,243,0.7530864197530864,0.24691358024691357,Yes,0.7530864197530864
75016,75016,99.00,10,1,11,0.9090909090909091,0.09090909090909091,Yes,0.9090909090909091
75017,75017,99.00,123,37,160,0.76875,0.23125,Yes,0.76875
75018,75018,99.00,6,0,6,1.0,0.0,Yes,1.0
75019,75019,99.00,232,73,305,0.760655737704918,0.23934426229508196,Yes,0.760655737704918
75020,75020,99.00,7,5,12,0.5833333333333334,0.4166666666666667,Yes,0.5833333333333334
75021,75021,99.00,7,4,11,0.6363636363636364,0.36363636363636365,Yes,0.6363636363636364
75022,75022,99.00,202,83,285,0.7087719298245614,0.2912280701754386,Yes,0.7087719298245614
75023,75023,99.00,238,82,320,0.74375,0.25625,Yes,0.74375
75024,75024,99.00,6,4,10,0.6,0.4,Yes,0.6
75025,75025,99.00,252,85,337,0.7477744807121661,0.2522255192878338,Yes,0.7477744807121661
75026,75026,99.00,5,4,9,0.5555555555555556,0.4444444444444444,Yes,0.5555555555555556
75027,75027,33.33,20,9,29,0.6896551724137931,0.3103448275862069,Yes,0.6896551724137931
75028,75028,99.00,124,54,178,0.6966292134831461,0.30337078651685395,Yes,0.6966292134831461
75029,75029,99.00,65,30,95,0.6842105263157895,0.3157894736842105,Yes,0.6842105263157895
75030,75030,99.00,15,4,19,0.7894736842105263,0.21052631578947367,Yes,0.7894736842105263
75031,75031,99.00,98,37,135,0.725925925925926,0.2740740740740741,Yes,0.725925925925926
75032,75032,99.00,138,48,186,0.7419354838709677,0.25806451612903225,Yes,0.7419354838709677
75033,75033,99.00,168,80,248,0.6774193548387096,0.3225806451612903,Yes,0.6774193548387096
75034,75034,99.00,59,18,77,0.7662337662337663,0.23376623376623376,Yes,0.7662337662337663
75035,75035,99.00,8,2,10,0.8,0.2,Yes,0.8
75036,75036,99.00,97,38,135,0.7185185185185186,0.2814814814814815,Yes,0.7185185185185186
75037,75037,99.00,133,45,178,0.7471910112359551,0.25280898876404495,Yes,0.7471910112359551
75038,75038,99.00,366,87,453,0.8079470198675497,0.19205298013245034,Yes,0.8079470198675497
75039,75039,99.00,8,2,10,0.8,0.2,Yes,0.8
75040,75040,99.00,133,37,170,0.7823529411764706,0.21764705882352942,Yes,0.7823529411764706
75041,75041,99.00,4,1,5,0.8,0.2,Yes,0.8
75042,75042,99.00,0,2,2,0.0,1.0,No,1.0
75043,75043,99.00,263,73,336,0.7827380952380952,0.21726190476190477,Yes,0.7827380952380952
75044,75044,99.00,231,59,290,0.7965517241379311,0.20344827586206896,Yes,0.7965517241379311
75045,75045,99.00,184,47,231,0.7965367965367965,0.20346320346320346,Yes,0.7965367965367965
75046,75046,99.00,1,0,1,1.0,0.0,Yes,1.0
75047,75047,99.00,5,2,7,0.7142857142857143,0.2857142857142857,Yes,0.7142857142857143
75048,75048,99.00,183,67,250,0.732,0.268,Yes,0.732
75049,75049,99.00,102,48,150,0.68,0.32,Yes,0.68
75050,75050,99.00,64,19,83,0.7710843373493976,0.2289156626506024,Yes,0.7710843373493976
75051,75051,99.00,94,35,129,0.7286821705426356,0.2713178294573643,Yes,0.7286821705426356
75052,75052,99.00,25,4,29,0.8620689655172413,0.13793103448275862,Yes,0.8620689655172413
75053,75053,53.85,153,53,206,0.7427184466019418,0.25728155339805825,Yes,0.7427184466019418
75054,75054,53.85,34,8,42,0.8095238095238095,0.19047619047619047,Yes,0.8095238095238095
75055,75055,53.85,23,7,30,0.7666666666666667,0.23333333333333334,Yes,0.7666666666666667
75056,75056,99.00,157,67,224,0.7008928571428571,0.29910714285714285,Yes,0.7008928571428571
75057,75057,99.00,5,0,5,1.0,0.0,Yes,1.0
75058,75058,99.00,72,26,98,0.7346938775510204,0.2653061224489796,Yes,0.7346938775510204
75059,75059,80.00,193,56,249,0.7751004016064257,0.2248995983935743,Yes,0.7751004016064257
75060,75060,99.00,8,5,13,0.6153846153846154,0.38461538461538464,Yes,0.6153846153846154
75061,75061,99.00,0,0,0,0,0,n/a,0
75062,75062,99.00,149,39,188,0.7925531914893617,0.2074468085106383,Yes,0.7925531914893617
75063,75063,99.00,91,32,123,0.7398373983739838,0.2601626016260163,Yes,0.7398373983739838
75064,75064,80.00,8,6,14,0.5714285714285714,0.42857142857142855,Yes,0.5714285714285714
75065,75065,99.00,39,21,60,0.65,0.35,Yes,0.65
75066,75066,99.00,220,95,315,0.6984126984126984,0.30158730158730157,Yes,0.6984126984126984
75067,75067,99.00,112,25,137,0.8175182481751825,0.18248175182481752,Yes,0.8175182481751825
75068,75068,99.00,8,10,18,0.4444444444444444,0.5555555555555556,No,0.5555555555555556
75069,75069,99.00,120,22,142,0.8450704225352113,0.15492957746478872,Yes,0.8450704225352113
75070,75070,99.00,171,51,222,0.7702702702702703,0.22972972972972974,Yes,0.7702702702702703
75071,75071,99.00,398,77,475,0.8378947368421052,0.16210526315789472,Yes,0.8378947368421052
75072,75072,99.00,353,71,424,0.8325471698113207,0.16745283018867924,Yes,0.8325471698113207
75073,75073,99.00,113,28,141,0.8014184397163121,0.19858156028368795,Yes,0.8014184397163121
75074,75074,99.00,67,21,88,0.7613636363636364,0.23863636363636365,Yes,0.7613636363636364
75075,75075,99.00,57,30,87,0.6551724137931034,0.3448275862068966,Yes,0.6551724137931034
75076,75076,99.00,9,4,13,0.6923076923076923,0.3076923076923077,Yes,0.6923076923076923
75077,75077,99.00,11,3,14,0.7857142857142857,0.21428571428571427,Yes,0.7857142857142857
75078,75078,99.00,8,7,15,0.5333333333333333,0.4666666666666667,Yes,0.5333333333333333
75079,75079,99.00,12,3,15,0.8,0.2,Yes,0.8
75080,75080,99.00,19,6,25,0.76,0.24,Yes,0.76
75081,75081,99.00,8,0,8,1.0,0.0,Yes,1.0
75082,75082,99.00,267,65,332,0.8042168674698795,0.19578313253012047,Yes,0.8042168674698795
75083,75083,99.00,195,60,255,0.7647058823529411,0.23529411764705882,Yes,0.7647058823529411
75084,75084,99.00,4,2,6,0.6666666666666666,0.3333333333333333,Yes,0.6666666666666666
75085,75085,99.00,14,2,16,0.875,0.125,Yes,0.875
75086,75086,99.00,2,3,5,0.4,0.6,No,0.6
75087,75087,99.00,163,61,224,0.7276785714285714,0.27232142857142855,Yes,0.7276785714285714
75088,75088,99.00,6,1,7,0.8571428571428571,0.14285714285714285,Yes,0.8571428571428571
75089,75089,99.00,6,4,10,0.6,0.4,Yes,0.6
75090,75090,99.00,8,4,12,0.6666666666666666,0.3333333333333333,Yes,0.6666666666666666
75091,75091,99.00,113,54,167,0.6766467065868264,0.32335329341317365,Yes,0.6766467065868264
75092,75092,99.00,98,44,142,0.6901408450704225,0.30985915492957744,Yes,0.6901408450704225
75093,75093,99.00,66,16,82,0.8048780487804879,0.1951219512195122,Yes,0.8048780487804879
75094,75094,99.00,5,5,10,0.5,0.5,Tie,0.5
75095,75095,99.00,3,1,4,0.75,0.25,Yes,0.75
75096,75096,99.00,16,7,23,0.6956521739130435,0.30434782608695654,Yes,0.6956521739130435
75097,75097,99.00,201,67,268,0.75,0.25,Yes,0.75
75098,75098,99.00,15,15,30,0.5,0.5,Tie,0.5
75099,75099,99.00,175,77,252,0.6944444444444444,0.3055555555555556,Yes,0.6944444444444444
75100,75100,99.00,19,7,26,0.7307692307692307,0.2692307692307692,Yes,0.7307692307692307
75101,75101,99.00,0,0,0,0,0,n/a,0
75102,75102,99.00,0,0,0,0,0,n/a,0
75103,75103,99.00,0,0,0,0,0,n/a,0
75104,75104,99.00,0,0,0,0,0,n/a,0
75105,75105,99.00,0,0,0,0,0,n/a,0
75106,75106,99.00,0,0,0,0,0,n/a,0
75107,75107,99.00,17,6,23,0.7391304347826086,0.2608695652173913,Yes,0.7391304347826086
75108,75108,99.00,151,26,177,0.8531073446327684,0.14689265536723164,Yes,0.8531073446327684
75109,75109,99.00,8,3,11,0.7272727272727273,0.2727272727272727,Yes,0.7272727272727273
75110,75110,99.00,10,8,18,0.5555555555555556,0.4444444444444444,Yes,0.5555555555555556
75111,75111,99.00,201,58,259,0.7760617760617761,0.22393822393822393,Yes,0.7760617760617761
75112,75112,99.00,245,90,335,0.7313432835820896,0.26865671641791045,Yes,0.7313432835820896
75113,75113,99.00,3,0,3,1.0,0.0,Yes,1.0
75114,75114,99.00,5,3,8,0.625,0.375,Yes,0.625
75115,75115,99.00,203,66,269,0.7546468401486989,0.24535315985130113,Yes,0.7546468401486989
76001,76001,99.00,196,86,282,0.6950354609929078,0.3049645390070922,Yes,0.6950354609929078
76002,76002,99.00,148,38,186,0.7956989247311828,0.20430107526881722,Yes,0.7956989247311828
76003,76003,99.00,8,5,13,0.6153846153846154,0.38461538461538464,Yes,0.6153846153846154
76004,76004,99.00,9,8,17,0.5294117647058824,0.47058823529411764,Yes,0.5294117647058824
76005,76005,99.00,11,1,12,0.9166666666666666,0.08333333333333333,Yes,0.9166666666666666
76006,76006,99.00,153,85,238,0.6428571428571429,0.35714285714285715,Yes,0.6428571428571429
76007,76007,99.00,156,69,225,0.6933333333333334,0.30666666666666664,Yes,0.6933333333333334
76008,76008,99.00,10,5,15,0.6666666666666666,0.3333333333333333,Yes,0.6666666666666666
76009,76009,99.00,101,66,167,0.6047904191616766,0.39520958083832336,Yes,0.6047904191616766
76010,76010,99.00,178,74,252,0.7063492063492064,0.29365079365079366,Yes,0.7063492063492064
76011,76011,99.00,14,4,18,0.7777777777777778,0.2222222222222222,Yes,0.7777777777777778
76012,76012,99.00,139,63,202,0.6881188118811881,0.3118811881188119,Yes,0.6881188118811881
76013,76013,99.00,16,11,27,0.5925925925925926,0.4074074074074074,Yes,0.5925925925925926
76014,76014,99.00,135,72,207,0.6521739130434783,0.34782608695652173,Yes,0.6521739130434783
76015,76015,99.00,19,8,27,0.7037037037037037,0.2962962962962963,Yes,0.7037037037037037
76016,76016,99.00,275,111,386,0.7124352331606217,0.28756476683937826,Yes,0.7124352331606217
76017,76017,99.00,10,4,14,0.7142857142857143,0.2857142857142857,Yes,0.7142857142857143
76018,76018,99.00,14,5,19,0.7368421052631579,0.2631578947368421,Yes,0.7368421052631579
76019,76019,0.00,12,9,21,0.5714285714285714,0.42857142857142855,Yes,0.5714285714285714
76020,76020,99.00,183,84,267,0.6853932584269663,0.3146067415730337,Yes,0.6853932584269663
76021,76021,99.00,221,98,319,0.6927899686520376,0.3072100313479624,Yes,0.6927899686520376
76022,76022,0.00,7,3,10,0.7,0.3,Yes,0.7
76023,76023,0.00,6,7,13,0.46153846153846156,0.5384615384615384,No,0.5384615384615384
76024,76024,0.00,22,13,35,0.6285714285714286,0.37142857142857144,Yes,0.6285714285714286
76025,76025,0.00,38,15,53,0.7169811320754716,0.2830188679245283,Yes,0.7169811320754716
76026,76026,0.00,25,11,36,0.6944444444444444,0.3055555555555556,Yes,0.6944444444444444
76027,76027,0.00,21,7,28,0.75,0.25,Yes,0.75
76028,76028,0.00,30,14,44,0.6818181818181818,0.3181818181818182,Yes,0.6818181818181818
76029,76029,99.00,67,45,112,0.5982142857142857,0.4017857142857143,Yes,0.5982142857142857
76030,76030,46.67,24,17,41,0.5853658536585366,0.4146341463414634,Yes,0.5853658536585366
76031,76031,0.00,18,8,26,0.6923076923076923,0.3076923076923077,Yes,0.6923076923076923
76032,76032,0.00,14,6,20,0.7,0.3,Yes,0.7
76033,76033,99.00,183,71,254,0.7204724409448819,0.2795275590551181,Yes,0.7204724409448819
76034,76034,0.00,59,24,83,0.7108433734939759,0.2891566265060241,Yes,0.7108433734939759
76035,76035,0.00,12,5,17,0.7058823529411765,0.29411764705882354,Yes,0.7058823529411765
76036,76036,99.00,12,2,14,0.8571428571428571,0.14285714285714285,Yes,0.8571428571428571
76037,76037,46.67,202,99,301,0.6710963455149501,0.3289036544850498,Yes,0.6710963455149501
76038,76038,46.67,29,19,48,0.6041666666666666,0.3958333333333333,Yes,0.6041666666666666
76039,76039,46.67,190,86,276,0.6884057971014492,0.3115942028985507,Yes,0.6884057971014492
76040,76040,0.00,18,7,25,0.72,0.28,Yes,0.72
76041,76041,0.00,17,5,22,0.7727272727272727,0.22727272727272727,Yes,0.7727272727272727
76042,76042,0.00,25,14,39,0.6410256410256411,0.358974358974359,Yes,0.6410256410256411
76043,76043,0.00,16,6,22,0.7272727272727273,0.2727272727272727,Yes,0.7272727272727273
76044,76044,0.00,17,2,19,0.8947368421052632,0.10526315789473684,Yes,0.8947368421052632
76045,76045,0.00,16,6,22,0.7272727272727273,0.2727272727272727,Yes,0.7272727272727273
76046,76046,46.67,46,18,64,0.71875,0.28125,Yes,0.71875
76047,76047,46.67,135,57,192,0.703125,0.296875,Yes,0.703125
76048,76048,90.00,196,93,289,0.6782006920415224,0.3217993079584775,Yes,0.6782006920415224
76049,76049,0.00,23,18,41,0.5609756097560976,0.43902439024390244,Yes,0.5609756097560976
76050,76050,0.00,18,1,19,0.9473684210526315,0.05263157894736842,Yes,0.9473684210526315
76051,76051,0.00,30,16,46,0.6521739130434783,0.34782608695652173,Yes,0.6521739130434783
76052,76052,90.00,215,73,288,0.7465277777777778,0.2534722222222222,Yes,0.7465277777777778
76053,76053,90.00,14,7,21,0.6666666666666666,0.3333333333333333,Yes,0.6666666666666666
76054,76054,90.00,125,52,177,0.7062146892655368,0.2937853107344633,Yes,0.7062146892655368
76055,76055,99.00,159,76,235,0.676595744680851,0.32340425531914896,Yes,0.676595744680851
76056,76056,90.00,13,5,18,0.7222222222222222,0.2777777777777778,Yes,0.7222222222222222
76057,76057,90.00,233,94,327,0.7125382262996942,0.2874617737003058,Yes,0.7125382262996942
76058,76058,0.00,13,17,30,0.43333333333333335,0.5666666666666667,No,0.5666666666666667
76059,76059,90.00,16,19,35,0.45714285714285713,0.5428571428571428,No,0.5428571428571428
76060,76060,90.00,177,104,281,0.6298932384341637,0.3701067615658363,Yes,0.6298932384341637
76061,76061,90.00,12,8,20,0.6,0.4,Yes,0.6
76062,76062,90.00,172,84,256,0.671875,0.328125,Yes,0.671875
76063,76063,90.00,9,11,20,0.45,0.55,No,0.55
76064,76064,0.00,8,9,17,0.47058823529411764,0.5294117647058824,No,0.5294117647058824
76065,76065,99.00,160,73,233,0.6866952789699571,0.3133047210300429,Yes,0.6866952789699571
76066,76066,0.00,11,10,21,0.5238095238095238,0.47619047619047616,Yes,0.5238095238095238
76067,76067,99.00,225,118,343,0.6559766763848397,0.34402332361516036,Yes,0.6559766763848397
76068,76068,0.00,25,7,32,0.78125,0.21875,Yes,0.78125
76069,76069,99.00,21,17,38,0.5526315789473685,0.4473684210526316,Yes,0.5526315789473685
76070,76070,0.00,14,9,23,0.6086956521739131,0.391304347826087,Yes,0.6086956521739131
76071,76071,0.00,25,5,30,0.8333333333333334,0.16666666666666666,Yes,0.8333333333333334
76072,76072,0.00,35,10,45,0.7777777777777778,0.2222222222222222,Yes,0.7777777777777778
76073,76073,0.00,5,4,9,0.5555555555555556,0.4444444444444444,Yes,0.5555555555555556
76074,76074,0.00,7,8,15,0.4666666666666667,0.5333333333333333,No,0.5333333333333333
76075,76075,0.00,14,7,21,0.6666666666666666,0.3333333333333333,Yes,0.6666666666666666
76076,76076,99.00,162,43,205,0.7902439024390244,0.2097560975609756,Yes,0.7902439024390244
76077,76077,0.00,20,6,26,0.7692307692307693,0.23076923076923078,Yes,0.7692307692307693
76078,76078,99.00,7,1,8,0.875,0.125,Yes,0.875
76079,76079,99.00,221,92,313,0.7060702875399361,0.2939297124600639,Yes,0.7060702875399361
76080,76080,99.00,234,70,304,0.7697368421052632,0.23026315789473684,Yes,0.7697368421052632
76081,76081,99.00,3,2,5,0.6,0.4,Yes,0.6
76082,76082,99.00,88,32,120,0.7333333333333333,0.26666666666666666,Yes,0.7333333333333333
76083,76083,99.00,296,82,378,0.783068783068783,0.21693121693121692,Yes,0.783068783068783
76084,76084,99.00,7,2,9,0.7777777777777778,0.2222222222222222,Yes,0.7777777777777778
76085,76085,99.00,187,53,240,0.7791666666666667,0.22083333333333333,Yes,0.7791666666666667
76086,76086,99.00,7,1,8,0.875,0.125,Yes,0.875
76087,76087,99.00,47,8,55,0.8545454545454545,0.14545454545454545,Yes,0.8545454545454545
76088,76088,46.67,46,26,72,0.6388888888888888,0.3611111111111111,Yes,0.6388888888888888
76089,76089,90.00,168,60,228,0.7368421052631579,0.2631578947368421,Yes,0.7368421052631579
76090,76090,0.00,0,0,0,0,0,n/a,0
76091,76091,99.00,0,0,0,0,0,n/a,0
76092,76092,99.00,0,0,0,0,0,n/a,0
76093,76093,99.00,0,0,0,0,0,n/a,0
76094,76094,0.00,0,0,0,0,0,n/a,0
76095,76095,99.00,0,0,0,0,0,n/a,0
76096,76096,99.00,0,0,0,0,0,n/a,0
76097,76097,0.00,0,0,0,0,0,n/a,0
76098,76098,99.00,0,0,0,0,0,n/a,0
76099,76099,90.00,19,5,24,0.7916666666666666,0.20833333333333334,Yes,0.7916666666666666
76100,76100,0.00,24,6,30,0.8,0.2,Yes,0.8
76101,76101,99.00,21,12,33,0.6363636363636364,0.36363636363636365,Yes,0.6363636363636364
76102,76102,99.00,6,12,18,0.3333333333333333,0.6666666666666666,No,0.6666666666666666
76103,76103,0.00,7,2,9,0.7777777777777778,0.2222222222222222,Yes,0.7777777777777778
77001,77001,99.00,2,0,2,1.0,0.0,Yes,1.0
77002,77002,99.00,70,19,89,0.7865168539325843,0.21348314606741572,Yes,0.7865168539325843
77003,77003,99.00,129,22,151,0.8543046357615894,0.1456953642384106,Yes,0.8543046357615894
77004,77004,99.00,1,1,2,0.5,0.5,Tie,0.5
77005,77005,99.00,108,33,141,0.7659574468085106,0.23404255319148937,Yes,0.7659574468085106
77006,77006,99.00,71,8,79,0.8987341772151899,0.10126582278481013,Yes,0.8987341772151899
77007,77007,99.00,70,24,94,0.7446808510638298,0.2553191489361702,Yes,0.7446808510638298
77008,77008,99.00,53,9,62,0.8548387096774194,0.14516129032258066,Yes,0.8548387096774194
77009,77009,99.00,67,13,80,0.8375,0.1625,Yes,0.8375
77010,77010,99.00,156,41,197,0.7918781725888325,0.20812182741116753,Yes,0.7918781725888325
77011,77011,99.00,48,8,56,0.8571428571428571,0.14285714285714285,Yes,0.8571428571428571
77012,77012,99.00,115,17,132,0.8712121212121212,0.12878787878787878,Yes,0.8712121212121212
77013,77013,99.00,0,0,0,0,0,n/a,0
77014,77014,99.00,118,20,138,0.855072463768116,0.14492753623188406,Yes,0.855072463768116
77015,77015,99.00,0,0,0,0,0,n/a,0
77016,77016,99.00,95,13,108,0.8796296296296297,0.12037037037037036,Yes,0.8796296296296297
77017,77017,99.00,93,15,108,0.8611111111111112,0.1388888888888889,Yes,0.8611111111111112
77018,77018,0.00,3,0,3,1.0,0.0,Yes,1.0
77019,77019,99.00,79,11,90,0.8777777777777778,0.12222222222222222,Yes,0.8777777777777778
77020,77020,99.00,0,1,1,0.0,1.0,No,1.0
77021,77021,99.00,88,12,100,0.88,0.12,Yes,0.88
77022,77022,99.00,96,13,109,0.8807339449541285,0.11926605504587157,Yes,0.8807339449541285
77023,77023,99.00,66,20,86,0.7674418604651163,0.23255813953488372,Yes,0.7674418604651163
77024,77024,99.00,1,0,1,1.0,0.0,Yes,1.0
77025,77025,99.00,122,17,139,0.8776978417266187,0.1223021582733813,Yes,0.8776978417266187
77026,77026,99.00,0,0,0,0,0,n/a,0
77027,77027,99.00,73,12,85,0.8588235294117647,0.1411764705882353,Yes,0.8588235294117647
77028,77028,99.00,112,14,126,0.8888888888888888,0.1111111111111111,Yes,0.8888888888888888
77029,77029,99.00,4,0,4,1.0,0.0,Yes,1.0
77030,77030,99.00,0,0,0,0,0,n/a,0
77031,77031,99.00,64,8,72,0.8888888888888888,0.1111111111111111,Yes,0.8888888888888888
77032,77032,0.00,1,0,1,1.0,0.0,Yes,1.0
77033,77033,0.00,0,0,0,0,0,n/a,0
77034,77034,0.00,0,0,0,0,0,n/a,0
77035,77035,0.00,1,0,1,1.0,0.0,Yes,1.0
77036,77036,0.00,2,0,2,1.0,0.0,Yes,1.0
77037,77037,99.00,96,17,113,0.8495575221238938,0.1504424778761062,Yes,0.8495575221238938
77038,77038,99.00,1,0,1,1.0,0.0,Yes,1.0
77039,77039,99.00,122,14,136,0.8970588235294118,0.10294117647058823,Yes,0.8970588235294118
77040,77040,99.00,1,0,1,1.0,0.0,Yes,1.0
77041,77041,99.00,2,0,2,1.0,0.0,Yes,1.0
77042,77042,99.00,111,20,131,0.8473282442748091,0.15267175572519084,Yes,0.8473282442748091
77043,77043,99.00,75,10,85,0.8823529411764706,0.11764705882352941,Yes,0.8823529411764706
77044,77044,99.00,109,13,122,0.8934426229508197,0.10655737704918032,Yes,0.8934426229508197
77045,77045,99.00,94,14,108,0.8703703703703703,0.12962962962962962,Yes,0.8703703703703703
77046,77046,99.00,0,0,0,0,0,n/a,0
77047,77047,99.00,138,24,162,0.8518518518518519,0.14814814814814814,Yes,0.8518518518518519
77048,77048,99.00,134,18,152,0.881578947368421,0.11842105263157894,Yes,0.881578947368421
77049,77049,55.56,144,30,174,0.8275862068965517,0.1724137931034483,Yes,0.8275862068965517
77050,77050,99.00,155,19,174,0.8908045977011494,0.10919540229885058,Yes,0.8908045977011494
77051,77051,99.00,2,0,2,1.0,0.0,Yes,1.0
77052,77052,99.00,10,2,12,0.8333333333333334,0.16666666666666666,Yes,0.8333333333333334
77053,77053,99.00,135,8,143,0.9440559440559441,0.055944055944055944,Yes,0.9440559440559441
77054,77054,99.00,47,5,52,0.9038461538461539,0.09615384615384616,Yes,0.9038461538461539
77055,77055,99.00,108,21,129,0.8372093023255814,0.16279069767441862,Yes,0.8372093023255814
77056,77056,99.00,2,2,4,0.5,0.5,Tie,0.5
77057,77057,99.00,5,1,6,0.8333333333333334,0.16666666666666666,Yes,0.8333333333333334
77058,77058,99.00,224,34,258,0.8682170542635659,0.13178294573643412,Yes,0.8682170542635659
77059,77059,55.56,8,2,10,0.8,0.2,Yes,0.8
77060,77060,55.56,12,4,16,0.75,0.25,Yes,0.75
77061,77061,55.56,132,26,158,0.8354430379746836,0.16455696202531644,Yes,0.8354430379746836
77062,77062,99.00,79,7,86,0.9186046511627907,0.08139534883720931,Yes,0.9186046511627907
77063,77063,99.00,2,1,3,0.6666666666666666,0.3333333333333333,Yes,0.6666666666666666
77064,77064,99.00,2,0,2,1.0,0.0,Yes,1.0
77065,77065,99.00,58,10,68,0.8529411764705882,0.14705882352941177,Yes,0.8529411764705882
77066,77066,99.00,116,36,152,0.7631578947368421,0.23684210526315788,Yes,0.7631578947368421
77067,77067,99.00,0,0,0,0,0,n/a,0
77068,77068,99.00,56,12,68,0.8235294117647058,0.17647058823529413,Yes,0.8235294117647058
77069,77069,55.56,0,0,0,0,0,n/a,0
77070,77070,99.00,0,0,0,0,0,n/a,0
77071,77071,99.00,131,19,150,0.8733333333333333,0.12666666666666668,Yes,0.8733333333333333
77072,77072,55.56,14,1,15,0.9333333333333333,0.06666666666666667,Yes,0.9333333333333333
77073,77073,55.56,0,0,0,0,0,n/a,0
77074,77074,99.00,0,1,1,0.0,1.0,No,1.0
77075,77075,99.00,1,1,2,0.5,0.5,Tie,0.5
77076,77076,99.00,89,10,99,0.898989898989899,0.10101010101010101,Yes,0.898989898989899
77077,77077,99.00,0,0,0,0,0,n/a,0
77078,77078,99.00,60,9,69,0.8695652173913043,0.13043478260869565,Yes,0.8695652173913043
77079,77079,99.00,0,0,0,0,0,n/a,0
77080,77080,99.00,1,0,1,1.0,0.0,Yes,1.0
77081,77081,99.00,1,0,1,1.0,0.0,Yes,1.0
77082,77082,99.00,6,1,7,0.8571428571428571,0.14285714285714285,Yes,0.8571428571428571
78001,78001,99.00,1,2,3,0.3333333333333333,0.6666666666666666,No,0.6666666666666666
78002,78002,99.00,117,12,129,0.9069767441860465,0.09302325581395349,Yes,0.9069767441860465
78003,78003,99.00,117,17,134,0.8731343283582089,0.12686567164179105,Yes,0.8731343283582089
78004,78004,99.00,1,0,1,1.0,0.0,Yes,1.0
78005,78005,99.00,124,25,149,0.8322147651006712,0.16778523489932887,Yes,0.8322147651006712
78006,78006,99.00,133,35,168,0.7916666666666666,0.20833333333333334,Yes,0.7916666666666666
78007,78007,20.00,71,6,77,0.922077922077922,0.07792207792207792,Yes,0.922077922077922
78008,78008,99.00,122,18,140,0.8714285714285714,0.12857142857142856,Yes,0.8714285714285714
78009,78009,20.00,9,1,10,0.9,0.1,Yes,0.9
78010,78010,0.00,0,0,0,0,0,n/a,0
78011,78011,0.00,0,0,0,0,0,n/a,0
78012,78012,99.00,89,16,105,0.8476190476190476,0.1523809523809524,Yes,0.8476190476190476
78013,78013,99.00,92,14,106,0.8679245283018868,0.1320754716981132,Yes,0.8679245283018868
78014,78014,99.00,65,11,76,0.8552631578947368,0.14473684210526316,Yes,0.8552631578947368
78015,78015,99.00,55,9,64,0.859375,0.140625,Yes,0.859375
78016,78016,83.33,108,17,125,0.864,0.136,Yes,0.864
78017,78017,99.00,0,0,0,0,0,n/a,0
78018,78018,99.00,80,21,101,0.7920792079207921,0.2079207920792079,Yes,0.7920792079207921
78019,78019,99.00,60,7,67,0.8955223880597015,0.1044776119402985,Yes,0.8955223880597015
78020,78020,99.00,59,13,72,0.8194444444444444,0.18055555555555555,Yes,0.8194444444444444
78021,78021,99.00,6,0,6,1.0,0.0,Yes,1.0
78022,78022,99.00,4,0,4,1.0,0.0,Yes,1.0
78023,78023,99.00,58,11,69,0.8405797101449275,0.15942028985507245,Yes,0.8405797101449275
78024,78024,99.00,57,17,74,0.7702702702702703,0.22972972972972974,Yes,0.7702702702702703
78025,78025,99.00,3,0,3,1.0,0.0,Yes,1.0
78026,78026,99.00,3,0,3,1.0,0.0,Yes,1.0
78027,78027,99.00,130,25,155,0.8387096774193549,0.16129032258064516,Yes,0.8387096774193549
78028,78028,83.33,1,0,1,1.0,0.0,Yes,1.0
78029,78029,99.00,91,15,106,0.8584905660377359,0.14150943396226415,Yes,0.8584905660377359
78030,78030,99.00,3,0,3,1.0,0.0,Yes,1.0
78031,78031,83.33,116,27,143,0.8111888111888111,0.1888111888111888,Yes,0.8111888111888111
78032,78032,83.33,3,0,3,1.0,0.0,Yes,1.0
78033,78033,99.00,175,35,210,0.8333333333333334,0.16666666666666666,Yes,0.8333333333333334
78034,78034,99.00,105,21,126,0.8333333333333334,0.16666666666666666,Yes,0.8333333333333334
78035,78035,83.33,1,1,2,0.5,0.5,Tie,0.5
78036,78036,83.33,36,17,53,0.6792452830188679,0.32075471698113206,Yes,0.6792452830188679
78037,78037,20.00,80,14,94,0.851063829787234,0.14893617021276595,Yes,0.851063829787234
78038,78038,83.33,70,20,90,0.7777777777777778,0.2222222222222222,Yes,0.7777777777777778
78039,78039,20.00,6,1,7,0.8571428571428571,0.14285714285714285,Yes,0.8571428571428571
78040,78040,99.00,176,25,201,0.8756218905472637,0.12437810945273632,Yes,0.8756218905472637
78041,78041,99.00,112,37,149,0.7516778523489933,0.2483221476510067,Yes,0.7516778523489933
78042,78042,99.00,0,0,0,0,0,n/a,0
78043,78043,99.00,91,10,101,0.900990099009901,0.09900990099009901,Yes,0.900990099009901
78044,78044,99.00,92,19,111,0.8288288288288288,0.17117117117117117,Yes,0.8288288288288288
78045,78045,99.00,3,0,3,1.0,0.0,Yes,1.0
78046,78046,99.00,5,1,6,0.8333333333333334,0.16666666666666666,Yes,0.8333333333333334
78047,78047,99.00,97,8,105,0.9238095238095239,0.0761904761904762,Yes,0.9238095238095239
78048,78048,99.00,295,44,339,0.8702064896755162,0.12979351032448377,Yes,0.8702064896755162
78049,78049,99.00,7,3,10,0.7,0.3,Yes,0.7
78050,78050,99.00,100,14,114,0.8771929824561403,0.12280701754385964,Yes,0.8771929824561403
78051,78051,99.00,0,0,0,0,0,n/a,0
78052,78052,99.00,93,15,108,0.8611111111111112,0.1388888888888889,Yes,0.8611111111111112
78053,78053,99.00,60,11,71,0.8450704225352113,0.15492957746478872,Yes,0.8450704225352113
78054,78054,99.00,1,0,1,1.0,0.0,Yes,1.0
78055,78055,20.00,0,0,0,0,0,n/a,0
78056,78056,20.00,0,0,0,0,0,n/a,0
78057,78057,99.00,0,0,0,0,0,n/a,0
78058,78058,20.00,0,0,0,0,0,n/a,0
78059,78059,99.00,110,15,125,0.88,0.12,Yes,0.88
78060,78060,99.00,110,27,137,0.8029197080291971,0.19708029197080293,Yes,0.8029197080291971
78061,78061,83.33,138,20,158,0.8734177215189873,0.12658227848101267,Yes,0.8734177215189873
78062,78062,20.00,4,1,5,0.8,0.2,Yes,0.8
78063,78063,99.00,0,0,0,0,0,n/a,0
78064,78064,0.00,0,0,0,0,0,n/a,0
78065,78065,99.00,67,20,87,0.7701149425287356,0.22988505747126436,Yes,0.7701149425287356
78066,78066,99.00,3,3,6,0.5,0.5,Tie,0.5
78067,78067,83.33,2,1,3,0.6666666666666666,0.3333333333333333,Yes,0.6666666666666666
78068,78068,99.00,0,2,2,0.0,1.0,No,1.0
78069,78069,99.00,3,0,3,1.0,0.0,Yes,1.0
78070,78070,99.00,1,0,1,1.0,0.0,Yes,1.0
78071,78071,99.00,4,0,4,1.0,0.0,Yes,1.0
78072,78072,99.00,3,1,4,0.75,0.25,Yes,0.75
78073,78073,99.00,3,0,3,1.0,0.0,Yes,1.0
79001,79001,99.00,76,16,92,0.8260869565217391,0.17391304347826086,Yes,0.8260869565217391
79002,79002,99.00,3,1,4,0.75,0.25,Yes,0.75
79003,79003,99.00,71,7,78,0.9102564102564102,0.08974358974358974,Yes,0.9102564102564102
79004,79004,99.00,112,22,134,0.835820895522388,0.16417910447761194,Yes,0.835820895522388
79005,79005,99.00,2,0,2,1.0,0.0,Yes,1.0
79006,79006,99.00,42,8,50,0.84,0.16,Yes,0.84
79007,79007,99.00,68,20,88,0.7727272727272727,0.22727272727272727,Yes,0.7727272727272727
79008,79008,99.00,89,19,108,0.8240740740740741,0.17592592592592593,Yes,0.8240740740740741
79009,79009,99.00,1,0,1,1.0,0.0,Yes,1.0
79010,79010,99.00,59,16,75,0.7866666666666666,0.21333333333333335,Yes,0.7866666666666666
79011,79011,99.00,2,0,2,1.0,0.0,Yes,1.0
79012,79012,99.00,0,0,0,0,0,n/a,0
79013,79013,99.00,104,11,115,0.9043478260869565,0.09565217391304348,Yes,0.9043478260869565
79014,79014,66.67,2,0,2,1.0,0.0,Yes,1.0
79015,79015,66.67,76,15,91,0.8351648351648352,0.16483516483516483,Yes,0.8351648351648352
79016,79016,66.67,101,16,117,0.8632478632478633,0.13675213675213677,Yes,0.8632478632478633
79017,79017,99.00,123,15,138,0.8913043478260869,0.10869565217391304,Yes,0.8913043478260869
79018,79018,66.67,1,0,1,1.0,0.0,Yes,1.0
79019,79019,99.00,5,0,5,1.0,0.0,Yes,1.0
79020,79020,99.00,92,15,107,0.8598130841121495,0.14018691588785046,Yes,0.8598130841121495
79021,79021,99.00,0,0,0,0,0,n/a,0
79022,79022,99.00,132,24,156,0.8461538461538461,0.15384615384615385,Yes,0.8461538461538461
79023,79023,99.00,129,17,146,0.8835616438356164,0.11643835616438356,Yes,0.8835616438356164
79024,79024,99.00,2,0,2,1.0,0.0,Yes,1.0
79025,79025,37.50,44,5,49,0.8979591836734694,0.10204081632653061,Yes,0.8979591836734694
79026,79026,37.50,41,11,52,0.7884615384615384,0.21153846153846154,Yes,0.7884615384615384
79027,79027,37.50,57,7,64,0.890625,0.109375,Yes,0.890625
79028,79028,37.50,50,3,53,0.9433962264150944,0.05660377358490566,Yes,0.9433962264150944
79029,79029,99.00,27,3,30,0.9,0.1,Yes,0.9
79030,79030,99.00,147,28,175,0.84,0.16,Yes,0.84
79031,79031,99.00,2,0,2,1.0,0.0,Yes,1.0
79032,79032,99.00,2,0,2,1.0,0.0,Yes,1.0
79033,79033,99.00,75,21,96,0.78125,0.21875,Yes,0.78125
79034,79034,99.00,2,0,2,1.0,0.0,Yes,1.0
79035,79035,99.00,114,32,146,0.7808219178082192,0.2191780821917808,Yes,0.7808219178082192
79036,79036,99.00,115,22,137,0.8394160583941606,0.16058394160583941,Yes,0.8394160583941606
79037,79037,99.00,0,0,0,0,0,n/a,0
79038,79038,0.00,0,0,0,0,0,n/a,0
79039,79039,0.00,0,0,0,0,0,n/a,0
79040,79040,99.00,167,35,202,0.8267326732673267,0.17326732673267325,Yes,0.8267326732673267
79041,79041,0.00,1,0,1,1.0,0.0,Yes,1.0
79042,79042,99.00,102,27,129,0.7906976744186046,0.20930232558139536,Yes,0.7906976744186046
79043,79043,99.00,68,8,76,0.8947368421052632,0.10526315789473684,Yes,0.8947368421052632
79044,79044,99.00,61,17,78,0.782051282051282,0.21794871794871795,Yes,0.782051282051282
79045,79045,99.00,2,0,2,1.0,0.0,Yes,1.0
79046,79046,99.00,92,17,109,0.8440366972477065,0.1559633027522936,Yes,0.8440366972477065
79047,79047,99.00,0,1,1,0.0,1.0,No,1.0
79048,79048,99.00,51,9,60,0.85,0.15,Yes,0.85
79049,79049,99.00,87,29,116,0.75,0.25,Yes,0.75
79050,79050,99.00,124,20,144,0.8611111111111112,0.1388888888888889,Yes,0.8611111111111112
79051,79051,99.00,1,0,1,1.0,0.0,Yes,1.0
79052,79052,99.00,2,1,3,0.6666666666666666,0.3333333333333333,Yes,0.6666666666666666
79053,79053,99.00,165,22,187,0.8823529411764706,0.11764705882352941,Yes,0.8823529411764706
79054,79054,99.00,64,10,74,0.8648648648648649,0.13513513513513514,Yes,0.8648648648648649
79055,79055,99.00,75,16,91,0.8241758241758241,0.17582417582417584,Yes,0.8241758241758241
79056,79056,99.00,119,21,140,0.85,0.15,Yes,0.85
79057,79057,99.00,161,22,183,0.8797814207650273,0.12021857923497267,Yes,0.8797814207650273
79058,79058,99.00,57,3,60,0.95,0.05,Yes,0.95
79059,79059,99.00,2,2,4,0.5,0.5,Tie,0.5
79060,79060,99.00,3,0,3,1.0,0.0,Yes,1.0
79061,79061,99.00,100,14,114,0.8771929824561403,0.12280701754385964,Yes,0.8771929824561403
79062,79062,99.00,68,14,82,0.8292682926829268,0.17073170731707318,Yes,0.8292682926829268
79063,79063,99.00,53,11,64,0.828125,0.171875,Yes,0.828125
79064,79064,99.00,40,10,50,0.8,0.2,Yes,0.8
79065,79065,99.00,0,0,0,0,0,n/a,0
79066,79066,99.00,70,20,90,0.7777777777777778,0.2222222222222222,Yes,0.7777777777777778
79067,79067,99.00,94,8,102,0.9215686274509803,0.0784313725490196,Yes,0.9215686274509803
79068,79068,99.00,191,21,212,0.9009433962264151,0.09905660377358491,Yes,0.9009433962264151
79069,79069,99.00,422,55,477,0.8846960167714885,0.11530398322851153,Yes,0.8846960167714885
79070,79070,99.00,75,9,84,0.8928571428571429,0.10714285714285714,Yes,0.8928571428571429
79071,79071,99.00,1,2,3,0.3333333333333333,0.6666666666666666,No,0.6666666666666666
79072,79072,99.00,134,16,150,0.8933333333333333,0.10666666666666667,Yes,0.8933333333333333
79073,79073,99.00,4,1,5,0.8,0.2,Yes,0.8
79074,79074,99.00,0,0,0,0,0,n/a,0
79075,79075,99.00,83,15,98,0.8469387755102041,0.15306122448979592,Yes,0.8469387755102041
79076,79076,99.00,6,2,8,0.75,0.25,Yes,0.75
79077,79077,99.00,1,0,1,1.0,0.0,Yes,1.0
79078,79078,99.00,0,1,1,0.0,1.0,No,1.0
79079,79079,99.00,1,0,1,1.0,0.0,Yes,1.0
79080,79080,99.00,0,0,0,0,0,n/a,0
79081,79081,99.00,0,0,0,0,0,n/a,0
79082,79082,99.00,0,0,0,0,0,n/a,0
79083,79083,99.00,1,0,1,1.0,0.0,Yes,1.0
79084,79084,99.00,138,15,153,0.9019607843137255,0.09803921568627451,Yes,0.9019607843137255
79085,79085,99.00,1,0,1,1.0,0.0,Yes,1.0
79086,79086,99.00,85,30,115,0.7391304347826086,0.2608695652173913,Yes,0.7391304347826086
79087,79087,99.00,0,0,0,0,0,n/a,0
79088,79088,99.00,0,0,0,0,0,n/a,0
79089,79089,99.00,3,1,4,0.75,0.25,Yes,0.75
79090,79090,99.00,19,0,19,1.0,0.0,Yes,1.0
80001,80001,99.00,152,93,245,0.6204081632653061,0.3795918367346939,Yes,0.6204081632653061
80002,80002,99.00,1,3,4,0.25,0.75,No,0.75
80003,80003,99.00,7,1,8,0.875,0.125,Yes,0.875
80004,80004,99.00,70,34,104,0.6730769230769231,0.3269230769230769,Yes,0.6730769230769231
80005,80005,99.00,2,0,2,1.0,0.0,Yes,1.0
80006,80006,99.00,136,57,193,0.7046632124352331,0.29533678756476683,Yes,0.7046632124352331
80007,80007,99.00,0,0,0,0,0,n/a,0
80008,80008,99.00,5,0,5,1.0,0.0,Yes,1.0
80009,80009,99.00,118,40,158,0.7468354430379747,0.25316455696202533,Yes,0.7468354430379747
80010,80010,99.00,1,0,1,1.0,0.0,Yes,1.0
80011,80011,99.00,96,45,141,0.6808510638297872,0.3191489361702128,Yes,0.6808510638297872
80012,80012,99.00,0,0,0,0,0,n/a,0
80013,80013,99.00,124,27,151,0.8211920529801324,0.17880794701986755,Yes,0.8211920529801324
80014,80014,99.00,124,17,141,0.8794326241134752,0.12056737588652482,Yes,0.8794326241134752
80015,80015,99.00,176,36,212,0.8301886792452831,0.16981132075471697,Yes,0.8301886792452831
80016,80016,99.00,9,1,10,0.9,0.1,Yes,0.9
80017,80017,99.00,130,39,169,0.7692307692307693,0.23076923076923078,Yes,0.7692307692307693
80018,80018,99.00,2,0,2,1.0,0.0,Yes,1.0
80019,80019,99.00,1,2,3,0.3333333333333333,0.6666666666666666,No,0.6666666666666666
80020,80020,99.00,11,0,11,1.0,0.0,Yes,1.0
80021,80021,99.00,150,31,181,0.8287292817679558,0.1712707182320442,Yes,0.8287292817679558
80022,80022,99.00,4,1,5,0.8,0.2,Yes,0.8
80023,80023,99.00,147,10,157,0.9363057324840764,0.06369426751592357,Yes,0.9363057324840764
80024,80024,99.00,2,1,3,0.6666666666666666,0.3333333333333333,Yes,0.6666666666666666
80025,80025,99.00,156,27,183,0.8524590163934426,0.14754098360655737,Yes,0.8524590163934426
80026,80026,99.00,173,48,221,0.7828054298642534,0.2171945701357466,Yes,0.7828054298642534
80027,80027,99.00,1,0,1,1.0,0.0,Yes,1.0
80028,80028,99.00,0,1,1,0.0,1.0,No,1.0
80029,80029,99.00,0,1,1,0.0,1.0,No,1.0
80030,80030,99.00,123,64,187,0.6577540106951871,0.3422459893048128,Yes,0.6577540106951871
80031,80031,75.00,133,47,180,0.7388888888888889,0.2611111111111111,Yes,0.7388888888888889
80032,80032,75.00,3,1,4,0.75,0.25,Yes,0.75
80033,80033,75.00,72,22,94,0.7659574468085106,0.23404255319148937,Yes,0.7659574468085106
80034,80034,75.00,5,1,6,0.8333333333333334,0.16666666666666666,Yes,0.8333333333333334
80035,80035,99.00,10,0,10,1.0,0.0,Yes,1.0
80036,80036,99.00,111,33,144,0.7708333333333334,0.22916666666666666,Yes,0.7708333333333334
80037,80037,33.33,88,25,113,0.7787610619469026,0.22123893805309736,Yes,0.7787610619469026
80038,80038,99.00,177,31,208,0.8509615384615384,0.14903846153846154,Yes,0.8509615384615384
80039,80039,99.00,4,0,4,1.0,0.0,Yes,1.0
80040,80040,33.33,4,3,7,0.5714285714285714,0.42857142857142855,Yes,0.5714285714285714
80041,80041,99.00,88,25,113,0.7787610619469026,0.22123893805309736,Yes,0.7787610619469026
80042,80042,99.00,79,16,95,0.8315789473684211,0.16842105263157894,Yes,0.8315789473684211
80043,80043,33.33,89,21,110,0.8090909090909091,0.19090909090909092,Yes,0.8090909090909091
80044,80044,33.33,2,1,3,0.6666666666666666,0.3333333333333333,Yes,0.6666666666666666
80045,80045,99.00,66,28,94,0.7021276595744681,0.2978723404255319,Yes,0.7021276595744681
80046,80046,99.00,90,17,107,0.8411214953271028,0.1588785046728972,Yes,0.8411214953271028
80047,80047,99.00,2,1,3,0.6666666666666666,0.3333333333333333,Yes,0.6666666666666666
80048,80048,99.00,155,27,182,0.8516483516483516,0.14835164835164835,Yes,0.8516483516483516
80049,80049,99.00,0,0,0,0,0,n/a,0
80050,80050,99.00,2,0,2,1.0,0.0,Yes,1.0
80051,80051,99.00,2,0,2,1.0,0.0,Yes,1.0
80052,80052,99.00,109,21,130,0.8384615384615385,0.16153846153846155,Yes,0.8384615384615385
80053,80053,99.00,3,1,4,0.75,0.25,Yes,0.75
80054,80054,99.00,0,0,0,0,0,n/a,0
80055,80055,99.00,90,26,116,0.7758620689655172,0.22413793103448276,Yes,0.7758620689655172
80056,80056,99.00,62,10,72,0.8611111111111112,0.1388888888888889,Yes,0.8611111111111112
80057,80057,99.00,0,0,0,0,0,n/a,0
80058,80058,99.00,69,17,86,0.8023255813953488,0.19767441860465115,Yes,0.8023255813953488
80059,80059,99.00,2,0,2,1.0,0.0,Yes,1.0
80060,80060,99.00,67,17,84,0.7976190476190477,0.20238095238095238,Yes,0.7976190476190477
80061,80061,99.00,0,0,0,0,0,n/a,0
80062,80062,99.00,2,1,3,0.6666666666666666,0.3333333333333333,Yes,0.6666666666666666
80063,80063,99.00,140,26,166,0.8433734939759037,0.1566265060240964,Yes,0.8433734939759037
80064,80064,99.00,1,0,1,1.0,0.0,Yes,1.0
80065,80065,99.00,124,11,135,0.9185185185185185,0.08148148148148149,Yes,0.9185185185185185
80066,80066,75.00,2,0,2,1.0,0.0,Yes,1.0
80067,80067,75.00,146,32,178,0.8202247191011236,0.1797752808988764,Yes,0.8202247191011236
80068,80068,75.00,4,0,4,1.0,0.0,Yes,1.0
80069,80069,75.00,1,0,1,1.0,0.0,Yes,1.0
80070,80070,99.00,1,0,1,1.0,0.0,Yes,1.0
80071,80071,99.00,143,42,185,0.772972972972973,0.22702702702702704,Yes,0.772972972972973
80072,80072,99.00,0,0,0,0,0,n/a,0
80073,80073,99.00,0,0,0,0,0,n/a,0
80074,80074,99.00,94,21,115,0.8173913043478261,0.1826086956521739,Yes,0.8173913043478261
80075,80075,99.00,0,0,0,0,0,n/a,0
80076,80076,99.00,62,9,71,0.8732394366197183,0.1267605633802817,Yes,0.8732394366197183
80077,80077,99.00,2,1,3,0.6666666666666666,0.3333333333333333,Yes,0.6666666666666666
80078,80078,99.00,167,33,200,0.835,0.165,Yes,0.835
80079,80079,99.00,3,0,3,1.0,0.0,Yes,1.0
80080,80080,99.00,86,17,103,0.8349514563106796,0.1650485436893204,Yes,0.8349514563106796
80081,80081,99.00,108,19,127,0.8503937007874016,0.14960629921259844,Yes,0.8503937007874016
80082,80082,83.33,2,0,2,1.0,0.0,Yes,1.0
80083,80083,99.00,172,37,209,0.8229665071770335,0.17703349282296652,Yes,0.8229665071770335
80084,80084,99.00,5,0,5,1.0,0.0,Yes,1.0
80085,80085,99.00,113,21,134,0.8432835820895522,0.15671641791044777,Yes,0.8432835820895522
80086,80086,99.00,0,0,0,0,0,n/a,0
80087,80087,99.00,0,0,0,0,0,n/a,0
80088,80088,99.00,0,0,0,0,0,n/a,0
80089,80089,33.33,0,0,0,0,0,n/a,0
80090,80090,99.00,0,0,0,0,0,n/a,0
80091,80091,99.00,0,0,0,0,0,n/a,0
80092,80092,99.00,0,0,0,0,0,n/a,0
80093,80093,99.00,0,0,0,0,0,n/a,0
80094,80094,99.00,93,14,107,0.8691588785046729,0.1308411214953271,Yes,0.8691588785046729
80095,80095,99.00,67,14,81,0.8271604938271605,0.1728395061728395,Yes,0.8271604938271605
81001,81001,99.00,4,0,4,1.0,0.0,Yes,1.0
81002,81002,99.00,115,24,139,0.8273381294964028,0.17266187050359713,Yes,0.8273381294964028
81003,81003,99.00,81,22,103,0.7864077669902912,0.21359223300970873,Yes,0.7864077669902912
81004,81004,99.00,0,1,1,0.0,1.0,No,1.0
81005,81005,99.00,3,0,3,1.0,0.0,Yes,1.0
81006,81006,99.00,100,28,128,0.78125,0.21875,Yes,0.78125
81007,81007,99.00,63,15,78,0.8076923076923077,0.19230769230769232,Yes,0.8076923076923077
81008,81008,99.00,68,15,83,0.8192771084337349,0.18072289156626506,Yes,0.8192771084337349
81009,81009,99.00,1,0,1,1.0,0.0,Yes,1.0
81010,81010,99.00,2,0,2,1.0,0.0,Yes,1.0
81011,81011,83.33,1,0,1,1.0,0.0,Yes,1.0
81012,81012,99.00,178,30,208,0.8557692307692307,0.14423076923076922,Yes,0.8557692307692307
81013,81013,99.00,1,0,1,1.0,0.0,Yes,1.0
81014,81014,99.00,218,47,265,0.8226415094339623,0.17735849056603772,Yes,0.8226415094339623
81015,81015,99.00,15,6,21,0.7142857142857143,0.2857142857142857,Yes,0.7142857142857143
81016,81016,99.00,0,0,0,0,0,n/a,0
81017,81017,83.33,123,15,138,0.8913043478260869,0.10869565217391304,Yes,0.8913043478260869
81018,81018,83.33,6,1,7,0.8571428571428571,0.14285714285714285,Yes,0.8571428571428571
81019,81019,83.33,91,15,106,0.8584905660377359,0.14150943396226415,Yes,0.8584905660377359
81020,81020,99.00,71,18,89,0.797752808988764,0.20224719101123595,Yes,0.797752808988764
81021,81021,99.00,145,15,160,0.90625,0.09375,Yes,0.90625
81022,81022,99.00,8,3,11,0.7272727272727273,0.2727272727272727,Yes,0.7272727272727273
81023,81023,99.00,176,34,210,0.8380952380952381,0.1619047619047619,Yes,0.8380952380952381
81024,81024,99.00,2,0,2,1.0,0.0,Yes,1.0
81025,81025,99.00,224,97,321,0.6978193146417445,0.30218068535825543,Yes,0.6978193146417445
81026,81026,99.00,3,0,3,1.0,0.0,Yes,1.0
81027,81027,99.00,0,1,1,0.0,1.0,No,1.0
81028,81028,99.00,88,22,110,0.8,0.2,Yes,0.8
81029,81029,99.00,2,0,2,1.0,0.0,Yes,1.0
81030,81030,99.00,229,93,322,0.7111801242236024,0.2888198757763975,Yes,0.7111801242236024
81031,81031,99.00,4,2,6,0.6666666666666666,0.3333333333333333,Yes,0.6666666666666666
81032,81032,99.00,5,1,6,0.8333333333333334,0.16666666666666666,Yes,0.8333333333333334
81033,81033,99.00,237,63,300,0.79,0.21,Yes,0.79
81034,81034,99.00,7,0,7,1.0,0.0,Yes,1.0
81035,81035,99.00,191,35,226,0.8451327433628318,0.15486725663716813,Yes,0.8451327433628318
81036,81036,99.00,7,3,10,0.7,0.3,Yes,0.7
81037,81037,99.00,110,14,124,0.8870967741935484,0.11290322580645161,Yes,0.8870967741935484
81038,81038,99.00,85,7,92,0.9239130434782609,0.07608695652173914,Yes,0.9239130434782609
81039,81039,50.00,3,0,3,1.0,0.0,Yes,1.0
81040,81040,50.00,138,36,174,0.7931034482758621,0.20689655172413793,Yes,0.7931034482758621
81041,81041,50.00,165,35,200,0.825,0.175,Yes,0.825
81042,81042,50.00,2,2,4,0.5,0.5,Tie,0.5
81043,81043,50.00,170,37,207,0.821256038647343,0.178743961352657,Yes,0.821256038647343
81044,81044,50.00,10,0,10,1.0,0.0,Yes,1.0
81045,81045,50.00,4,0,4,1.0,0.0,Yes,1.0
81046,81046,50.00,6,0,6,1.0,0.0,Yes,1.0
81047,81047,99.00,256,80,336,0.7619047619047619,0.23809523809523808,Yes,0.7619047619047619
81048,81048,99.00,190,41,231,0.8225108225108225,0.1774891774891775,Yes,0.8225108225108225
81049,81049,99.00,245,71,316,0.7753164556962026,0.22468354430379747,Yes,0.7753164556962026
81050,81050,99.00,17,5,22,0.7727272727272727,0.22727272727272727,Yes,0.7727272727272727
81051,81051,99.00,6,4,10,0.6,0.4,Yes,0.6
81052,81052,99.00,6,1,7,0.8571428571428571,0.14285714285714285,Yes,0.8571428571428571
81053,81053,99.00,145,56,201,0.7213930348258707,0.27860696517412936,Yes,0.7213930348258707
81054,81054,99.00,116,28,144,0.8055555555555556,0.19444444444444445,Yes,0.8055555555555556
81055,81055,99.00,22,8,30,0.7333333333333333,0.26666666666666666,Yes,0.7333333333333333
81056,81056,99.00,190,61,251,0.7569721115537849,0.24302788844621515,Yes,0.7569721115537849
81057,81057,99.00,7,3,10,0.7,0.3,Yes,0.7
81058,81058,99.00,175,47,222,0.7882882882882883,0.21171171171171171,Yes,0.7882882882882883
81059,81059,99.00,7,5,12,0.5833333333333334,0.4166666666666667,Yes,0.5833333333333334
81060,81060,99.00,251,96,347,0.723342939481268,0.276657060518732,Yes,0.723342939481268
81061,81061,99.00,2,3,5,0.4,0.6,No,0.6
81062,81062,99.00,10,0,10,1.0,0.0,Yes,1.0
81063,81063,99.00,10,1,11,0.9090909090909091,0.09090909090909091,Yes,0.9090909090909091
81064,81064,99.00,330,59,389,0.8483290488431876,0.15167095115681234,Yes,0.8483290488431876
81065,81065,99.00,236,111,347,0.6801152737752162,0.31988472622478387,Yes,0.6801152737752162
81066,81066,99.00,9,0,9,1.0,0.0,Yes,1.0
81067,81067,99.00,16,1,17,0.9411764705882353,0.058823529411764705,Yes,0.9411764705882353
81068,81068,99.00,305,97,402,0.7587064676616916,0.24129353233830847,Yes,0.7587064676616916
81069,81069,99.00,7,2,9,0.7777777777777778,0.2222222222222222,Yes,0.7777777777777778
81070,81070,99.00,1,2,3,0.3333333333333333,0.6666666666666666,No,0.6666666666666666
81071,81071,99.00,252,56,308,0.8181818181818182,0.18181818181818182,Yes,0.8181818181818182
81072,81072,99.00,20,5,25,0.8,0.2,Yes,0.8
81073,81073,99.00,293,126,419,0.6992840095465394,0.30071599045346065,Yes,0.6992840095465394
81074,81074,99.00,237,77,314,0.7547770700636943,0.24522292993630573,Yes,0.7547770700636943
81075,81075,99.00,10,5,15,0.6666666666666666,0.3333333333333333,Yes,0.6666666666666666
81076,81076,99.00,5,0,5,1.0,0.0,Yes,1.0
81077,81077,99.00,14,6,20,0.7,0.3,Yes,0.7
81078,81078,99.00,180,42,222,0.8108108108108109,0.1891891891891892,Yes,0.8108108108108109
81079,81079,99.00,8,8,16,0.5,0.5,Tie,0.5
81080,81080,99.00,124,62,186,0.6666666666666666,0.3333333333333333,Yes,0.6666666666666666
81081,81081,99.00,220,62,282,0.7801418439716312,0.2198581560283688,Yes,0.7801418439716312
81082,81082,99.00,3,2,5,0.6,0.4,Yes,0.6
81083,81083,99.00,280,58,338,0.8284023668639053,0.17159763313609466,Yes,0.8284023668639053
81084,81084,99.00,15,1,16,0.9375,0.0625,Yes,0.9375
81085,81085,99.00,289,126,415,0.6963855421686747,0.3036144578313253,Yes,0.6963855421686747
81086,81086,99.00,8,1,9,0.8888888888888888,0.1111111111111111,Yes,0.8888888888888888
81087,81087,50.00,230,66,296,0.777027027027027,0.22297297297297297,Yes,0.777027027027027
81088,81088,99.00,7,2,9,0.7777777777777778,0.2222222222222222,Yes,0.7777777777777778
81089,81089,50.00,4,1,5,0.8,0.2,Yes,0.8
81090,81090,50.00,13,1,14,0.9285714285714286,0.07142857142857142,Yes,0.9285714285714286
81091,81091,99.00,80,7,87,0.9195402298850575,0.08045977011494253,Yes,0.9195402298850575
81092,81092,99.00,85,22,107,0.794392523364486,0.205607476635514,Yes,0.794392523364486
81093,81093,99.00,3,0,3,1.0,0.0,Yes,1.0
81094,81094,99.00,76,23,99,0.7676767676767676,0.23232323232323232,Yes,0.7676767676767676
81095,81095,99.00,1,0,1,1.0,0.0,Yes,1.0
81096,81096,99.00,2,3,5,0.4,0.6,No,0.6
81097,81097,99.00,175,21,196,0.8928571428571429,0.10714285714285714,Yes,0.8928571428571429
81098,81098,99.00,2,1,3,0.6666666666666666,0.3333333333333333,Yes,0.6666666666666666
81099,81099,99.00,74,10,84,0.8809523809523809,0.11904761904761904,Yes,0.8809523809523809
81100,81100,99.00,67,11,78,0.8589743589743589,0.14102564102564102,Yes,0.8589743589743589
81101,81101,99.00,0,0,0,0,0,n/a,0
81102,81102,99.00,0,0,0,0,0,n/a,0
81103,81103,99.00,0,0,0,0,0,n/a,0
81104,81104,99.00,0,0,0,0,0,n/a,0
81105,81105,83.33,0,0,0,0,0,n/a,0
81106,81106,99.00,0,0,0,0,0,n/a,0
81107,81107,99.00,0,1,1,0.0,1.0,No,1.0
82001,82001,42.86,182,131,313,0.5814696485623003,0.4185303514376997,Yes,0.5814696485623003
82002,82002,42.86,19,7,26,0.7307692307692307,0.2692307692307692,Yes,0.7307692307692307
82003,82003,99.00,57,29,86,0.6627906976744186,0.3372093023255814,Yes,0.6627906976744186
82004,82004,99.00,10,3,13,0.7692307692307693,0.23076923076923078,Yes,0.7692307692307693
82005,82005,99.00,178,119,297,0.5993265993265994,0.4006734006734007,Yes,0.5993265993265994
82006,82006,42.86,143,61,204,0.7009803921568627,0.29901960784313725,Yes,0.7009803921568627
82007,82007,42.86,17,9,26,0.6538461538461539,0.34615384615384615,Yes,0.6538461538461539
82008,82008,99.00,106,25,131,0.8091603053435115,0.19083969465648856,Yes,0.8091603053435115
82009,82009,99.00,173,55,228,0.7587719298245614,0.2412280701754386,Yes,0.7587719298245614
82010,82010,99.00,11,2,13,0.8461538461538461,0.15384615384615385,Yes,0.8461538461538461
82011,82011,99.00,59,23,82,0.7195121951219512,0.2804878048780488,Yes,0.7195121951219512
82012,82012,99.00,69,13,82,0.8414634146341463,0.15853658536585366,Yes,0.8414634146341463
82013,82013,99.00,91,19,110,0.8272727272727273,0.17272727272727273,Yes,0.8272727272727273
82014,82014,99.00,0,0,0,0,0,n/a,0
82015,82015,99.00,4,1,5,0.8,0.2,Yes,0.8
82016,82016,99.00,150,54,204,0.7352941176470589,0.2647058823529412,Yes,0.7352941176470589
82017,82017,99.00,6,3,9,0.6666666666666666,0.3333333333333333,Yes,0.6666666666666666
82018,82018,99.00,80,27,107,0.7476635514018691,0.2523364485981308,Yes,0.7476635514018691
82019,82019,99.00,8,0,8,1.0,0.0,Yes,1.0
82020,82020,99.00,125,45,170,0.7352941176470589,0.2647058823529412,Yes,0.7352941176470589
82021,82021,99.00,127,52,179,0.7094972067039106,0.2905027932960894,Yes,0.7094972067039106
82022,82022,99.00,6,1,7,0.8571428571428571,0.14285714285714285,Yes,0.8571428571428571
82023,82023,0.00,4,0,4,1.0,0.0,Yes,1.0
82024,82024,99.00,74,15,89,0.8314606741573034,0.16853932584269662,Yes,0.8314606741573034
82025,82025,99.00,2,3,5,0.4,0.6,No,0.6
82026,82026,99.00,0,0,0,0,0,n/a,0
82027,82027,0.00,0,0,0,0,0,n/a,0
82028,82028,99.00,89,12,101,0.8811881188118812,0.1188118811881188,Yes,0.8811881188118812
82029,82029,99.00,0,0,0,0,0,n/a,0
82030,82030,99.00,167,28,195,0.8564102564102564,0.14358974358974358,Yes,0.8564102564102564
82031,82031,99.00,2,1,3,0.6666666666666666,0.3333333333333333,Yes,0.6666666666666666
82032,82032,99.00,150,46,196,0.7653061224489796,0.23469387755102042,Yes,0.7653061224489796
82033,82033,99.00,9,1,10,0.9,0.1,Yes,0.9
82034,82034,99.00,2,0,2,1.0,0.0,Yes,1.0
82035,82035,99.00,135,73,208,0.6490384615384616,0.35096153846153844,Yes,0.6490384615384616
82036,82036,99.00,94,35,129,0.7286821705426356,0.2713178294573643,Yes,0.7286821705426356
82037,82037,99.00,92,18,110,0.8363636363636363,0.16363636363636364,Yes,0.8363636363636363
82038,82038,99.00,152,50,202,0.7524752475247525,0.24752475247524752,Yes,0.7524752475247525
82039,82039,99.00,3,0,3,1.0,0.0,Yes,1.0
82040,82040,99.00,105,51,156,0.6730769230769231,0.3269230769230769,Yes,0.6730769230769231
82041,82041,99.00,150,87,237,0.6329113924050633,0.3670886075949367,Yes,0.6329113924050633
82042,82042,99.00,152,112,264,0.5757575757575758,0.42424242424242425,Yes,0.5757575757575758
82043,82043,99.00,7,3,10,0.7,0.3,Yes,0.7
82044,82044,99.00,6,3,9,0.6666666666666666,0.3333333333333333,Yes,0.6666666666666666
82045,82045,99.00,5,2,7,0.7142857142857143,0.2857142857142857,Yes,0.7142857142857143
82046,82046,99.00,3,0,3,1.0,0.0,Yes,1.0
82047,82047,50.00,49,35,84,0.5833333333333334,0.4166666666666667,Yes,0.5833333333333334
82048,82048,50.00,3,4,7,0.42857142857142855,0.5714285714285714,No,0.5714285714285714
82049,82049,50.00,43,23,66,0.6515151515151515,0.3484848484848485,Yes,0.6515151515151515
82050,82050,99.00,58,19,77,0.7532467532467533,0.24675324675324675,Yes,0.7532467532467533
82051,82051,99.00,150,38,188,0.7978723404255319,0.20212765957446807,Yes,0.7978723404255319
82052,82052,99.00,167,61,228,0.7324561403508771,0.2675438596491228,Yes,0.7324561403508771
82053,82053,99.00,5,0,5,1.0,0.0,Yes,1.0
82054,82054,75.00,0,0,0,0,0,n/a,0
82055,82055,99.00,0,0,0,0,0,n/a,0
82056,82056,99.00,51,18,69,0.7391304347826086,0.2608695652173913,Yes,0.7391304347826086
82057,82057,99.00,129,43,172,0.75,0.25,Yes,0.75
82058,82058,99.00,3,1,4,0.75,0.25,Yes,0.75
82059,82059,50.00,15,4,19,0.7894736842105263,0.21052631578947367,Yes,0.7894736842105263
82060,82060,66.67,156,50,206,0.7572815533980582,0.24271844660194175,Yes,0.7572815533980582
82061,82061,66.67,1,0,1,1.0,0.0,Yes,1.0
82062,82062,66.67,124,47,171,0.7251461988304093,0.27485380116959063,Yes,0.7251461988304093
82063,82063,66.67,2,0,2,1.0,0.0,Yes,1.0
82064,82064,99.00,122,17,139,0.8776978417266187,0.1223021582733813,Yes,0.8776978417266187
82065,82065,0.00,13,2,15,0.8666666666666667,0.13333333333333333,Yes,0.8666666666666667
82066,82066,99.00,279,47,326,0.8558282208588958,0.1441717791411043,Yes,0.8558282208588958
82067,82067,99.00,8,1,9,0.8888888888888888,0.1111111111111111,Yes,0.8888888888888888
82068,82068,99.00,14,2,16,0.875,0.125,Yes,0.875
82069,82069,99.00,294,47,341,0.8621700879765396,0.1378299120234604,Yes,0.8621700879765396
82070,82070,99.00,6,2,8,0.75,0.25,Yes,0.75
82071,82071,66.67,242,23,265,0.9132075471698113,0.08679245283018867,Yes,0.9132075471698113
82072,82072,66.67,4,1,5,0.8,0.2,Yes,0.8
82073,82073,66.67,7,0,7,1.0,0.0,Yes,1.0
82074,82074,66.67,180,29,209,0.861244019138756,0.13875598086124402,Yes,0.861244019138756
82075,82075,66.67,2,1,3,0.6666666666666666,0.3333333333333333,Yes,0.6666666666666666
82076,82076,66.67,6,1,7,0.8571428571428571,0.14285714285714285,Yes,0.8571428571428571
82077,82077,99.00,10,1,11,0.9090909090909091,0.09090909090909091,Yes,0.9090909090909091
82078,82078,0.00,9,3,12,0.75,0.25,Yes,0.75
82079,82079,0.00,11,4,15,0.7333333333333333,0.26666666666666666,Yes,0.7333333333333333
82080,82080,42.86,176,31,207,0.8502415458937198,0.1497584541062802,Yes,0.8502415458937198
82081,82081,42.86,20,2,22,0.9090909090909091,0.09090909090909091,Yes,0.9090909090909091
82082,82082,0.00,10,0,10,1.0,0.0,Yes,1.0
82083,82083,0.00,6,0,6,1.0,0.0,Yes,1.0
82084,82084,0.00,14,0,14,1.0,0.0,Yes,1.0
82085,82085,0.00,11,4,15,0.7333333333333333,0.26666666666666666,Yes,0.7333333333333333
82086,82086,0.00,14,2,16,0.875,0.125,Yes,0.875
82087,82087,0.00,9,2,11,0.8181818181818182,0.18181818181818182,Yes,0.8181818181818182
82088,82088,99.00,219,39,258,0.8488372093023255,0.1511627906976744,Yes,0.8488372093023255
82089,82089,0.00,24,3,27,0.8888888888888888,0.1111111111111111,Yes,0.8888888888888888
82090,82090,99.00,173,30,203,0.8522167487684729,0.1477832512315271,Yes,0.8522167487684729
82091,82091,99.00,2,0,2,1.0,0.0,Yes,1.0
82092,82092,99.00,229,58,287,0.7979094076655052,0.20209059233449478,Yes,0.7979094076655052
82093,82093,0.00,13,0,13,1.0,0.0,Yes,1.0
82094,82094,0.00,12,8,20,0.6,0.4,Yes,0.6
82095,82095,99.00,13,4,17,0.7647058823529411,0.23529411764705882,Yes,0.7647058823529411
82096,82096,99.00,6,0,6,1.0,0.0,Yes,1.0
82097,82097,99.00,12,4,16,0.75,0.25,Yes,0.75
82098,82098,99.00,241,42,283,0.8515901060070671,0.14840989399293286,Yes,0.8515901060070671
82099,82099,0.00,24,6,30,0.8,0.2,Yes,0.8
82100,82100,99.00,11,1,12,0.9166666666666666,0.08333333333333333,Yes,0.9166666666666666
82101,82101,0.00,27,7,34,0.7941176470588235,0.20588235294117646,Yes,0.7941176470588235
82102,82102,42.86,248,39,287,0.8641114982578397,0.13588850174216027,Yes,0.8641114982578397
82103,82103,42.86,24,2,26,0.9230769230769231,0.07692307692307693,Yes,0.9230769230769231
82104,82104,42.86,40,9,49,0.8163265306122449,0.1836734693877551,Yes,0.8163265306122449
82105,82105,0.00,20,5,25,0.8,0.2,Yes,0.8
82106,82106,0.00,0,0,0,0,0,n/a,0
82107,82107,99.00,1,0,1,1.0,0.0,Yes,1.0
82108,82108,99.00,0,0,0,0,0,n/a,0
82109,82109,0.00,2,1,3,0.6666666666666666,0.3333333333333333,Yes,0.6666666666666666
82110,82110,75.00,0,0,0,0,0,n/a,0
82111,82111,99.00,0,0,0,0,0,n/a,0
82112,82112,99.00,0,0,0,0,0,n/a,0
82113,82113,99.00,0,0,0,0,0,n/a,0
82114,82114,99.00,0,0,0,0,0,n/a,0
82115,82115,66.67,0,0,0,0,0,n/a,0
82116,82116,99.00,0,0,0,0,0,n/a,0
82117,82117,99.00,0,0,0,0,0,n/a,0
82118,82118,99.00,0,0,0,0,0,n/a,0
82119,82119,99.00,3,1,4,0.75,0.25,Yes,0.75
83001,83001,99.00,230,37,267,0.8614232209737828,0.13857677902621723,Yes,0.8614232209737828
83002,83002,99.00,0,0,0,0,0,n/a,0
83003,83003,99.00,0,1,1,0.0,1.0,No,1.0
83004,83004,99.00,147,37,184,0.7989130434782609,0.20108695652173914,Yes,0.7989130434782609
83005,83005,99.00,0,0,0,0,0,n/a,0
83006,83006,99.00,158,24,182,0.8681318681318682,0.13186813186813187,Yes,0.8681318681318682
83007,83007,99.00,6,3,9,0.6666666666666666,0.3333333333333333,Yes,0.6666666666666666
83008,83008,99.00,212,40,252,0.8412698412698413,0.15873015873015872,Yes,0.8412698412698413
83009,83009,99.00,1,1,2,0.5,0.5,Tie,0.5
83010,83010,99.00,222,41,263,0.844106463878327,0.155893536121673,Yes,0.844106463878327
83011,83011,99.00,140,18,158,0.8860759493670886,0.11392405063291139,Yes,0.8860759493670886
83012,83012,99.00,0,0,0,0,0,n/a,0
83013,83013,99.00,119,28,147,0.8095238095238095,0.19047619047619047,Yes,0.8095238095238095
83014,83014,99.00,1,0,1,1.0,0.0,Yes,1.0
83015,83015,99.00,6,2,8,0.75,0.25,Yes,0.75
83016,83016,99.00,180,24,204,0.8823529411764706,0.11764705882352941,Yes,0.8823529411764706
83017,83017,99.00,160,22,182,0.8791208791208791,0.12087912087912088,Yes,0.8791208791208791
83018,83018,99.00,1,0,1,1.0,0.0,Yes,1.0
83019,83019,99.00,4,0,4,1.0,0.0,Yes,1.0
83020,83020,99.00,1,2,3,0.3333333333333333,0.6666666666666666,No,0.6666666666666666
83021,83021,99.00,151,32,183,0.825136612021858,0.17486338797814208,Yes,0.825136612021858
83022,83022,99.00,0,0,0,0,0,n/a,0
83023,83023,99.00,85,23,108,0.7870370370370371,0.21296296296296297,Yes,0.7870370370370371
83024,83024,99.00,2,0,2,1.0,0.0,Yes,1.0
83025,83025,99.00,159,20,179,0.888268156424581,0.11173184357541899,Yes,0.888268156424581
83026,83026,99.00,0,1,1,0.0,1.0,No,1.0
83027,83027,99.00,154,23,177,0.8700564971751412,0.12994350282485875,Yes,0.8700564971751412
83028,83028,99.00,101,12,113,0.8938053097345132,0.10619469026548672,Yes,0.8938053097345132
83029,83029,99.00,142,23,165,0.8606060606060606,0.1393939393939394,Yes,0.8606060606060606
83030,83030,99.00,5,4,9,0.5555555555555556,0.4444444444444444,Yes,0.5555555555555556
83031,83031,99.00,120,22,142,0.8450704225352113,0.15492957746478872,Yes,0.8450704225352113
83032,83032,83.33,132,24,156,0.8461538461538461,0.15384615384615385,Yes,0.8461538461538461
83033,83033,99.00,216,44,260,0.8307692307692308,0.16923076923076924,Yes,0.8307692307692308
83034,83034,99.00,1,0,1,1.0,0.0,Yes,1.0
83035,83035,99.00,99,16,115,0.8608695652173913,0.1391304347826087,Yes,0.8608695652173913
83036,83036,99.00,3,1,4,0.75,0.25,Yes,0.75
83037,83037,83.33,3,1,4,0.75,0.25,Yes,0.75
83038,83038,83.33,65,17,82,0.7926829268292683,0.2073170731707317,Yes,0.7926829268292683
83039,83039,83.33,130,23,153,0.8496732026143791,0.1503267973856209,Yes,0.8496732026143791
83040,83040,83.33,0,0,0,0,0,n/a,0
83041,83041,99.00,6,0,6,1.0,0.0,Yes,1.0
83042,83042,83.33,109,12,121,0.9008264462809917,0.09917355371900827,Yes,0.9008264462809917
83043,83043,83.33,2,0,2,1.0,0.0,Yes,1.0
83044,83044,83.33,111,12,123,0.9024390243902439,0.0975609756097561,Yes,0.9024390243902439
83045,83045,99.00,126,21,147,0.8571428571428571,0.14285714285714285,Yes,0.8571428571428571
83046,83046,99.00,77,18,95,0.8105263157894737,0.18947368421052632,Yes,0.8105263157894737
83047,83047,83.33,82,13,95,0.8631578947368421,0.1368421052631579,Yes,0.8631578947368421
83048,83048,83.33,3,0,3,1.0,0.0,Yes,1.0
83049,83049,99.00,3,0,3,1.0,0.0,Yes,1.0
83050,83050,83.33,113,15,128,0.8828125,0.1171875,Yes,0.8828125
83051,83051,83.33,64,15,79,0.810126582278481,0.189873417721519,Yes,0.810126582278481
83052,83052,83.33,5,0,5,1.0,0.0,Yes,1.0
83053,83053,83.33,6,0,6,1.0,0.0,Yes,1.0
83054,83054,83.33,5,1,6,0.8333333333333334,0.16666666666666666,Yes,0.8333333333333334
83055,83055,99.00,122,28,150,0.8133333333333334,0.18666666666666668,Yes,0.8133333333333334
83056,83056,99.00,2,4,6,0.3333333333333333,0.6666666666666666,No,0.6666666666666666
83057,83057,99.00,168,34,202,0.8316831683168316,0.16831683168316833,Yes,0.8316831683168316
83058,83058,99.00,92,19,111,0.8288288288288288,0.17117117117117117,Yes,0.8288288288288288
83059,83059,99.00,63,15,78,0.8076923076923077,0.19230769230769232,Yes,0.8076923076923077
83060,83060,99.00,0,0,0,0,0,n/a,0
83061,83061,99.00,1,0,1,1.0,0.0,Yes,1.0
83062,83062,99.00,1,0,1,1.0,0.0,Yes,1.0
83063,83063,99.00,89,23,112,0.7946428571428571,0.20535714285714285,Yes,0.7946428571428571
83064,83064,99.00,184,24,208,0.8846153846153846,0.11538461538461539,Yes,0.8846153846153846
83065,83065,99.00,4,0,4,1.0,0.0,Yes,1.0
83066,83066,99.00,175,17,192,0.9114583333333334,0.08854166666666667,Yes,0.9114583333333334
83067,83067,99.00,125,37,162,0.7716049382716049,0.22839506172839505,Yes,0.7716049382716049
83068,83068,99.00,0,0,0,0,0,n/a,0
83069,83069,99.00,163,39,202,0.806930693069307,0.19306930693069307,Yes,0.806930693069307
83070,83070,99.00,110,20,130,0.8461538461538461,0.15384615384615385,Yes,0.8461538461538461
83071,83071,99.00,8,1,9,0.8888888888888888,0.1111111111111111,Yes,0.8888888888888888
83072,83072,99.00,138,21,159,0.8679245283018868,0.1320754716981132,Yes,0.8679245283018868
83073,83073,99.00,2,1,3,0.6666666666666666,0.3333333333333333,Yes,0.6666666666666666
83074,83074,99.00,184,28,212,0.8679245283018868,0.1320754716981132,Yes,0.8679245283018868
83075,83075,99.00,4,0,4,1.0,0.0,Yes,1.0
83076,83076,99.00,3,0,3,1.0,0.0,Yes,1.0
83077,83077,99.00,169,24,193,0.8756476683937824,0.12435233160621761,Yes,0.8756476683937824
83078,83078,99.00,133,24,157,0.8471337579617835,0.15286624203821655,Yes,0.8471337579617835
83079,83079,99.00,106,12,118,0.8983050847457628,0.1016949152542373,Yes,0.8983050847457628
83080,83080,99.00,5,1,6,0.8333333333333334,0.16666666666666666,Yes,0.8333333333333334
83081,83081,99.00,4,1,5,0.8,0.2,Yes,0.8
83082,83082,99.00,129,19,148,0.8716216216216216,0.12837837837837837,Yes,0.8716216216216216
83083,83083,99.00,9,1,10,0.9,0.1,Yes,0.9
83084,83084,99.00,22,1,23,0.9565217391304348,0.043478260869565216,Yes,0.9565217391304348
83085,83085,99.00,1,0,1,1.0,0.0,Yes,1.0
83086,83086,99.00,0,0,0,0,0,n/a,0
83087,83087,99.00,0,0,0,0,0,n/a,0
83088,83088,99.00,3,0,3,1.0,0.0,Yes,1.0
83089,83089,99.00,1,0,1,1.0,0.0,Yes,1.0
84001,84001,99.00,53,9,62,0.8548387096774194,0.14516129032258066,Yes,0.8548387096774194
84002,84002,99.00,141,16,157,0.8980891719745223,0.10191082802547771,Yes,0.8980891719745223
84003,84003,99.00,62,9,71,0.8732394366197183,0.1267605633802817,Yes,0.8732394366197183
84004,84004,99.00,114,20,134,0.8507462686567164,0.14925373134328357,Yes,0.8507462686567164
84005,84005,99.00,1,0,1,1.0,0.0,Yes,1.0
84006,84006,99.00,130,16,146,0.8904109589041096,0.1095890410958904,Yes,0.8904109589041096
84007,84007,99.00,72,6,78,0.9230769230769231,0.07692307692307693,Yes,0.9230769230769231
84008,84008,99.00,3,0,3,1.0,0.0,Yes,1.0
84009,84009,55.56,9,3,12,0.75,0.25,Yes,0.75
84010,84010,55.56,159,15,174,0.9137931034482759,0.08620689655172414,Yes,0.9137931034482759
84011,84011,99.00,106,28,134,0.7910447761194029,0.208955223880597,Yes,0.7910447761194029
84012,84012,99.00,4,1,5,0.8,0.2,Yes,0.8
84013,84013,99.00,61,6,67,0.9104477611940298,0.08955223880597014,Yes,0.9104477611940298
84014,84014,55.56,13,3,16,0.8125,0.1875,Yes,0.8125
84015,84015,55.56,121,25,146,0.8287671232876712,0.17123287671232876,Yes,0.8287671232876712
84016,84016,99.00,7,1,8,0.875,0.125,Yes,0.875
84017,84017,99.00,3,1,4,0.75,0.25,Yes,0.75
84018,84018,99.00,83,12,95,0.8736842105263158,0.12631578947368421,Yes,0.8736842105263158
84019,84019,83.33,150,19,169,0.8875739644970414,0.11242603550295859,Yes,0.8875739644970414
84020,84020,83.33,2,0,2,1.0,0.0,Yes,1.0
84021,84021,83.33,1,0,1,1.0,0.0,Yes,1.0
84022,84022,99.00,1,0,1,1.0,0.0,Yes,1.0
84023,84023,83.33,101,17,118,0.8559322033898306,0.1440677966101695,Yes,0.8559322033898306
84024,84024,83.33,126,24,150,0.84,0.16,Yes,0.84
84025,84025,83.33,0,0,0,0,0,n/a,0
84026,84026,83.33,0,0,0,0,0,n/a,0
84027,84027,99.00,114,14,128,0.890625,0.109375,Yes,0.890625
84028,84028,99.00,1,0,1,1.0,0.0,Yes,1.0
84029,84029,99.00,1,0,1,1.0,0.0,Yes,1.0
84030,84030,99.00,55,15,70,0.7857142857142857,0.21428571428571427,Yes,0.7857142857142857
84031,84031,99.00,1,0,1,1.0,0.0,Yes,1.0
84032,84032,99.00,51,16,67,0.7611940298507462,0.23880597014925373,Yes,0.7611940298507462
84033,84033,99.00,0,0,0,0,0,n/a,0
84034,84034,99.00,2,2,4,0.5,0.5,Tie,0.5
84035,84035,99.00,112,31,143,0.7832167832167832,0.21678321678321677,Yes,0.7832167832167832
84036,84036,99.00,1,0,1,1.0,0.0,Yes,1.0
84037,84037,99.00,0,0,0,0,0,n/a,0
84038,84038,99.00,54,11,65,0.8307692307692308,0.16923076923076924,Yes,0.8307692307692308
84039,84039,99.00,83,16,99,0.8383838383838383,0.16161616161616163,Yes,0.8383838383838383
84040,84040,99.00,66,14,80,0.825,0.175,Yes,0.825
84041,84041,99.00,91,23,114,0.7982456140350878,0.20175438596491227,Yes,0.7982456140350878
84042,84042,99.00,65,10,75,0.8666666666666667,0.13333333333333333,Yes,0.8666666666666667
84043,84043,99.00,115,22,137,0.8394160583941606,0.16058394160583941,Yes,0.8394160583941606
84044,84044,99.00,0,0,0,0,0,n/a,0
84045,84045,99.00,63,9,72,0.875,0.125,Yes,0.875
84046,84046,99.00,2,0,2,1.0,0.0,Yes,1.0
84047,84047,99.00,18,5,23,0.782608695652174,0.21739130434782608,Yes,0.782608695652174
84048,84048,99.00,66,11,77,0.8571428571428571,0.14285714285714285,Yes,0.8571428571428571
84049,84049,99.00,90,22,112,0.8035714285714286,0.19642857142857142,Yes,0.8035714285714286
84050,84050,99.00,96,22,118,0.8135593220338984,0.1864406779661017,Yes,0.8135593220338984
84051,84051,99.00,0,0,0,0,0,n/a,0
84052,84052,99.00,0,1,1,0.0,1.0,No,1.0
84053,84053,99.00,65,13,78,0.8333333333333334,0.16666666666666666,Yes,0.8333333333333334
84054,84054,99.00,0,0,0,0,0,n/a,0
84055,84055,99.00,34,10,44,0.7727272727272727,0.22727272727272727,Yes,0.7727272727272727
84056,84056,99.00,46,7,53,0.8679245283018868,0.1320754716981132,Yes,0.8679245283018868
84057,84057,99.00,60,10,70,0.8571428571428571,0.14285714285714285,Yes,0.8571428571428571
84058,84058,99.00,109,44,153,0.7124183006535948,0.2875816993464052,Yes,0.7124183006535948
84059,84059,99.00,1,0,1,1.0,0.0,Yes,1.0
84060,84060,83.33,37,13,50,0.74,0.26,Yes,0.74
84061,84061,99.00,52,9,61,0.8524590163934426,0.14754098360655737,Yes,0.8524590163934426
84062,84062,99.00,86,22,108,0.7962962962962963,0.2037037037037037,Yes,0.7962962962962963
84063,84063,99.00,0,0,0,0,0,n/a,0
84064,84064,99.00,51,15,66,0.7727272727272727,0.22727272727272727,Yes,0.7727272727272727
84065,84065,99.00,65,25,90,0.7222222222222222,0.2777777777777778,Yes,0.7222222222222222
84066,84066,99.00,3,0,3,1.0,0.0,Yes,1.0
84067,84067,99.00,70,24,94,0.7446808510638298,0.2553191489361702,Yes,0.7446808510638298
84068,84068,99.00,0,0,0,0,0,n/a,0
84069,84069,99.00,0,1,1,0.0,1.0,No,1.0
84070,84070,99.00,1,0,1,1.0,0.0,Yes,1.0
84071,84071,99.00,97,15,112,0.8660714285714286,0.13392857142857142,Yes,0.8660714285714286
84072,84072,99.00,70,19,89,0.7865168539325843,0.21348314606741572,Yes,0.7865168539325843
84073,84073,99.00,0,0,0,0,0,n/a,0
84074,84074,99.00,92,16,108,0.8518518518518519,0.14814814814814814,Yes,0.8518518518518519
84075,84075,66.67,54,8,62,0.8709677419354839,0.12903225806451613,Yes,0.8709677419354839
84076,84076,99.00,0,0,0,0,0,n/a,0
84077,84077,99.00,1,0,1,1.0,0.0,Yes,1.0
84078,84078,99.00,0,0,0,0,0,n/a,0
84079,84079,99.00,0,0,0,0,0,n/a,0
84080,84080,55.56,29,2,31,0.9354838709677419,0.06451612903225806,Yes,0.9354838709677419
84081,84081,99.00,0,0,0,0,0,n/a,0
84082,84082,99.00,1,0,1,1.0,0.0,Yes,1.0
84083,84083,99.00,1,0,1,1.0,0.0,Yes,1.0
84084,84084,99.00,2,0,2,1.0,0.0,Yes,1.0
84085,84085,99.00,94,10,104,0.9038461538461539,0.09615384615384616,Yes,0.9038461538461539
85001,85001,99.00,135,21,156,0.8653846153846154,0.1346153846153846,Yes,0.8653846153846154
85002,85002,99.00,185,32,217,0.8525345622119815,0.14746543778801843,Yes,0.8525345622119815
85003,85003,99.00,9,2,11,0.8181818181818182,0.18181818181818182,Yes,0.8181818181818182
85004,85004,37.50,118,18,136,0.8676470588235294,0.1323529411764706,Yes,0.8676470588235294
85005,85005,37.50,81,8,89,0.9101123595505618,0.0898876404494382,Yes,0.9101123595505618
85006,85006,37.50,3,3,6,0.5,0.5,Tie,0.5
85007,85007,99.00,116,21,137,0.8467153284671532,0.15328467153284672,Yes,0.8467153284671532
85008,85008,99.00,84,22,106,0.7924528301886793,0.20754716981132076,Yes,0.7924528301886793
85009,85009,99.00,69,4,73,0.9452054794520548,0.0547945205479452,Yes,0.9452054794520548
85010,85010,99.00,9,1,10,0.9,0.1,Yes,0.9
85011,85011,99.00,131,20,151,0.8675496688741722,0.13245033112582782,Yes,0.8675496688741722
85012,85012,99.00,5,1,6,0.8333333333333334,0.16666666666666666,Yes,0.8333333333333334
85013,85013,99.00,250,49,299,0.8361204013377926,0.16387959866220736,Yes,0.8361204013377926
85014,85014,99.00,2,0,2,1.0,0.0,Yes,1.0
85015,85015,99.00,83,8,91,0.9120879120879121,0.08791208791208792,Yes,0.9120879120879121
85016,85016,99.00,43,16,59,0.7288135593220338,0.2711864406779661,Yes,0.7288135593220338
85017,85017,99.00,0,0,0,0,0,n/a,0
85018,85018,99.00,0,0,0,0,0,n/a,0
85019,85019,99.00,12,2,14,0.8571428571428571,0.14285714285714285,Yes,0.8571428571428571
85020,85020,99.00,112,17,129,0.8682170542635659,0.13178294573643412,Yes,0.8682170542635659
85021,85021,99.00,167,30,197,0.8477157360406091,0.15228426395939088,Yes,0.8477157360406091
85022,85022,99.00,41,6,47,0.8723404255319149,0.1276595744680851,Yes,0.8723404255319149
85023,85023,99.00,153,35,188,0.8138297872340425,0.18617021276595744,Yes,0.8138297872340425
85024,85024,99.00,3,0,3,1.0,0.0,Yes,1.0
85025,85025,99.00,143,23,166,0.8614457831325302,0.13855421686746988,Yes,0.8614457831325302
85026,85026,99.00,3,1,4,0.75,0.25,Yes,0.75
85027,85027,99.00,150,33,183,0.819672131147541,0.18032786885245902,Yes,0.819672131147541
85028,85028,99.00,56,14,70,0.8,0.2,Yes,0.8
85029,85029,99.00,1,0,1,1.0,0.0,Yes,1.0
85030,85030,99.00,120,17,137,0.8759124087591241,0.12408759124087591,Yes,0.8759124087591241
85031,85031,99.00,1,0,1,1.0,0.0,Yes,1.0
85032,85032,75.00,20,3,23,0.8695652173913043,0.13043478260869565,Yes,0.8695652173913043
85033,85033,50.00,46,11,57,0.8070175438596491,0.19298245614035087,Yes,0.8070175438596491
85034,85034,99.00,102,18,120,0.85,0.15,Yes,0.85
85035,85035,99.00,0,0,0,0,0,n/a,0
85036,85036,99.00,1,0,1,1.0,0.0,Yes,1.0
85037,85037,99.00,3,0,3,1.0,0.0,Yes,1.0
85038,85038,66.67,0,0,0,0,0,n/a,0
85039,85039,66.67,53,9,62,0.8548387096774194,0.14516129032258066,Yes,0.8548387096774194
85040,85040,66.67,2,0,2,1.0,0.0,Yes,1.0
85041,85041,99.00,2,0,2,1.0,0.0,Yes,1.0
85042,85042,99.00,0,0,0,0,0,n/a,0
85043,85043,99.00,73,12,85,0.8588235294117647,0.1411764705882353,Yes,0.8588235294117647
85044,85044,99.00,2,1,3,0.6666666666666666,0.3333333333333333,Yes,0.6666666666666666
85045,85045,99.00,108,19,127,0.8503937007874016,0.14960629921259844,Yes,0.8503937007874016
85046,85046,99.00,81,26,107,0.7570093457943925,0.24299065420560748,Yes,0.7570093457943925
85047,85047,99.00,0,0,0,0,0,n/a,0
85048,85048,99.00,56,6,62,0.9032258064516129,0.0967741935483871,Yes,0.9032258064516129
85049,85049,99.00,74,10,84,0.8809523809523809,0.11904761904761904,Yes,0.8809523809523809
85050,85050,99.00,126,17,143,0.8811188811188811,0.11888111888111888,Yes,0.8811188811188811
85051,85051,99.00,1,0,1,1.0,0.0,Yes,1.0
85052,85052,99.00,102,24,126,0.8095238095238095,0.19047619047619047,Yes,0.8095238095238095
85053,85053,66.67,44,4,48,0.9166666666666666,0.08333333333333333,Yes,0.9166666666666666
85054,85054,66.67,52,6,58,0.896551724137931,0.10344827586206896,Yes,0.896551724137931
85055,85055,66.67,37,11,48,0.7708333333333334,0.22916666666666666,Yes,0.7708333333333334
85056,85056,99.00,126,20,146,0.863013698630137,0.136986301369863,Yes,0.863013698630137
85057,85057,99.00,1,1,2,0.5,0.5,Tie,0.5
85058,85058,99.00,122,25,147,0.8299319727891157,0.17006802721088435,Yes,0.8299319727891157
85059,85059,99.00,2,0,2,1.0,0.0,Yes,1.0
85060,85060,99.00,1,0,1,1.0,0.0,Yes,1.0
85061,85061,99.00,2,0,2,1.0,0.0,Yes,1.0
85062,85062,99.00,119,17,136,0.875,0.125,Yes,0.875
85063,85063,99.00,6,0,6,1.0,0.0,Yes,1.0
85064,85064,99.00,83,15,98,0.8469387755102041,0.15306122448979592,Yes,0.8469387755102041
85065,85065,99.00,3,1,4,0.75,0.25,Yes,0.75
85066,85066,99.00,87,20,107,0.8130841121495327,0.18691588785046728,Yes,0.8130841121495327
85067,85067,99.00,101,20,121,0.8347107438016529,0.1652892561983471,Yes,0.8347107438016529
85068,85068,99.00,14,3,17,0.8235294117647058,0.17647058823529413,Yes,0.8235294117647058
85069,85069,99.00,74,6,80,0.925,0.075,Yes,0.925
85070,85070,99.00,104,15,119,0.8739495798319328,0.12605042016806722,Yes,0.8739495798319328
85071,85071,99.00,0,0,0,0,0,n/a,0
85072,85072,99.00,0,0,0,0,0,n/a,0
85073,85073,99.00,0,0,0,0,0,n/a,0
85074,85074,99.00,0,0,0,0,0,n/a,0
85075,85075,99.00,0,0,0,0,0,n/a,0
85076,85076,99.00,0,0,0,0,0,n/a,0
85077,85077,99.00,0,0,0,0,0,n/a,0
85078,85078,99.00,0,0,0,0,0,n/a,0
85079,85079,99.00,0,0,0,0,0,n/a,0
85080,85080,99.00,87,5,92,0.9456521739130435,0.05434782608695652,Yes,0.9456521739130435
85081,85081,99.00,0,0,0,0,0,n/a,0
85082,85082,99.00,0,0,0,0,0,n/a,0
85083,85083,75.00,1,0,1,1.0,0.0,Yes,1.0
85084,85084,99.00,2,0,2,1.0,0.0,Yes,1.0
85085,85085,99.00,1,0,1,1.0,0.0,Yes,1.0
86001,86001,99.00,0,0,0,0,0,n/a,0
86002,86002,99.00,133,22,155,0.8580645161290322,0.14193548387096774,Yes,0.8580645161290322
86003,86003,99.00,1,1,2,0.5,0.5,Tie,0.5
86004,86004,99.00,109,14,123,0.8861788617886179,0.11382113821138211,Yes,0.8861788617886179
86005,86005,0.00,0,0,0,0,0,n/a,0
86006,86006,0.00,1,0,1,1.0,0.0,Yes,1.0
86007,86007,0.00,1,0,1,1.0,0.0,Yes,1.0
86008,86008,99.00,88,16,104,0.8461538461538461,0.15384615384615385,Yes,0.8461538461538461
86009,86009,99.00,77,9,86,0.8953488372093024,0.10465116279069768,Yes,0.8953488372093024
86010,86010,99.00,0,0,0,0,0,n/a,0
86011,86011,80.00,81,13,94,0.8617021276595744,0.13829787234042554,Yes,0.8617021276595744
86012,86012,99.00,71,16,87,0.8160919540229885,0.1839080459770115,Yes,0.8160919540229885
86013,86013,80.00,2,0,2,1.0,0.0,Yes,1.0
86014,86014,80.00,91,10,101,0.900990099009901,0.09900990099009901,Yes,0.900990099009901
86015,86015,99.00,5,1,6,0.8333333333333334,0.16666666666666666,Yes,0.8333333333333334
86016,86016,80.00,0,0,0,0,0,n/a,0
86017,86017,80.00,2,0,2,1.0,0.0,Yes,1.0
86018,86018,99.00,60,17,77,0.7792207792207793,0.22077922077922077,Yes,0.7792207792207793
86019,86019,99.00,96,13,109,0.8807339449541285,0.11926605504587157,Yes,0.8807339449541285
86020,86020,99.00,52,7,59,0.8813559322033898,0.11864406779661017,Yes,0.8813559322033898
86021,86021,0.00,0,0,0,0,0,n/a,0
86022,86022,99.00,85,18,103,0.8252427184466019,0.17475728155339806,Yes,0.8252427184466019
86023,86023,99.00,2,1,3,0.6666666666666666,0.3333333333333333,Yes,0.6666666666666666
86024,86024,99.00,4,0,4,1.0,0.0,Yes,1.0
86025,86025,99.00,73,14,87,0.8390804597701149,0.16091954022988506,Yes,0.8390804597701149
86026,86026,99.00,86,15,101,0.8514851485148515,0.1485148514851485,Yes,0.8514851485148515
86027,86027,99.00,0,0,0,0,0,n/a,0
86028,86028,0.00,2,0,2,1.0,0.0,Yes,1.0
86029,86029,0.00,0,0,0,0,0,n/a,0
86030,86030,0.00,0,0,0,0,0,n/a,0
86031,86031,99.00,1,0,1,1.0,0.0,Yes,1.0
86032,86032,99.00,77,19,96,0.8020833333333334,0.19791666666666666,Yes,0.8020833333333334
86033,86033,99.00,148,21,169,0.8757396449704142,0.1242603550295858,Yes,0.8757396449704142
86034,86034,99.00,2,0,2,1.0,0.0,Yes,1.0
86035,86035,99.00,0,0,0,0,0,n/a,0
86036,86036,99.00,116,12,128,0.90625,0.09375,Yes,0.90625
86037,86037,99.00,1,0,1,1.0,0.0,Yes,1.0
86038,86038,99.00,84,12,96,0.875,0.125,Yes,0.875
86039,86039,99.00,2,0,2,1.0,0.0,Yes,1.0
86040,86040,99.00,115,28,143,0.8041958041958042,0.1958041958041958,Yes,0.8041958041958042
86041,86041,99.00,1,0,1,1.0,0.0,Yes,1.0
86042,86042,99.00,0,0,0,0,0,n/a,0
86043,86043,99.00,0,0,0,0,0,n/a,0
86044,86044,99.00,1,0,1,1.0,0.0,Yes,1.0
86045,86045,99.00,81,13,94,0.8617021276595744,0.13829787234042554,Yes,0.8617021276595744
86046,86046,0.00,0,0,0,0,0,n/a,0
86047,86047,99.00,68,12,80,0.85,0.15,Yes,0.85
86048,86048,0.00,1,0,1,1.0,0.0,Yes,1.0
86049,86049,99.00,2,0,2,1.0,0.0,Yes,1.0
86050,86050,99.00,69,11,80,0.8625,0.1375,Yes,0.8625
86051,86051,99.00,1,0,1,1.0,0.0,Yes,1.0
86052,86052,99.00,68,9,77,0.8831168831168831,0.11688311688311688,Yes,0.8831168831168831
86053,86053,99.00,2,0,2,1.0,0.0,Yes,1.0
86054,86054,99.00,2,0,2,1.0,0.0,Yes,1.0
86055,86055,99.00,80,8,88,0.9090909090909091,0.09090909090909091,Yes,0.9090909090909091
86056,86056,99.00,63,11,74,0.8513513513513513,0.14864864864864866,Yes,0.8513513513513513
86057,86057,99.00,75,9,84,0.8928571428571429,0.10714285714285714,Yes,0.8928571428571429
86058,86058,99.00,5,0,5,1.0,0.0,Yes,1.0
86059,86059,0.00,1,1,2,0.5,0.5,Tie,0.5
86060,86060,99.00,0,0,0,0,0,n/a,0
86061,86061,99.00,2,1,3,0.6666666666666666,0.3333333333333333,Yes,0.6666666666666666
86062,86062,99.00,3,0,3,1.0,0.0,Yes,1.0
86063,86063,99.00,73,12,85,0.8588235294117647,0.1411764705882353,Yes,0.8588235294117647
86064,86064,99.00,73,9,82,0.8902439024390244,0.10975609756097561,Yes,0.8902439024390244
86065,86065,99.00,2,0,2,1.0,0.0,Yes,1.0
86066,86066,80.00,115,13,128,0.8984375,0.1015625,Yes,0.8984375
86067,86067,99.00,0,0,0,0,0,n/a,0
86068,86068,99.00,0,1,1,0.0,1.0,No,1.0
86069,86069,99.00,1,1,2,0.5,0.5,Tie,0.5
86070,86070,99.00,0,0,0,0,0,n/a,0
86071,86071,99.00,1,0,1,1.0,0.0,Yes,1.0
86072,86072,99.00,1,0,1,1.0,0.0,Yes,1.0
87001,87001,0.00,0,0,0,0,0,n/a,0
87002,87002,0.00,0,0,0,0,0,n/a,0
87003,87003,0.00,0,1,1,0.0,1.0,No,1.0
87004,87004,0.00,1,0,1,1.0,0.0,Yes,1.0
87005,87005,0.00,0,0,0,0,0,n/a,0
87006,87006,0.00,1,0,1,1.0,0.0,Yes,1.0
87007,87007,0.00,1,0,1,1.0,0.0,Yes,1.0
87008,87008,0.00,3,0,3,1.0,0.0,Yes,1.0
87009,87009,0.00,0,0,0,0,0,n/a,0
87010,87010,0.00,3,0,3,1.0,0.0,Yes,1.0
87011,87011,0.00,2,0,2,1.0,0.0,Yes,1.0
87012,87012,0.00,0,0,0,0,0,n/a,0
87013,87013,0.00,0,0,0,0,0,n/a,0
87014,87014,0.00,1,0,1,1.0,0.0,Yes,1.0
87015,87015,0.00,1,0,1,1.0,0.0,Yes,1.0
87016,87016,0.00,1,0,1,1.0,0.0,Yes,1.0
87017,87017,99.00,0,0,0,0,0,n/a,0
87018,87018,99.00,2,0,2,1.0,0.0,Yes,1.0
87019,87019,99.00,111,18,129,0.8604651162790697,0.13953488372093023,Yes,0.8604651162790697
87020,87020,99.00,1,0,1,1.0,0.0,Yes,1.0
87021,87021,0.00,0,0,0,0,0,n/a,0
87022,87022,99.00,133,19,152,0.875,0.125,Yes,0.875
87023,87023,99.00,0,2,2,0.0,1.0,No,1.0
87024,87024,75.00,0,0,0,0,0,n/a,0
87025,87025,99.00,2,0,2,1.0,0.0,Yes,1.0
87026,87026,99.00,105,13,118,0.8898305084745762,0.11016949152542373,Yes,0.8898305084745762
87027,87027,99.00,1,0,1,1.0,0.0,Yes,1.0
87028,87028,99.00,98,14,112,0.875,0.125,Yes,0.875
87029,87029,99.00,151,21,172,0.877906976744186,0.12209302325581395,Yes,0.877906976744186
87030,87030,99.00,108,19,127,0.8503937007874016,0.14960629921259844,Yes,0.8503937007874016
87031,87031,99.00,3,1,4,0.75,0.25,Yes,0.75
87032,87032,99.00,39,17,56,0.6964285714285714,0.30357142857142855,Yes,0.6964285714285714
87033,87033,75.00,98,20,118,0.8305084745762712,0.1694915254237288,Yes,0.8305084745762712
87034,87034,75.00,3,0,3,1.0,0.0,Yes,1.0
87035,87035,75.00,108,15,123,0.8780487804878049,0.12195121951219512,Yes,0.8780487804878049
87036,87036,75.00,0,1,1,0.0,1.0,No,1.0
87037,87037,99.00,84,36,120,0.7,0.3,Yes,0.7
87038,87038,99.00,0,0,0,0,0,n/a,0
87039,87039,99.00,73,20,93,0.7849462365591398,0.21505376344086022,Yes,0.7849462365591398
87040,87040,66.67,95,34,129,0.7364341085271318,0.26356589147286824,Yes,0.7364341085271318
87041,87041,66.67,4,0,4,1.0,0.0,Yes,1.0
87042,87042,99.00,14,2,16,0.875,0.125,Yes,0.875
87043,87043,0.00,0,0,0,0,0,n/a,0
87044,87044,99.00,0,0,0,0,0,n/a,0
87045,87045,99.00,0,0,0,0,0,n/a,0
87046,87046,99.00,48,10,58,0.8275862068965517,0.1724137931034483,Yes,0.8275862068965517
87047,87047,99.00,151,31,182,0.8296703296703297,0.17032967032967034,Yes,0.8296703296703297
87048,87048,99.00,123,23,146,0.8424657534246576,0.15753424657534246,Yes,0.8424657534246576
87049,87049,99.00,224,35,259,0.8648648648648649,0.13513513513513514,Yes,0.8648648648648649
87050,87050,99.00,4,0,4,1.0,0.0,Yes,1.0
87051,87051,99.00,259,45,304,0.8519736842105263,0.14802631578947367,Yes,0.8519736842105263
87052,87052,99.00,1,0,1,1.0,0.0,Yes,1.0
87053,87053,99.00,4,0,4,1.0,0.0,Yes,1.0
87054,87054,99.00,7,0,7,1.0,0.0,Yes,1.0
87055,87055,99.00,181,24,205,0.8829268292682927,0.11707317073170732,Yes,0.8829268292682927
87056,87056,99.00,197,27,224,0.8794642857142857,0.12053571428571429,Yes,0.8794642857142857
87057,87057,99.00,160,44,204,0.7843137254901961,0.21568627450980393,Yes,0.7843137254901961
87058,87058,99.00,196,31,227,0.8634361233480177,0.13656387665198239,Yes,0.8634361233480177
87059,87059,99.00,1,0,1,1.0,0.0,Yes,1.0
87060,87060,99.00,223,22,245,0.9102040816326531,0.08979591836734693,Yes,0.9102040816326531
87061,87061,99.00,190,29,219,0.867579908675799,0.1324200913242009,Yes,0.867579908675799
87062,87062,99.00,3,0,3,1.0,0.0,Yes,1.0
87063,87063,99.00,0,0,0,0,0,n/a,0
87064,87064,99.00,0,0,0,0,0,n/a,0
87065,87065,99.00,3,1,4,0.75,0.25,Yes,0.75
87066,87066,99.00,64,12,76,0.8421052631578947,0.15789473684210525,Yes,0.8421052631578947
87067,87067,99.00,1,0,1,1.0,0.0,Yes,1.0
87068,87068,99.00,63,12,75,0.84,0.16,Yes,0.84
87069,87069,0.00,5,0,5,1.0,0.0,Yes,1.0
87070,87070,99.00,105,14,119,0.8823529411764706,0.11764705882352941,Yes,0.8823529411764706
87071,87071,99.00,88,16,104,0.8461538461538461,0.15384615384615385,Yes,0.8461538461538461
87072,87072,99.00,119,22,141,0.8439716312056738,0.15602836879432624,Yes,0.8439716312056738
87073,87073,99.00,14,1,15,0.9333333333333333,0.06666666666666667,Yes,0.9333333333333333
87074,87074,66.67,89,21,110,0.8090909090909091,0.19090909090909092,Yes,0.8090909090909091
87075,87075,99.00,1,2,3,0.3333333333333333,0.6666666666666666,No,0.6666666666666666
87076,87076,66.67,1,1,2,0.5,0.5,Tie,0.5
87077,87077,99.00,108,23,131,0.8244274809160306,0.17557251908396945,Yes,0.8244274809160306
87078,87078,99.00,133,19,152,0.875,0.125,Yes,0.875
87079,87079,99.00,0,0,0,0,0,n/a,0
87080,87080,37.50,81,12,93,0.8709677419354839,0.12903225806451613,Yes,0.8709677419354839
87081,87081,99.00,100,12,112,0.8928571428571429,0.10714285714285714,Yes,0.8928571428571429
87082,87082,37.50,2,1,3,0.6666666666666666,0.3333333333333333,Yes,0.6666666666666666
87083,87083,99.00,0,0,0,0,0,n/a,0
87084,87084,99.00,137,21,158,0.8670886075949367,0.13291139240506328,Yes,0.8670886075949367
87085,87085,99.00,1,0,1,1.0,0.0,Yes,1.0
87086,87086,99.00,2,0,2,1.0,0.0,Yes,1.0
87087,87087,99.00,163,30,193,0.844559585492228,0.15544041450777202,Yes,0.844559585492228
87088,87088,99.00,1,0,1,1.0,0.0,Yes,1.0
87089,87089,99.00,2,0,2,1.0,0.0,Yes,1.0
87090,87090,0.00,0,0,0,0,0,n/a,0
87091,87091,0.00,0,0,0,0,0,n/a,0
87092,87092,0.00,0,0,0,0,0,n/a,0
87093,87093,99.00,0,0,0,0,0,n/a,0
87094,87094,99.00,0,0,0,0,0,n/a,0
87095,87095,99.00,0,0,0,0,0,n/a,0
87096,87096,99.00,0,0,0,0,0,n/a,0
87097,87097,99.00,42,11,53,0.7924528301886793,0.20754716981132076,Yes,0.7924528301886793
87098,87098,99.00,2,0,2,1.0,0.0,Yes,1.0
87099,87099,99.00,6,0,6,1.0,0.0,Yes,1.0
87100,87100,99.00,0,1,1,0.0,1.0,No,1.0
87101,87101,99.00,8,0,8,1.0,0.0,Yes,1.0
87102,87102,99.00,0,0,0,0,0,n/a,0
41001,41001,99.00,5,0,5,1.0,0.0,Yes,1.0
41002,41002,99.00,91,105,196,0.4642857142857143,0.5357142857142857,No,0.5357142857142857
41003,41003,99.00,107,123,230,0.4652173913043478,0.5347826086956522,No,0.5347826086956522
41004,41004,99.00,9,1,10,0.9,0.1,Yes,0.9
41005,41005,36.36,37,126,163,0.22699386503067484,0.7730061349693251,No,0.7730061349693251
41006,41006,99.00,67,38,105,0.638095238095238,0.3619047619047619,Yes,0.638095238095238
41007,41007,99.00,72,56,128,0.5625,0.4375,Yes,0.5625
41008,41008,99.00,54,49,103,0.5242718446601942,0.47572815533980584,Yes,0.5242718446601942
41009,41009,99.00,42,51,93,0.45161290322580644,0.5483870967741935,No,0.5483870967741935
41010,41010,99.00,2,1,3,0.6666666666666666,0.3333333333333333,Yes,0.6666666666666666
41011,41011,99.00,21,26,47,0.44680851063829785,0.5531914893617021,No,0.5531914893617021
41012,41012,36.36,40,38,78,0.5128205128205128,0.48717948717948717,Yes,0.5128205128205128
41013,41013,36.36,1,0,1,1.0,0.0,Yes,1.0
41014,41014,99.00,0,0,0,0,0,n/a,0
41015,41015,36.36,6,7,13,0.46153846153846156,0.5384615384615384,No,0.5384615384615384
41016,41016,99.00,33,58,91,0.3626373626373626,0.6373626373626373,No,0.6373626373626373
41017,41017,99.00,131,115,246,0.532520325203252,0.46747967479674796,Yes,0.532520325203252
41018,41018,99.00,82,54,136,0.6029411764705882,0.39705882352941174,Yes,0.6029411764705882
41019,41019,99.00,0,0,0,0,0,n/a,0
41020,41020,99.00,64,55,119,0.5378151260504201,0.46218487394957986,Yes,0.5378151260504201
41021,41021,99.00,104,53,157,0.6624203821656051,0.3375796178343949,Yes,0.6624203821656051
41022,41022,99.00,24,7,31,0.7741935483870968,0.22580645161290322,Yes,0.7741935483870968
41023,41023,99.00,1,0,1,1.0,0.0,Yes,1.0
41024,41024,66.67,3,0,3,1.0,0.0,Yes,1.0
41025,41025,66.67,14,10,24,0.5833333333333334,0.4166666666666667,Yes,0.5833333333333334
41026,41026,99.00,0,0,0,0,0,n/a,0
41027,41027,99.00,3,1,4,0.75,0.25,Yes,0.75
41028,41028,99.00,119,17,136,0.875,0.125,Yes,0.875
41029,41029,66.67,0,0,0,0,0,n/a,0
41030,41030,99.00,150,18,168,0.8928571428571429,0.10714285714285714,Yes,0.8928571428571429
41031,41031,99.00,133,12,145,0.9172413793103448,0.08275862068965517,Yes,0.9172413793103448
41032,41032,99.00,14,2,16,0.875,0.125,Yes,0.875
41033,41033,99.00,176,25,201,0.8756218905472637,0.12437810945273632,Yes,0.8756218905472637
41034,41034,99.00,3,1,4,0.75,0.25,Yes,0.75
41035,41035,99.00,76,28,104,0.7307692307692307,0.2692307692307692,Yes,0.7307692307692307
41036,41036,99.00,82,59,141,0.5815602836879432,0.41843971631205673,Yes,0.5815602836879432
41037,41037,99.00,124,21,145,0.8551724137931035,0.14482758620689656,Yes,0.8551724137931035
41038,41038,99.00,152,29,181,0.8397790055248618,0.16022099447513813,Yes,0.8397790055248618
41039,41039,99.00,123,11,134,0.917910447761194,0.08208955223880597,Yes,0.917910447761194
41040,41040,99.00,92,14,106,0.8679245283018868,0.1320754716981132,Yes,0.8679245283018868
41041,41041,99.00,95,9,104,0.9134615384615384,0.08653846153846154,Yes,0.9134615384615384
41042,41042,33.33,3,2,5,0.6,0.4,Yes,0.6
41043,41043,99.00,113,15,128,0.8828125,0.1171875,Yes,0.8828125
41044,41044,99.00,0,1,1,0.0,1.0,No,1.0
41045,41045,99.00,116,15,131,0.8854961832061069,0.11450381679389313,Yes,0.8854961832061069
41046,41046,99.00,208,102,310,0.6709677419354839,0.32903225806451614,Yes,0.6709677419354839
41047,41047,99.00,180,15,195,0.9230769230769231,0.07692307692307693,Yes,0.9230769230769231
41048,41048,99.00,73,13,86,0.8488372093023255,0.1511627906976744,Yes,0.8488372093023255
41049,41049,99.00,114,16,130,0.8769230769230769,0.12307692307692308,Yes,0.8769230769230769
41050,41050,99.00,48,136,184,0.2608695652173913,0.7391304347826086,No,0.7391304347826086
41051,41051,99.00,32,32,64,0.5,0.5,Tie,0.5
41052,41052,99.00,4,2,6,0.6666666666666666,0.3333333333333333,Yes,0.6666666666666666
41053,41053,99.00,5,1,6,0.8333333333333334,0.16666666666666666,Yes,0.8333333333333334
41054,41054,99.00,103,9,112,0.9196428571428571,0.08035714285714286,Yes,0.9196428571428571
41055,41055,99.00,179,30,209,0.8564593301435407,0.14354066985645933,Yes,0.8564593301435407
41056,41056,99.00,0,2,2,0.0,1.0,No,1.0
41057,41057,36.36,10,7,17,0.5882352941176471,0.4117647058823529,Yes,0.5882352941176471
41058,41058,36.36,63,119,182,0.34615384615384615,0.6538461538461539,No,0.6538461538461539
41059,41059,36.36,54,71,125,0.432,0.568,No,0.568
41060,41060,33.33,3,2,5,0.6,0.4,Yes,0.6
41061,41061,33.33,30,20,50,0.6,0.4,Yes,0.6
41062,41062,33.33,27,14,41,0.6585365853658537,0.34146341463414637,Yes,0.6585365853658537
41063,41063,99.00,190,69,259,0.7335907335907336,0.26640926640926643,Yes,0.7335907335907336
41064,41064,99.00,8,3,11,0.7272727272727273,0.2727272727272727,Yes,0.7272727272727273
41065,41065,99.00,2,0,2,1.0,0.0,Yes,1.0
41066,41066,99.00,0,0,0,0,0,n/a,0
41067,41067,99.00,3,0,3,1.0,0.0,Yes,1.0
41068,41068,99.00,116,35,151,0.7682119205298014,0.23178807947019867,Yes,0.7682119205298014
41069,41069,99.00,73,17,90,0.8111111111111111,0.18888888888888888,Yes,0.8111111111111111
41070,41070,99.00,79,36,115,0.6869565217391305,0.3130434782608696,Yes,0.6869565217391305
41071,41071,0.00,3,2,5,0.6,0.4,Yes,0.6
41072,41072,99.00,2,0,2,1.0,0.0,Yes,1.0
41073,41073,0.00,6,0,6,1.0,0.0,Yes,1.0
41074,41074,0.00,6,1,7,0.8571428571428571,0.14285714285714285,Yes,0.8571428571428571
41075,41075,99.00,61,29,90,0.6777777777777778,0.32222222222222224,Yes,0.6777777777777778
41076,41076,99.00,106,42,148,0.7162162162162162,0.28378378378378377,Yes,0.7162162162162162
41077,41077,99.00,111,44,155,0.7161290322580646,0.2838709677419355,Yes,0.7161290322580646
41078,41078,99.00,1,0,1,1.0,0.0,Yes,1.0
41079,41079,66.67,38,21,59,0.6440677966101694,0.3559322033898305,Yes,0.6440677966101694
41080,41080,99.00,0,0,0,0,0,n/a,0
41081,41081,99.00,66,25,91,0.7252747252747253,0.27472527472527475,Yes,0.7252747252747253
41082,41082,99.00,84,31,115,0.7304347826086957,0.26956521739130435,Yes,0.7304347826086957
41083,41083,99.00,3,0,3,1.0,0.0,Yes,1.0
41084,41084,33.33,28,25,53,0.5283018867924528,0.4716981132075472,Yes,0.5283018867924528
41085,41085,99.00,1,0,1,1.0,0.0,Yes,1.0
41086,41086,99.00,100,48,148,0.6756756756756757,0.32432432432432434,Yes,0.6756756756756757
41087,41087,99.00,61,29,90,0.6777777777777778,0.32222222222222224,Yes,0.6777777777777778
41088,41088,99.00,93,39,132,0.7045454545454546,0.29545454545454547,Yes,0.7045454545454546
41089,41089,99.00,4,1,5,0.8,0.2,Yes,0.8
41090,41090,99.00,20,8,28,0.7142857142857143,0.2857142857142857,Yes,0.7142857142857143
41091,41091,66.67,70,19,89,0.7865168539325843,0.21348314606741572,Yes,0.7865168539325843
41092,41092,99.00,0,0,0,0,0,n/a,0
41093,41093,99.00,0,0,0,0,0,n/a,0
41094,41094,36.36,4,7,11,0.36363636363636365,0.6363636363636364,No,0.6363636363636364
41095,41095,99.00,36,57,93,0.3870967741935484,0.6129032258064516,No,0.6129032258064516
41096,41096,99.00,12,1,13,0.9230769230769231,0.07692307692307693,Yes,0.9230769230769231
41097,41097,99.00,7,1,8,0.875,0.125,Yes,0.875
41098,41098,99.00,62,50,112,0.5535714285714286,0.44642857142857145,Yes,0.5535714285714286
41099,41099,99.00,0,0,0,0,0,n/a,0
42001,42001,99.00,11,4,15,0.7333333333333333,0.26666666666666666,Yes,0.7333333333333333
42002,42002,99.00,12,0,12,1.0,0.0,Yes,1.0
42003,42003,99.00,224,25,249,0.8995983935742972,0.10040160642570281,Yes,0.8995983935742972
42004,42004,99.00,130,25,155,0.8387096774193549,0.16129032258064516,Yes,0.8387096774193549
42005,42005,99.00,5,0,5,1.0,0.0,Yes,1.0
42006,42006,99.00,240,55,295,0.8135593220338984,0.1864406779661017,Yes,0.8135593220338984
42007,42007,99.00,187,13,200,0.935,0.065,Yes,0.935
42008,42008,99.00,125,18,143,0.8741258741258742,0.1258741258741259,Yes,0.8741258741258742
42009,42009,99.00,116,18,134,0.8656716417910447,0.13432835820895522,Yes,0.8656716417910447
42010,42010,99.00,135,18,153,0.8823529411764706,0.11764705882352941,Yes,0.8823529411764706
42011,42011,99.00,114,22,136,0.8382352941176471,0.16176470588235295,Yes,0.8382352941176471
42012,42012,99.00,89,10,99,0.898989898989899,0.10101010101010101,Yes,0.898989898989899
42013,42013,99.00,102,18,120,0.85,0.15,Yes,0.85
42014,42014,99.00,91,12,103,0.883495145631068,0.11650485436893204,Yes,0.883495145631068
42015,42015,99.00,120,16,136,0.8823529411764706,0.11764705882352941,Yes,0.8823529411764706
42016,42016,99.00,165,41,206,0.8009708737864077,0.19902912621359223,Yes,0.8009708737864077
42017,42017,99.00,4,1,5,0.8,0.2,Yes,0.8
42018,42018,99.00,139,21,160,0.86875,0.13125,Yes,0.86875
42019,42019,99.00,10,1,11,0.9090909090909091,0.09090909090909091,Yes,0.9090909090909091
42020,42020,99.00,177,32,209,0.84688995215311,0.15311004784688995,Yes,0.84688995215311
42021,42021,99.00,144,22,166,0.8674698795180723,0.13253012048192772,Yes,0.8674698795180723
42022,42022,99.00,144,16,160,0.9,0.1,Yes,0.9
42023,42023,99.00,2,3,5,0.4,0.6,No,0.6
42024,42024,0.00,3,0,3,1.0,0.0,Yes,1.0
42025,42025,0.00,32,5,37,0.8648648648648649,0.13513513513513514,Yes,0.8648648648648649
42026,42026,99.00,13,2,15,0.8666666666666667,0.13333333333333333,Yes,0.8666666666666667
42027,42027,99.00,149,46,195,0.764102564102564,0.2358974358974359,Yes,0.764102564102564
42028,42028,99.00,186,29,215,0.8651162790697674,0.13488372093023257,Yes,0.8651162790697674
42029,42029,99.00,206,51,257,0.8015564202334631,0.19844357976653695,Yes,0.8015564202334631
42030,42030,99.00,293,48,341,0.8592375366568915,0.14076246334310852,Yes,0.8592375366568915
42031,42031,99.00,9,1,10,0.9,0.1,Yes,0.9
42032,42032,99.00,19,3,22,0.8636363636363636,0.13636363636363635,Yes,0.8636363636363636
42033,42033,99.00,9,2,11,0.8181818181818182,0.18181818181818182,Yes,0.8181818181818182
42034,42034,99.00,8,6,14,0.5714285714285714,0.42857142857142855,Yes,0.5714285714285714
42035,42035,99.00,272,43,315,0.8634920634920635,0.1365079365079365,Yes,0.8634920634920635
42036,42036,99.00,126,106,232,0.5431034482758621,0.45689655172413796,Yes,0.5431034482758621
42037,42037,0.00,9,6,15,0.6,0.4,Yes,0.6
42038,42038,99.00,1,3,4,0.25,0.75,No,0.75
42039,42039,99.00,2,0,2,1.0,0.0,Yes,1.0
42040,42040,99.00,118,6,124,0.9516129032258065,0.04838709677419355,Yes,0.9516129032258065
42041,42041,99.00,127,15,142,0.8943661971830986,0.1056338028169014,Yes,0.8943661971830986
42042,42042,99.00,106,15,121,0.8760330578512396,0.12396694214876033,Yes,0.8760330578512396
42043,42043,99.00,109,19,128,0.8515625,0.1484375,Yes,0.8515625
42044,42044,99.00,6,1,7,0.8571428571428571,0.14285714285714285,Yes,0.8571428571428571
42045,42045,99.00,110,13,123,0.8943089430894309,0.10569105691056911,Yes,0.8943089430894309
42046,42046,99.00,120,23,143,0.8391608391608392,0.16083916083916083,Yes,0.8391608391608392
42047,42047,99.00,7,1,8,0.875,0.125,Yes,0.875
42048,42048,99.00,152,24,176,0.8636363636363636,0.13636363636363635,Yes,0.8636363636363636
42049,42049,99.00,266,25,291,0.9140893470790378,0.0859106529209622,Yes,0.9140893470790378
42050,42050,99.00,156,19,175,0.8914285714285715,0.10857142857142857,Yes,0.8914285714285715
42051,42051,99.00,89,169,258,0.3449612403100775,0.6550387596899225,No,0.6550387596899225
42052,42052,99.00,91,26,117,0.7777777777777778,0.2222222222222222,Yes,0.7777777777777778
42053,42053,99.00,102,7,109,0.9357798165137615,0.06422018348623854,Yes,0.9357798165137615
42054,42054,99.00,143,19,162,0.8827160493827161,0.11728395061728394,Yes,0.8827160493827161
42055,42055,99.00,31,5,36,0.8611111111111112,0.1388888888888889,Yes,0.8611111111111112
42056,42056,99.00,119,15,134,0.8880597014925373,0.11194029850746269,Yes,0.8880597014925373
42057,42057,99.00,123,19,142,0.8661971830985915,0.13380281690140844,Yes,0.8661971830985915
42058,42058,99.00,175,32,207,0.8454106280193237,0.15458937198067632,Yes,0.8454106280193237
42059,42059,99.00,5,61,66,0.07575757575757576,0.9242424242424242,No,0.9242424242424242
42060,42060,99.00,8,19,27,0.2962962962962963,0.7037037037037037,No,0.7037037037037037
42061,42061,99.00,64,44,108,0.5925925925925926,0.4074074074074074,Yes,0.5925925925925926
42062,42062,99.00,78,99,177,0.4406779661016949,0.559322033898305,No,0.559322033898305
42063,42063,99.00,55,226,281,0.19572953736654805,0.8042704626334519,No,0.8042704626334519
42064,42064,99.00,52,166,218,0.23853211009174313,0.7614678899082569,No,0.7614678899082569
42065,42065,99.00,1,0,1,1.0,0.0,Yes,1.0
42066,42066,99.00,7,2,9,0.7777777777777778,0.2222222222222222,Yes,0.7777777777777778
42067,42067,99.00,58,90,148,0.3918918918918919,0.6081081081081081,No,0.6081081081081081
42068,42068,99.00,3,0,3,1.0,0.0,Yes,1.0
42069,42069,99.00,11,23,34,0.3235294117647059,0.6764705882352942,No,0.6764705882352942
42070,42070,99.00,93,24,117,0.7948717948717948,0.20512820512820512,Yes,0.7948717948717948
42071,42071,99.00,182,19,201,0.9054726368159204,0.0945273631840796,Yes,0.9054726368159204
42072,42072,99.00,140,25,165,0.8484848484848485,0.15151515151515152,Yes,0.8484848484848485
42073,42073,99.00,122,17,139,0.8776978417266187,0.1223021582733813,Yes,0.8776978417266187
42074,42074,99.00,85,12,97,0.8762886597938144,0.12371134020618557,Yes,0.8762886597938144
42075,42075,99.00,274,46,320,0.85625,0.14375,Yes,0.85625
42076,42076,99.00,6,0,6,1.0,0.0,Yes,1.0
42077,42077,99.00,154,26,180,0.8555555555555555,0.14444444444444443,Yes,0.8555555555555555
42078,42078,99.00,23,9,32,0.71875,0.28125,Yes,0.71875
42079,42079,99.00,122,20,142,0.8591549295774648,0.14084507042253522,Yes,0.8591549295774648
42080,42080,99.00,113,11,124,0.9112903225806451,0.08870967741935484,Yes,0.9112903225806451
42081,42081,99.00,14,4,18,0.7777777777777778,0.2222222222222222,Yes,0.7777777777777778
42082,42082,99.00,5,0,5,1.0,0.0,Yes,1.0
43001,43001,99.00,193,22,215,0.8976744186046511,0.10232558139534884,Yes,0.8976744186046511
43002,43002,99.00,21,6,27,0.7777777777777778,0.2222222222222222,Yes,0.7777777777777778
43003,43003,99.00,122,40,162,0.7530864197530864,0.24691358024691357,Yes,0.7530864197530864
43004,43004,99.00,132,25,157,0.8407643312101911,0.1592356687898089,Yes,0.8407643312101911
43005,43005,99.00,12,0,12,1.0,0.0,Yes,1.0
43006,43006,99.00,271,49,320,0.846875,0.153125,Yes,0.846875
43007,43007,99.00,236,22,258,0.9147286821705426,0.08527131782945736,Yes,0.9147286821705426
43008,43008,99.00,4,0,4,1.0,0.0,Yes,1.0
43009,43009,99.00,166,22,188,0.8829787234042553,0.11702127659574468,Yes,0.8829787234042553
43010,43010,99.00,66,14,80,0.825,0.175,Yes,0.825
43011,43011,99.00,107,45,152,0.7039473684210527,0.29605263157894735,Yes,0.7039473684210527
43012,43012,99.00,240,42,282,0.851063829787234,0.14893617021276595,Yes,0.851063829787234
43013,43013,99.00,83,41,124,0.6693548387096774,0.33064516129032256,Yes,0.6693548387096774
43014,43014,99.00,169,34,203,0.8325123152709359,0.16748768472906403,Yes,0.8325123152709359
43015,43015,99.00,202,40,242,0.8347107438016529,0.1652892561983471,Yes,0.8347107438016529
43016,43016,99.00,6,4,10,0.6,0.4,Yes,0.6
43017,43017,99.00,240,43,283,0.8480565371024735,0.1519434628975265,Yes,0.8480565371024735
43018,43018,99.00,296,46,342,0.8654970760233918,0.13450292397660818,Yes,0.8654970760233918
43019,43019,99.00,5,1,6,0.8333333333333334,0.16666666666666666,Yes,0.8333333333333334
43020,43020,99.00,16,3,19,0.8421052631578947,0.15789473684210525,Yes,0.8421052631578947
43021,43021,99.00,168,34,202,0.8316831683168316,0.16831683168316833,Yes,0.8316831683168316
43022,43022,99.00,10,0,10,1.0,0.0,Yes,1.0
43023,43023,99.00,299,40,339,0.8820058997050148,0.11799410029498525,Yes,0.8820058997050148
43024,43024,99.00,291,37,328,0.8871951219512195,0.11280487804878049,Yes,0.8871951219512195
43025,43025,99.00,6,0,6,1.0,0.0,Yes,1.0
43026,43026,99.00,236,34,270,0.8740740740740741,0.1259259259259259,Yes,0.8740740740740741
43027,43027,99.00,145,25,170,0.8529411764705882,0.14705882352941177,Yes,0.8529411764705882
43028,43028,99.00,175,15,190,0.9210526315789473,0.07894736842105263,Yes,0.9210526315789473
43029,43029,75.00,48,10,58,0.8275862068965517,0.1724137931034483,Yes,0.8275862068965517
43030,43030,75.00,72,8,80,0.9,0.1,Yes,0.9
43031,43031,75.00,112,12,124,0.9032258064516129,0.0967741935483871,Yes,0.9032258064516129
43032,43032,99.00,81,10,91,0.8901098901098901,0.10989010989010989,Yes,0.8901098901098901
43033,43033,75.00,99,27,126,0.7857142857142857,0.21428571428571427,Yes,0.7857142857142857
43034,43034,99.00,5,0,5,1.0,0.0,Yes,1.0
43035,43035,99.00,201,44,245,0.8204081632653061,0.17959183673469387,Yes,0.8204081632653061
43036,43036,99.00,129,16,145,0.8896551724137931,0.1103448275862069,Yes,0.8896551724137931
43037,43037,99.00,146,28,174,0.8390804597701149,0.16091954022988506,Yes,0.8390804597701149
43038,43038,50.00,97,27,124,0.782258064516129,0.21774193548387097,Yes,0.782258064516129
43039,43039,50.00,114,26,140,0.8142857142857143,0.18571428571428572,Yes,0.8142857142857143
43040,43040,99.00,2,0,2,1.0,0.0,Yes,1.0
43041,43041,99.00,128,27,155,0.8258064516129032,0.17419354838709677,Yes,0.8258064516129032
43042,43042,99.00,20,6,26,0.7692307692307693,0.23076923076923078,Yes,0.7692307692307693
43043,43043,99.00,244,62,306,0.7973856209150327,0.20261437908496732,Yes,0.7973856209150327
43044,43044,99.00,254,38,292,0.8698630136986302,0.13013698630136986,Yes,0.8698630136986302
43045,43045,99.00,259,33,292,0.886986301369863,0.11301369863013698,Yes,0.886986301369863
43046,43046,99.00,167,19,186,0.8978494623655914,0.10215053763440861,Yes,0.8978494623655914
43047,43047,99.00,8,2,10,0.8,0.2,Yes,0.8
43048,43048,99.00,9,2,11,0.8181818181818182,0.18181818181818182,Yes,0.8181818181818182
43049,43049,99.00,234,33,267,0.8764044943820225,0.12359550561797752,Yes,0.8764044943820225
43050,43050,99.00,183,41,224,0.8169642857142857,0.18303571428571427,Yes,0.8169642857142857
43051,43051,99.00,200,23,223,0.8968609865470852,0.1031390134529148,Yes,0.8968609865470852
43052,43052,99.00,239,41,280,0.8535714285714285,0.14642857142857144,Yes,0.8535714285714285
43053,43053,99.00,168,24,192,0.875,0.125,Yes,0.875
43054,43054,99.00,150,30,180,0.8333333333333334,0.16666666666666666,Yes,0.8333333333333334
43055,43055,99.00,99,16,115,0.8608695652173913,0.1391304347826087,Yes,0.8608695652173913
43056,43056,99.00,4,2,6,0.6666666666666666,0.3333333333333333,Yes,0.6666666666666666
43057,43057,99.00,37,29,66,0.5606060606060606,0.4393939393939394,Yes,0.5606060606060606
43058,43058,99.00,1,0,1,1.0,0.0,Yes,1.0
43059,43059,99.00,134,62,196,0.6836734693877551,0.3163265306122449,Yes,0.6836734693877551
43060,43060,99.00,2,0,2,1.0,0.0,Yes,1.0
43061,43061,99.00,73,11,84,0.8690476190476191,0.13095238095238096,Yes,0.8690476190476191
43062,43062,99.00,52,25,77,0.6753246753246753,0.3246753246753247,Yes,0.6753246753246753
43063,43063,99.00,86,28,114,0.7543859649122807,0.24561403508771928,Yes,0.7543859649122807
43064,43064,99.00,162,33,195,0.8307692307692308,0.16923076923076924,Yes,0.8307692307692308
43065,43065,99.00,10,1,11,0.9090909090909091,0.09090909090909091,Yes,0.9090909090909091
43066,43066,99.00,135,25,160,0.84375,0.15625,Yes,0.84375
43067,43067,99.00,221,45,266,0.8308270676691729,0.16917293233082706,Yes,0.8308270676691729
43068,43068,99.00,3,0,3,1.0,0.0,Yes,1.0
43069,43069,99.00,82,9,91,0.9010989010989011,0.0989010989010989,Yes,0.9010989010989011
43070,43070,99.00,2,0,2,1.0,0.0,Yes,1.0
43071,43071,99.00,4,1,5,0.8,0.2,Yes,0.8
43072,43072,99.00,2,2,4,0.5,0.5,Tie,0.5
43073,43073,99.00,345,41,386,0.8937823834196891,0.10621761658031088,Yes,0.8937823834196891
43074,43074,99.00,112,32,144,0.7777777777777778,0.2222222222222222,Yes,0.7777777777777778
43075,43075,99.00,233,32,265,0.879245283018868,0.12075471698113208,Yes,0.879245283018868
43076,43076,99.00,70,27,97,0.7216494845360825,0.27835051546391754,Yes,0.7216494845360825
43077,43077,99.00,1,0,1,1.0,0.0,Yes,1.0
43078,43078,99.00,167,24,191,0.8743455497382199,0.1256544502617801,Yes,0.8743455497382199
43079,43079,99.00,0,0,0,0,0,n/a,0
43080,43080,99.00,210,36,246,0.8536585365853658,0.14634146341463414,Yes,0.8536585365853658
43081,43081,99.00,11,4,15,0.7333333333333333,0.26666666666666666,Yes,0.7333333333333333
43082,43082,99.00,21,6,27,0.7777777777777778,0.2222222222222222,Yes,0.7777777777777778
43083,43083,99.00,1,1,2,0.5,0.5,Tie,0.5
43084,43084,99.00,3,0,3,1.0,0.0,Yes,1.0
43085,43085,99.00,101,71,172,0.5872093023255814,0.4127906976744186,Yes,0.5872093023255814
43086,43086,99.00,10,0,10,1.0,0.0,Yes,1.0
43087,43087,99.00,166,36,202,0.8217821782178217,0.1782178217821782,Yes,0.8217821782178217
44001,44001,99.00,67,64,131,0.5114503816793893,0.48854961832061067,Yes,0.5114503816793893
44002,44002,99.00,3,50,53,0.05660377358490566,0.9433962264150944,No,0.9433962264150944
44003,44003,99.00,19,84,103,0.18446601941747573,0.8155339805825242,No,0.8155339805825242
44004,44004,99.00,56,65,121,0.4628099173553719,0.5371900826446281,No,0.5371900826446281
44005,44005,99.00,11,0,11,1.0,0.0,Yes,1.0
44006,44006,99.00,217,81,298,0.7281879194630873,0.27181208053691275,Yes,0.7281879194630873
44007,44007,99.00,4,1,5,0.8,0.2,Yes,0.8
44008,44008,99.00,3,1,4,0.75,0.25,Yes,0.75
44009,44009,99.00,152,20,172,0.8837209302325582,0.11627906976744186,Yes,0.8837209302325582
44010,44010,99.00,90,26,116,0.7758620689655172,0.22413793103448276,Yes,0.7758620689655172
44011,44011,99.00,0,0,0,0,0,n/a,0
44012,44012,99.00,5,3,8,0.625,0.375,Yes,0.625
44013,44013,99.00,28,61,89,0.3146067415730337,0.6853932584269663,No,0.6853932584269663
44014,44014,99.00,207,58,265,0.7811320754716982,0.2188679245283019,Yes,0.7811320754716982
44015,44015,99.00,231,50,281,0.8220640569395018,0.17793594306049823,Yes,0.8220640569395018
44016,44016,99.00,5,0,5,1.0,0.0,Yes,1.0
44017,44017,99.00,6,1,7,0.8571428571428571,0.14285714285714285,Yes,0.8571428571428571
44018,44018,99.00,321,84,405,0.7925925925925926,0.2074074074074074,Yes,0.7925925925925926
44019,44019,99.00,83,70,153,0.5424836601307189,0.45751633986928103,Yes,0.5424836601307189
44020,44020,99.00,196,65,261,0.7509578544061303,0.24904214559386972,Yes,0.7509578544061303
44021,44021,99.00,0,0,0,0,0,n/a,0
44022,44022,99.00,0,0,0,0,0,n/a,0
44023,44023,99.00,42,54,96,0.4375,0.5625,No,0.5625
44024,44024,99.00,32,42,74,0.43243243243243246,0.5675675675675675,No,0.5675675675675675
44025,44025,99.00,104,134,238,0.4369747899159664,0.5630252100840336,No,0.5630252100840336
44026,44026,99.00,81,59,140,0.5785714285714286,0.42142857142857143,Yes,0.5785714285714286
44027,44027,99.00,79,87,166,0.4759036144578313,0.5240963855421686,No,0.5240963855421686
44028,44028,0.00,8,0,8,1.0,0.0,Yes,1.0
44029,44029,99.00,140,75,215,0.6511627906976745,0.3488372093023256,Yes,0.6511627906976745
44030,44030,99.00,2,0,2,1.0,0.0,Yes,1.0
44031,44031,0.00,15,5,20,0.75,0.25,Yes,0.75
44032,44032,99.00,29,10,39,0.7435897435897436,0.2564102564102564,Yes,0.7435897435897436
44033,44033,0.00,12,2,14,0.8571428571428571,0.14285714285714285,Yes,0.8571428571428571
44034,44034,0.00,3,0,3,1.0,0.0,Yes,1.0
44035,44035,99.00,240,57,297,0.8080808080808081,0.1919191919191919,Yes,0.8080808080808081
44036,44036,99.00,274,53,327,0.8379204892966361,0.1620795107033639,Yes,0.8379204892966361
44037,44037,99.00,7,2,9,0.7777777777777778,0.2222222222222222,Yes,0.7777777777777778
44038,44038,99.00,181,58,239,0.7573221757322176,0.24267782426778242,Yes,0.7573221757322176
44039,44039,99.00,172,50,222,0.7747747747747747,0.22522522522522523,Yes,0.7747747747747747
44040,44040,99.00,0,0,0,0,0,n/a,0
44041,44041,99.00,0,1,1,0.0,1.0,No,1.0
44042,44042,99.00,146,46,192,0.7604166666666666,0.23958333333333334,Yes,0.7604166666666666
44043,44043,99.00,149,102,251,0.5936254980079682,0.4063745019920319,Yes,0.5936254980079682
44044,44044,99.00,2,2,4,0.5,0.5,Tie,0.5
44045,44045,99.00,117,31,148,0.7905405405405406,0.20945945945945946,Yes,0.7905405405405406
44046,44046,99.00,3,0,3,1.0,0.0,Yes,1.0
44047,44047,99.00,2,0,2,1.0,0.0,Yes,1.0
44048,44048,99.00,230,63,293,0.7849829351535836,0.2150170648464164,Yes,0.7849829351535836
44049,44049,99.00,297,52,349,0.8510028653295129,0.1489971346704871,Yes,0.8510028653295129
44050,44050,99.00,209,49,258,0.810077519379845,0.18992248062015504,Yes,0.810077519379845
44051,44051,99.00,355,81,436,0.8142201834862385,0.18577981651376146,Yes,0.8142201834862385
44052,44052,99.00,316,64,380,0.8315789473684211,0.16842105263157894,Yes,0.8315789473684211
44053,44053,99.00,322,114,436,0.7385321100917431,0.26146788990825687,Yes,0.7385321100917431
44054,44054,99.00,211,52,263,0.8022813688212928,0.19771863117870722,Yes,0.8022813688212928
44055,44055,99.00,66,18,84,0.7857142857142857,0.21428571428571427,Yes,0.7857142857142857
44056,44056,99.00,21,12,33,0.6363636363636364,0.36363636363636365,Yes,0.6363636363636364
44057,44057,99.00,455,122,577,0.7885615251299827,0.21143847487001732,Yes,0.7885615251299827
44058,44058,99.00,352,129,481,0.7318087318087318,0.2681912681912682,Yes,0.7318087318087318
44059,44059,99.00,253,59,312,0.8108974358974359,0.1891025641025641,Yes,0.8108974358974359
44060,44060,99.00,241,69,310,0.7774193548387097,0.22258064516129034,Yes,0.7774193548387097
44061,44061,99.00,30,11,41,0.7317073170731707,0.2682926829268293,Yes,0.7317073170731707
44062,44062,99.00,20,10,30,0.6666666666666666,0.3333333333333333,Yes,0.6666666666666666
44063,44063,36.36,163,49,212,0.7688679245283019,0.23113207547169812,Yes,0.7688679245283019
44064,44064,99.00,122,20,142,0.8591549295774648,0.14084507042253522,Yes,0.8591549295774648
44065,44065,99.00,335,70,405,0.8271604938271605,0.1728395061728395,Yes,0.8271604938271605
44066,44066,99.00,30,8,38,0.7894736842105263,0.21052631578947367,Yes,0.7894736842105263
44067,44067,99.00,1,1,2,0.5,0.5,Tie,0.5
44068,44068,36.36,323,98,421,0.7672209026128266,0.2327790973871734,Yes,0.7672209026128266
44069,44069,36.36,44,15,59,0.7457627118644068,0.2542372881355932,Yes,0.7457627118644068
44070,44070,36.36,49,23,72,0.6805555555555556,0.3194444444444444,Yes,0.6805555555555556
44071,44071,99.00,62,12,74,0.8378378378378378,0.16216216216216217,Yes,0.8378378378378378
44072,44072,36.36,315,90,405,0.7777777777777778,0.2222222222222222,Yes,0.7777777777777778
44073,44073,99.00,244,45,289,0.8442906574394463,0.15570934256055363,Yes,0.8442906574394463
44074,44074,99.00,27,12,39,0.6923076923076923,0.3076923076923077,Yes,0.6923076923076923
44075,44075,99.00,340,94,434,0.783410138248848,0.21658986175115208,Yes,0.783410138248848
44076,44076,36.36,268,50,318,0.8427672955974843,0.15723270440251572,Yes,0.8427672955974843
44077,44077,99.00,428,115,543,0.7882136279926335,0.21178637200736647,Yes,0.7882136279926335
44078,44078,99.00,372,116,488,0.7622950819672131,0.23770491803278687,Yes,0.7622950819672131
44079,44079,99.00,371,83,454,0.8171806167400881,0.1828193832599119,Yes,0.8171806167400881
44080,44080,99.00,22,11,33,0.6666666666666666,0.3333333333333333,Yes,0.6666666666666666
44081,44081,99.00,130,71,201,0.6467661691542289,0.35323383084577115,Yes,0.6467661691542289
44082,44082,99.00,13,1,14,0.9285714285714286,0.07142857142857142,Yes,0.9285714285714286
44083,44083,99.00,228,56,284,0.8028169014084507,0.19718309859154928,Yes,0.8028169014084507
44084,44084,99.00,21,12,33,0.6363636363636364,0.36363636363636365,Yes,0.6363636363636364
44085,44085,99.00,0,0,0,0,0,n/a,0
44086,44086,99.00,13,1,14,0.9285714285714286,0.07142857142857142,Yes,0.9285714285714286
44087,44087,0.00,4,1,5,0.8,0.2,Yes,0.8
44088,44088,99.00,6,1,7,0.8571428571428571,0.14285714285714285,Yes,0.8571428571428571
44089,44089,99.00,5,1,6,0.8333333333333334,0.16666666666666666,Yes,0.8333333333333334
44090,44090,99.00,2,1,3,0.6666666666666666,0.3333333333333333,Yes,0.6666666666666666
44091,44091,99.00,0,0,0,0,0,n/a,0
44092,44092,99.00,0,0,0,0,0,n/a,0
44093,44093,0.00,0,0,0,0,0,n/a,0
45001,45001,99.00,51,116,167,0.30538922155688625,0.6946107784431138,No,0.6946107784431138
45002,45002,99.00,68,108,176,0.38636363636363635,0.6136363636363636,No,0.6136363636363636
45003,45003,99.00,43,106,149,0.28859060402684567,0.7114093959731543,No,0.7114093959731543
45004,45004,75.00,66,49,115,0.5739130434782609,0.4260869565217391,Yes,0.5739130434782609
45005,45005,99.00,45,91,136,0.33088235294117646,0.6691176470588235,No,0.6691176470588235
45006,45006,75.00,34,103,137,0.24817518248175183,0.7518248175182481,No,0.7518248175182481
45007,45007,99.00,0,0,0,0,0,n/a,0
45008,45008,99.00,30,57,87,0.3448275862068966,0.6551724137931034,No,0.6551724137931034
45009,45009,75.00,28,121,149,0.18791946308724833,0.8120805369127517,No,0.8120805369127517
45010,45010,75.00,2,0,2,1.0,0.0,Yes,1.0
45011,45011,75.00,56,38,94,0.5957446808510638,0.40425531914893614,Yes,0.5957446808510638
45012,45012,99.00,11,3,14,0.7857142857142857,0.21428571428571427,Yes,0.7857142857142857
45013,45013,99.00,107,85,192,0.5572916666666666,0.4427083333333333,Yes,0.5572916666666666
45014,45014,99.00,94,65,159,0.5911949685534591,0.4088050314465409,Yes,0.5911949685534591
45015,45015,99.00,0,0,0,0,0,n/a,0
45016,45016,99.00,24,104,128,0.1875,0.8125,No,0.8125
45017,45017,99.00,26,37,63,0.4126984126984127,0.5873015873015873,No,0.5873015873015873
45018,45018,99.00,0,0,0,0,0,n/a,0
45019,45019,99.00,46,91,137,0.3357664233576642,0.6642335766423357,No,0.6642335766423357
45020,45020,99.00,0,1,1,0.0,1.0,No,1.0
45021,45021,99.00,9,33,42,0.21428571428571427,0.7857142857142857,No,0.7857142857142857
45022,45022,99.00,38,58,96,0.3958333333333333,0.6041666666666666,No,0.6041666666666666
45023,45023,99.00,3,0,3,1.0,0.0,Yes,1.0
45024,45024,99.00,1,3,4,0.25,0.75,No,0.75
45025,45025,99.00,0,0,0,0,0,n/a,0
45026,45026,99.00,53,19,72,0.7361111111111112,0.2638888888888889,Yes,0.7361111111111112
45027,45027,99.00,58,20,78,0.7435897435897436,0.2564102564102564,Yes,0.7435897435897436
45028,45028,66.67,2,2,4,0.5,0.5,Tie,0.5
45029,45029,99.00,26,17,43,0.6046511627906976,0.3953488372093023,Yes,0.6046511627906976
45030,45030,66.67,80,28,108,0.7407407407407407,0.25925925925925924,Yes,0.7407407407407407
45031,45031,99.00,70,43,113,0.6194690265486725,0.3805309734513274,Yes,0.6194690265486725
45032,45032,99.00,1,1,2,0.5,0.5,Tie,0.5
45033,45033,99.00,101,45,146,0.6917808219178082,0.3082191780821918,Yes,0.6917808219178082
45034,45034,99.00,4,0,4,1.0,0.0,Yes,1.0
45035,45035,99.00,69,72,141,0.48936170212765956,0.5106382978723404,No,0.5106382978723404
45036,45036,99.00,0,0,0,0,0,n/a,0
45037,45037,99.00,67,33,100,0.67,0.33,Yes,0.67
45038,45038,66.67,60,17,77,0.7792207792207793,0.22077922077922077,Yes,0.7792207792207793
45039,45039,66.67,1,0,1,1.0,0.0,Yes,1.0
45040,45040,99.00,112,55,167,0.6706586826347305,0.32934131736526945,Yes,0.6706586826347305
45041,45041,99.00,0,2,2,0.0,1.0,No,1.0
45042,45042,99.00,0,0,0,0,0,n/a,0
45043,45043,99.00,81,50,131,0.6183206106870229,0.3816793893129771,Yes,0.6183206106870229
45044,45044,99.00,86,27,113,0.7610619469026548,0.23893805309734514,Yes,0.7610619469026548
45045,45045,99.00,0,0,0,0,0,n/a,0
45046,45046,99.00,39,25,64,0.609375,0.390625,Yes,0.609375
45047,45047,99.00,15,1,16,0.9375,0.0625,Yes,0.9375
45048,45048,99.00,65,49,114,0.5701754385964912,0.4298245614035088,Yes,0.5701754385964912
45049,45049,99.00,0,0,0,0,0,n/a,0
45050,45050,99.00,66,20,86,0.7674418604651163,0.23255813953488372,Yes,0.7674418604651163
45051,45051,99.00,57,23,80,0.7125,0.2875,Yes,0.7125
45052,45052,99.00,1,0,1,1.0,0.0,Yes,1.0
45053,45053,99.00,89,44,133,0.6691729323308271,0.3308270676691729,Yes,0.6691729323308271
45054,45054,99.00,1,3,4,0.25,0.75,No,0.75
45055,45055,99.00,0,0,0,0,0,n/a,0
45056,45056,66.67,1,2,3,0.3333333333333333,0.6666666666666666,No,0.6666666666666666
45057,45057,99.00,65,24,89,0.7303370786516854,0.2696629213483146,Yes,0.7303370786516854
45058,45058,99.00,2,0,2,1.0,0.0,Yes,1.0
45059,45059,99.00,96,46,142,0.676056338028169,0.323943661971831,Yes,0.676056338028169
45060,45060,99.00,49,21,70,0.7,0.3,Yes,0.7
45061,45061,99.00,0,0,0,0,0,n/a,0
45062,45062,99.00,36,12,48,0.75,0.25,Yes,0.75
45063,45063,99.00,0,0,0,0,0,n/a,0
45064,45064,99.00,26,23,49,0.5306122448979592,0.46938775510204084,Yes,0.5306122448979592
45065,45065,99.00,1,2,3,0.3333333333333333,0.6666666666666666,No,0.6666666666666666
45066,45066,0.00,1,0,1,1.0,0.0,Yes,1.0
45067,45067,99.00,0,0,0,0,0,n/a,0
45068,45068,99.00,61,50,111,0.5495495495495496,0.45045045045045046,Yes,0.5495495495495496
45069,45069,99.00,101,87,188,0.5372340425531915,0.4627659574468085,Yes,0.5372340425531915
45070,45070,99.00,0,2,2,0.0,1.0,No,1.0
45071,45071,99.00,3,1,4,0.75,0.25,Yes,0.75
45072,45072,99.00,0,0,0,0,0,n/a,0
45073,45073,99.00,47,25,72,0.6527777777777778,0.3472222222222222,Yes,0.6527777777777778
45074,45074,99.00,64,43,107,0.5981308411214953,0.40186915887850466,Yes,0.5981308411214953
45075,45075,99.00,64,35,99,0.6464646464646465,0.35353535353535354,Yes,0.6464646464646465
45076,45076,99.00,2,0,2,1.0,0.0,Yes,1.0
45077,45077,99.00,0,0,0,0,0,n/a,0
45078,45078,99.00,91,53,144,0.6319444444444444,0.3680555555555556,Yes,0.6319444444444444
45079,45079,99.00,0,0,0,0,0,n/a,0
45080,45080,99.00,0,0,0,0,0,n/a,0
46001,46001,99.00,5,4,9,0.5555555555555556,0.4444444444444444,Yes,0.5555555555555556
46002,46002,99.00,3,1,4,0.75,0.25,Yes,0.75
46003,46003,99.00,82,41,123,0.6666666666666666,0.3333333333333333,Yes,0.6666666666666666
46004,46004,99.00,128,44,172,0.7441860465116279,0.2558139534883721,Yes,0.7441860465116279
46005,46005,99.00,58,10,68,0.8529411764705882,0.14705882352941177,Yes,0.8529411764705882
46006,46006,99.00,2,1,3,0.6666666666666666,0.3333333333333333,Yes,0.6666666666666666
46007,46007,99.00,5,2,7,0.7142857142857143,0.2857142857142857,Yes,0.7142857142857143
46008,46008,99.00,125,28,153,0.8169934640522876,0.1830065359477124,Yes,0.8169934640522876
46009,46009,99.00,8,2,10,0.8,0.2,Yes,0.8
46010,46010,99.00,99,18,117,0.8461538461538461,0.15384615384615385,Yes,0.8461538461538461
46011,46011,99.00,19,4,23,0.8260869565217391,0.17391304347826086,Yes,0.8260869565217391
46012,46012,99.00,99,18,117,0.8461538461538461,0.15384615384615385,Yes,0.8461538461538461
46013,46013,99.00,5,0,5,1.0,0.0,Yes,1.0
46014,46014,99.00,104,17,121,0.859504132231405,0.14049586776859505,Yes,0.859504132231405
46015,46015,99.00,1,0,1,1.0,0.0,Yes,1.0
46016,46016,99.00,86,27,113,0.7610619469026548,0.23893805309734514,Yes,0.7610619469026548
46017,46017,99.00,52,42,94,0.5531914893617021,0.44680851063829785,Yes,0.5531914893617021
46018,46018,99.00,0,0,0,0,0,n/a,0
46019,46019,99.00,69,29,98,0.7040816326530612,0.29591836734693877,Yes,0.7040816326530612
46020,46020,99.00,60,29,89,0.6741573033707865,0.3258426966292135,Yes,0.6741573033707865
46021,46021,99.00,0,0,0,0,0,n/a,0
46022,46022,99.00,46,30,76,0.6052631578947368,0.39473684210526316,Yes,0.6052631578947368
46023,46023,99.00,50,16,66,0.7575757575757576,0.24242424242424243,Yes,0.7575757575757576
46024,46024,99.00,50,23,73,0.684931506849315,0.3150684931506849,Yes,0.684931506849315
46025,46025,99.00,0,1,1,0.0,1.0,No,1.0
46026,46026,50.00,12,10,22,0.5454545454545454,0.45454545454545453,Yes,0.5454545454545454
46027,46027,99.00,58,29,87,0.6666666666666666,0.3333333333333333,Yes,0.6666666666666666
46028,46028,99.00,0,0,0,0,0,n/a,0
46029,46029,99.00,50,19,69,0.7246376811594203,0.2753623188405797,Yes,0.7246376811594203
46030,46030,99.00,92,35,127,0.7244094488188977,0.2755905511811024,Yes,0.7244094488188977
46031,46031,99.00,151,44,195,0.7743589743589744,0.22564102564102564,Yes,0.7743589743589744
46032,46032,99.00,8,1,9,0.8888888888888888,0.1111111111111111,Yes,0.8888888888888888
46033,46033,99.00,98,19,117,0.8376068376068376,0.1623931623931624,Yes,0.8376068376068376
46034,46034,99.00,6,0,6,1.0,0.0,Yes,1.0
46035,46035,99.00,0,0,0,0,0,n/a,0
46036,46036,99.00,6,1,7,0.8571428571428571,0.14285714285714285,Yes,0.8571428571428571
46037,46037,99.00,0,1,1,0.0,1.0,No,1.0
46038,46038,99.00,65,23,88,0.7386363636363636,0.26136363636363635,Yes,0.7386363636363636
46039,46039,99.00,2,0,2,1.0,0.0,Yes,1.0
46040,46040,99.00,22,11,33,0.6666666666666666,0.3333333333333333,Yes,0.6666666666666666
46041,46041,99.00,156,62,218,0.7155963302752294,0.28440366972477066,Yes,0.7155963302752294
46042,46042,99.00,128,82,210,0.6095238095238096,0.3904761904761905,Yes,0.6095238095238096
46043,46043,99.00,28,13,41,0.6829268292682927,0.3170731707317073,Yes,0.6829268292682927
46044,46044,99.00,34,9,43,0.7906976744186046,0.20930232558139536,Yes,0.7906976744186046
46045,46045,99.00,43,10,53,0.8113207547169812,0.18867924528301888,Yes,0.8113207547169812
46046,46046,99.00,32,5,37,0.8648648648648649,0.13513513513513514,Yes,0.8648648648648649
46047,46047,99.00,108,35,143,0.7552447552447552,0.24475524475524477,Yes,0.7552447552447552
46048,46048,99.00,78,37,115,0.6782608695652174,0.3217391304347826,Yes,0.6782608695652174
46049,46049,99.00,190,64,254,0.7480314960629921,0.25196850393700787,Yes,0.7480314960629921
46050,46050,99.00,127,54,181,0.7016574585635359,0.2983425414364641,Yes,0.7016574585635359
46051,46051,33.33,135,62,197,0.6852791878172588,0.3147208121827411,Yes,0.6852791878172588
46052,46052,99.00,7,0,7,1.0,0.0,Yes,1.0
46053,46053,99.00,115,52,167,0.688622754491018,0.31137724550898205,Yes,0.688622754491018
46054,46054,99.00,107,39,146,0.7328767123287672,0.2671232876712329,Yes,0.7328767123287672
46055,46055,99.00,92,30,122,0.7540983606557377,0.2459016393442623,Yes,0.7540983606557377
46056,46056,99.00,112,33,145,0.7724137931034483,0.22758620689655173,Yes,0.7724137931034483
46057,46057,99.00,5,4,9,0.5555555555555556,0.4444444444444444,Yes,0.5555555555555556
46058,46058,99.00,146,32,178,0.8202247191011236,0.1797752808988764,Yes,0.8202247191011236
46059,46059,99.00,120,39,159,0.7547169811320755,0.24528301886792453,Yes,0.7547169811320755
46060,46060,99.00,240,93,333,0.7207207207207207,0.27927927927927926,Yes,0.7207207207207207
46061,46061,99.00,18,2,20,0.9,0.1,Yes,0.9
46062,46062,99.00,217,69,286,0.7587412587412588,0.24125874125874125,Yes,0.7587412587412588
46063,46063,99.00,143,58,201,0.7114427860696517,0.2885572139303483,Yes,0.7114427860696517
46064,46064,99.00,156,59,215,0.7255813953488373,0.2744186046511628,Yes,0.7255813953488373
46065,46065,99.00,149,58,207,0.7198067632850241,0.28019323671497587,Yes,0.7198067632850241
46066,46066,99.00,91,41,132,0.6893939393939394,0.3106060606060606,Yes,0.6893939393939394
46067,46067,99.00,125,67,192,0.6510416666666666,0.3489583333333333,Yes,0.6510416666666666
46068,46068,99.00,107,67,174,0.6149425287356322,0.3850574712643678,Yes,0.6149425287356322
46069,46069,99.00,80,56,136,0.5882352941176471,0.4117647058823529,Yes,0.5882352941176471
46070,46070,99.00,3,0,3,1.0,0.0,Yes,1.0
46071,46071,99.00,87,47,134,0.6492537313432836,0.35074626865671643,Yes,0.6492537313432836
46072,46072,99.00,112,45,157,0.7133757961783439,0.28662420382165604,Yes,0.7133757961783439
46073,46073,99.00,79,57,136,0.5808823529411765,0.41911764705882354,Yes,0.5808823529411765
46074,46074,99.00,1,1,2,0.5,0.5,Tie,0.5
46075,46075,99.00,210,80,290,0.7241379310344828,0.27586206896551724,Yes,0.7241379310344828
46076,46076,99.00,1,5,6,0.16666666666666666,0.8333333333333334,No,0.8333333333333334
46077,46077,99.00,34,20,54,0.6296296296296297,0.37037037037037035,Yes,0.6296296296296297
46078,46078,99.00,243,98,341,0.7126099706744868,0.2873900293255132,Yes,0.7126099706744868
46079,46079,99.00,148,97,245,0.6040816326530613,0.39591836734693875,Yes,0.6040816326530613
46080,46080,99.00,92,14,106,0.8679245283018868,0.1320754716981132,Yes,0.8679245283018868
46081,46081,99.00,0,1,1,0.0,1.0,No,1.0
46082,46082,99.00,0,0,0,0,0,n/a,0
46083,46083,99.00,0,0,0,0,0,n/a,0
46084,46084,99.00,0,0,0,0,0,n/a,0
47001,47001,99.00,124,42,166,0.7469879518072289,0.25301204819277107,Yes,0.7469879518072289
47002,47002,99.00,4,3,7,0.5714285714285714,0.42857142857142855,Yes,0.5714285714285714
47003,47003,99.00,51,14,65,0.7846153846153846,0.2153846153846154,Yes,0.7846153846153846
47004,47004,44.44,1,0,1,1.0,0.0,Yes,1.0
47005,47005,99.00,5,0,5,1.0,0.0,Yes,1.0
47006,47006,99.00,142,50,192,0.7395833333333334,0.2604166666666667,Yes,0.7395833333333334
47007,47007,99.00,9,2,11,0.8181818181818182,0.18181818181818182,Yes,0.8181818181818182
47008,47008,99.00,117,60,177,0.6610169491525424,0.3389830508474576,Yes,0.6610169491525424
47009,47009,99.00,149,47,196,0.7602040816326531,0.23979591836734693,Yes,0.7602040816326531
47010,47010,99.00,9,9,18,0.5,0.5,Tie,0.5
47011,47011,99.00,3,0,3,1.0,0.0,Yes,1.0
47012,47012,99.00,81,29,110,0.7363636363636363,0.2636363636363636,Yes,0.7363636363636363
47013,47013,99.00,131,36,167,0.7844311377245509,0.2155688622754491,Yes,0.7844311377245509
47014,47014,99.00,59,35,94,0.6276595744680851,0.3723404255319149,Yes,0.6276595744680851
47015,47015,99.00,50,11,61,0.819672131147541,0.18032786885245902,Yes,0.819672131147541
47016,47016,99.00,2,1,3,0.6666666666666666,0.3333333333333333,Yes,0.6666666666666666
47017,47017,99.00,70,22,92,0.7608695652173914,0.2391304347826087,Yes,0.7608695652173914
47018,47018,99.00,40,26,66,0.6060606060606061,0.3939393939393939,Yes,0.6060606060606061
47019,47019,99.00,1,0,1,1.0,0.0,Yes,1.0
47020,47020,99.00,76,24,100,0.76,0.24,Yes,0.76
47021,47021,99.00,5,1,6,0.8333333333333334,0.16666666666666666,Yes,0.8333333333333334
47022,47022,99.00,4,4,8,0.5,0.5,Tie,0.5
47023,47023,99.00,99,31,130,0.7615384615384615,0.23846153846153847,Yes,0.7615384615384615
47024,47024,99.00,92,36,128,0.71875,0.28125,Yes,0.71875
47025,47025,99.00,94,36,130,0.7230769230769231,0.27692307692307694,Yes,0.7230769230769231
47026,47026,99.00,56,27,83,0.6746987951807228,0.3253012048192771,Yes,0.6746987951807228
47027,47027,99.00,76,32,108,0.7037037037037037,0.2962962962962963,Yes,0.7037037037037037
47028,47028,99.00,118,31,149,0.7919463087248322,0.2080536912751678,Yes,0.7919463087248322
47029,47029,99.00,87,32,119,0.7310924369747899,0.2689075630252101,Yes,0.7310924369747899
47030,47030,99.00,7,4,11,0.6363636363636364,0.36363636363636365,Yes,0.6363636363636364
47031,47031,99.00,91,23,114,0.7982456140350878,0.20175438596491227,Yes,0.7982456140350878
47032,47032,99.00,2,1,3,0.6666666666666666,0.3333333333333333,Yes,0.6666666666666666
47033,47033,99.00,1,0,1,1.0,0.0,Yes,1.0
47034,47034,99.00,0,0,0,0,0,n/a,0
47035,47035,99.00,0,0,0,0,0,n/a,0
47036,47036,99.00,2,0,2,1.0,0.0,Yes,1.0
47037,47037,99.00,83,23,106,0.7830188679245284,0.2169811320754717,Yes,0.7830188679245284
47038,47038,99.00,4,1,5,0.8,0.2,Yes,0.8
47039,47039,99.00,2,0,2,1.0,0.0,Yes,1.0
47040,47040,99.00,68,24,92,0.7391304347826086,0.2608695652173913,Yes,0.7391304347826086
47041,47041,99.00,1,1,2,0.5,0.5,Tie,0.5
47042,47042,99.00,3,0,3,1.0,0.0,Yes,1.0
47043,47043,99.00,105,47,152,0.6907894736842105,0.3092105263157895,Yes,0.6907894736842105
47044,47044,99.00,116,21,137,0.8467153284671532,0.15328467153284672,Yes,0.8467153284671532
47045,47045,99.00,68,17,85,0.8,0.2,Yes,0.8
47046,47046,99.00,55,25,80,0.6875,0.3125,Yes,0.6875
47047,47047,99.00,74,32,106,0.6981132075471698,0.3018867924528302,Yes,0.6981132075471698
47048,47048,99.00,79,40,119,0.6638655462184874,0.33613445378151263,Yes,0.6638655462184874
47049,47049,99.00,7,1,8,0.875,0.125,Yes,0.875
47050,47050,99.00,101,37,138,0.7318840579710145,0.26811594202898553,Yes,0.7318840579710145
47051,47051,99.00,105,47,152,0.6907894736842105,0.3092105263157895,Yes,0.6907894736842105
47052,47052,99.00,2,3,5,0.4,0.6,No,0.6
47053,47053,99.00,74,18,92,0.8043478260869565,0.1956521739130435,Yes,0.8043478260869565
47054,47054,99.00,1,1,2,0.5,0.5,Tie,0.5
47055,47055,99.00,112,28,140,0.8,0.2,Yes,0.8
47056,47056,99.00,0,0,0,0,0,n/a,0
47057,47057,99.00,87,36,123,0.7073170731707317,0.2926829268292683,Yes,0.7073170731707317
47058,47058,99.00,53,22,75,0.7066666666666667,0.29333333333333333,Yes,0.7066666666666667
47059,47059,99.00,50,14,64,0.78125,0.21875,Yes,0.78125
47060,47060,99.00,0,0,0,0,0,n/a,0
47061,47061,99.00,45,8,53,0.8490566037735849,0.1509433962264151,Yes,0.8490566037735849
47062,47062,99.00,72,25,97,0.7422680412371134,0.25773195876288657,Yes,0.7422680412371134
47063,47063,99.00,35,12,47,0.7446808510638298,0.2553191489361702,Yes,0.7446808510638298
47064,47064,99.00,82,39,121,0.6776859504132231,0.32231404958677684,Yes,0.6776859504132231
47065,47065,99.00,4,3,7,0.5714285714285714,0.42857142857142855,Yes,0.5714285714285714
47066,47066,99.00,0,1,1,0.0,1.0,No,1.0
47067,47067,99.00,0,0,0,0,0,n/a,0
47068,47068,99.00,0,1,1,0.0,1.0,No,1.0
47069,47069,99.00,5,2,7,0.7142857142857143,0.2857142857142857,Yes,0.7142857142857143
47070,47070,99.00,50,34,84,0.5952380952380952,0.40476190476190477,Yes,0.5952380952380952
47071,47071,99.00,9,1,10,0.9,0.1,Yes,0.9
47072,47072,44.44,52,10,62,0.8387096774193549,0.16129032258064516,Yes,0.8387096774193549
47073,47073,99.00,0,0,0,0,0,n/a,0
47074,47074,99.00,0,0,0,0,0,n/a,0
48001,48001,99.00,0,0,0,0,0,n/a,0
48002,48002,99.00,2,0,2,1.0,0.0,Yes,1.0
48003,48003,99.00,22,47,69,0.3188405797101449,0.6811594202898551,No,0.6811594202898551
48004,48004,99.00,42,116,158,0.26582278481012656,0.7341772151898734,No,0.7341772151898734
48005,48005,99.00,23,48,71,0.323943661971831,0.676056338028169,No,0.676056338028169
48006,48006,99.00,3,1,4,0.75,0.25,Yes,0.75
48007,48007,99.00,23,63,86,0.26744186046511625,0.7325581395348837,No,0.7325581395348837
48008,48008,99.00,4,8,12,0.3333333333333333,0.6666666666666666,No,0.6666666666666666
48009,48009,99.00,18,58,76,0.23684210526315788,0.7631578947368421,No,0.7631578947368421
48010,48010,99.00,25,100,125,0.2,0.8,No,0.8
48011,48011,99.00,0,0,0,0,0,n/a,0
48012,48012,99.00,1,2,3,0.3333333333333333,0.6666666666666666,No,0.6666666666666666
48013,48013,99.00,0,0,0,0,0,n/a,0
48014,48014,99.00,15,39,54,0.2777777777777778,0.7222222222222222,No,0.7222222222222222
48015,48015,99.00,27,146,173,0.15606936416184972,0.8439306358381503,No,0.8439306358381503
48016,48016,99.00,20,104,124,0.16129032258064516,0.8387096774193549,No,0.8387096774193549
48017,48017,99.00,1,0,1,1.0,0.0,Yes,1.0
48018,48018,99.00,9,97,106,0.08490566037735849,0.9150943396226415,No,0.9150943396226415
48019,48019,99.00,27,133,160,0.16875,0.83125,No,0.83125
48020,48020,99.00,0,0,0,0,0,n/a,0
48021,48021,99.00,7,56,63,0.1111111111111111,0.8888888888888888,No,0.8888888888888888
48022,48022,99.00,1,3,4,0.25,0.75,No,0.75
48023,48023,99.00,17,84,101,0.16831683168316833,0.8316831683168316,No,0.8316831683168316
48024,48024,99.00,9,68,77,0.11688311688311688,0.8831168831168831,No,0.8831168831168831
48025,48025,99.00,12,66,78,0.15384615384615385,0.8461538461538461,No,0.8461538461538461
48026,48026,99.00,81,158,239,0.3389121338912134,0.6610878661087866,No,0.6610878661087866
48027,48027,99.00,0,2,2,0.0,1.0,No,1.0
48028,48028,99.00,1,3,4,0.25,0.75,No,0.75
48029,48029,99.00,38,151,189,0.20105820105820105,0.798941798941799,No,0.798941798941799
48030,48030,99.00,22,177,199,0.11055276381909548,0.8894472361809045,No,0.8894472361809045
48031,48031,99.00,43,15,58,0.7413793103448276,0.25862068965517243,Yes,0.7413793103448276
48032,48032,99.00,38,144,182,0.2087912087912088,0.7912087912087912,No,0.7912087912087912
48033,48033,99.00,3,4,7,0.42857142857142855,0.5714285714285714,No,0.5714285714285714
48034,48034,99.00,29,11,40,0.725,0.275,Yes,0.725
48035,48035,99.00,5,4,9,0.5555555555555556,0.4444444444444444,Yes,0.5555555555555556
48036,48036,99.00,60,31,91,0.6593406593406593,0.34065934065934067,Yes,0.6593406593406593
48037,48037,99.00,2,2,4,0.5,0.5,Tie,0.5
48038,48038,99.00,1,2,3,0.3333333333333333,0.6666666666666666,No,0.6666666666666666
48039,48039,99.00,2,1,3,0.6666666666666666,0.3333333333333333,Yes,0.6666666666666666
48040,48040,99.00,47,100,147,0.3197278911564626,0.6802721088435374,No,0.6802721088435374
48041,48041,99.00,2,0,2,1.0,0.0,Yes,1.0
48042,48042,99.00,59,134,193,0.30569948186528495,0.694300518134715,No,0.694300518134715
48043,48043,99.00,72,37,109,0.6605504587155964,0.3394495412844037,Yes,0.6605504587155964
48044,48044,99.00,59,16,75,0.7866666666666666,0.21333333333333335,Yes,0.7866666666666666
48045,48045,99.00,2,2,4,0.5,0.5,Tie,0.5
48046,48046,99.00,2,1,3,0.6666666666666666,0.3333333333333333,Yes,0.6666666666666666
48047,48047,99.00,48,74,122,0.39344262295081966,0.6065573770491803,No,0.6065573770491803
48048,48048,99.00,10,80,90,0.1111111111111111,0.8888888888888888,No,0.8888888888888888
48049,48049,99.00,12,9,21,0.5714285714285714,0.42857142857142855,Yes,0.5714285714285714
48050,48050,75.00,6,50,56,0.10714285714285714,0.8928571428571429,No,0.8928571428571429
48051,48051,99.00,79,68,147,0.5374149659863946,0.46258503401360546,Yes,0.5374149659863946
48052,48052,99.00,18,58,76,0.23684210526315788,0.7631578947368421,No,0.7631578947368421
48053,48053,99.00,0,0,0,0,0,n/a,0
48054,48054,99.00,4,2,6,0.6666666666666666,0.3333333333333333,Yes,0.6666666666666666
48055,48055,99.00,98,143,241,0.4066390041493776,0.5933609958506224,No,0.5933609958506224
48056,48056,99.00,63,97,160,0.39375,0.60625,No,0.60625
48057,48057,99.00,5,1,6,0.8333333333333334,0.16666666666666666,Yes,0.8333333333333334
48058,48058,99.00,2,1,3,0.6666666666666666,0.3333333333333333,Yes,0.6666666666666666
48059,48059,99.00,18,123,141,0.1276595744680851,0.8723404255319149,No,0.8723404255319149
48060,48060,99.00,40,122,162,0.24691358024691357,0.7530864197530864,No,0.7530864197530864
48061,48061,99.00,47,158,205,0.22926829268292684,0.7707317073170732,No,0.7707317073170732
48062,48062,99.00,71,74,145,0.4896551724137931,0.5103448275862069,No,0.5103448275862069
48063,48063,99.00,70,43,113,0.6194690265486725,0.3805309734513274,Yes,0.6194690265486725
48064,48064,99.00,15,50,65,0.23076923076923078,0.7692307692307693,No,0.7692307692307693
48065,48065,99.00,52,110,162,0.32098765432098764,0.6790123456790124,No,0.6790123456790124
48066,48066,99.00,0,0,0,0,0,n/a,0
48067,48067,99.00,13,28,41,0.3170731707317073,0.6829268292682927,No,0.6829268292682927
48068,48068,99.00,1,0,1,1.0,0.0,Yes,1.0
48069,48069,99.00,1,0,1,1.0,0.0,Yes,1.0
48070,48070,99.00,50,77,127,0.3937007874015748,0.6062992125984252,No,0.6062992125984252
48071,48071,99.00,13,103,116,0.11206896551724138,0.8879310344827587,No,0.8879310344827587
48072,48072,99.00,24,144,168,0.14285714285714285,0.8571428571428571,No,0.8571428571428571
49001,49001,99.00,84,14,98,0.8571428571428571,0.14285714285714285,Yes,0.8571428571428571
49002,49002,99.00,40,11,51,0.7843137254901961,0.21568627450980393,Yes,0.7843137254901961
49003,49003,66.67,11,1,12,0.9166666666666666,0.08333333333333333,Yes,0.9166666666666666
49004,49004,66.67,94,20,114,0.8245614035087719,0.17543859649122806,Yes,0.8245614035087719
49005,49005,66.67,45,5,50,0.9,0.1,Yes,0.9
49006,49006,99.00,2,0,2,1.0,0.0,Yes,1.0
49007,49007,99.00,0,0,0,0,0,n/a,0
49008,49008,99.00,64,23,87,0.735632183908046,0.26436781609195403,Yes,0.735632183908046
49009,49009,99.00,36,11,47,0.7659574468085106,0.23404255319148937,Yes,0.7659574468085106
49010,49010,0.00,0,0,0,0,0,n/a,0
49011,49011,0.00,3,0,3,1.0,0.0,Yes,1.0
49012,49012,99.00,2,0,2,1.0,0.0,Yes,1.0
49013,49013,99.00,1,0,1,1.0,0.0,Yes,1.0
49014,49014,66.67,0,0,0,0,0,n/a,0
49015,49015,99.00,0,0,0,0,0,n/a,0
49016,49016,99.00,61,9,70,0.8714285714285714,0.12857142857142856,Yes,0.8714285714285714
49017,49017,99.00,58,26,84,0.6904761904761905,0.30952380952380953,Yes,0.6904761904761905
49018,49018,99.00,1,0,1,1.0,0.0,Yes,1.0
49019,49019,99.00,52,15,67,0.7761194029850746,0.22388059701492538,Yes,0.7761194029850746
49020,49020,99.00,125,32,157,0.7961783439490446,0.20382165605095542,Yes,0.7961783439490446
49021,49021,99.00,53,14,67,0.7910447761194029,0.208955223880597,Yes,0.7910447761194029
49022,49022,99.00,71,29,100,0.71,0.29,Yes,0.71
49023,49023,99.00,114,27,141,0.8085106382978723,0.19148936170212766,Yes,0.8085106382978723
49024,49024,99.00,4,0,4,1.0,0.0,Yes,1.0
49025,49025,99.00,77,38,115,0.6695652173913044,0.33043478260869563,Yes,0.6695652173913044
49026,49026,44.44,92,67,159,0.5786163522012578,0.42138364779874216,Yes,0.5786163522012578
49027,49027,44.44,63,18,81,0.7777777777777778,0.2222222222222222,Yes,0.7777777777777778
49028,49028,44.44,5,4,9,0.5555555555555556,0.4444444444444444,Yes,0.5555555555555556
49029,49029,99.00,0,0,0,0,0,n/a,0
49030,49030,99.00,3,0,3,1.0,0.0,Yes,1.0
49031,49031,99.00,36,15,51,0.7058823529411765,0.29411764705882354,Yes,0.7058823529411765
49032,49032,99.00,0,0,0,0,0,n/a,0
49033,49033,99.00,1,0,1,1.0,0.0,Yes,1.0
49034,49034,44.44,5,0,5,1.0,0.0,Yes,1.0
49035,49035,99.00,133,44,177,0.751412429378531,0.24858757062146894,Yes,0.751412429378531
49036,49036,44.44,1,0,1,1.0,0.0,Yes,1.0
49037,49037,99.00,46,21,67,0.6865671641791045,0.31343283582089554,Yes,0.6865671641791045
49038,49038,99.00,40,16,56,0.7142857142857143,0.2857142857142857,Yes,0.7142857142857143
49039,49039,99.00,7,1,8,0.875,0.125,Yes,0.875
49040,49040,99.00,115,30,145,0.7931034482758621,0.20689655172413793,Yes,0.7931034482758621
49041,49041,99.00,58,24,82,0.7073170731707317,0.2926829268292683,Yes,0.7073170731707317
49042,49042,99.00,51,16,67,0.7611940298507462,0.23880597014925373,Yes,0.7611940298507462
49043,49043,99.00,36,21,57,0.631578947368421,0.3684210526315789,Yes,0.631578947368421
49044,49044,44.44,5,1,6,0.8333333333333334,0.16666666666666666,Yes,0.8333333333333334
49045,49045,99.00,3,0,3,1.0,0.0,Yes,1.0
49046,49046,99.00,0,0,0,0,0,n/a,0
49047,49047,99.00,81,26,107,0.7570093457943925,0.24299065420560748,Yes,0.7570093457943925
49048,49048,99.00,70,27,97,0.7216494845360825,0.27835051546391754,Yes,0.7216494845360825
49049,49049,99.00,135,59,194,0.6958762886597938,0.30412371134020616,Yes,0.6958762886597938
49050,49050,99.00,137,49,186,0.7365591397849462,0.26344086021505375,Yes,0.7365591397849462
49051,49051,99.00,8,3,11,0.7272727272727273,0.2727272727272727,Yes,0.7272727272727273
49052,49052,99.00,3,5,8,0.375,0.625,No,0.625
49053,49053,99.00,158,59,217,0.728110599078341,0.271889400921659,Yes,0.728110599078341
49054,49054,99.00,163,75,238,0.6848739495798319,0.31512605042016806,Yes,0.6848739495798319
49055,49055,99.00,49,18,67,0.7313432835820896,0.26865671641791045,Yes,0.7313432835820896
49056,49056,99.00,0,0,0,0,0,n/a,0
49057,49057,99.00,0,0,0,0,0,n/a,0
49058,49058,99.00,61,19,80,0.7625,0.2375,Yes,0.7625
49059,49059,44.44,88,38,126,0.6984126984126984,0.30158730158730157,Yes,0.6984126984126984
49060,49060,99.00,0,0,0,0,0,n/a,0
49061,49061,0.00,1,0,1,1.0,0.0,Yes,1.0
49062,49062,66.67,87,14,101,0.8613861386138614,0.13861386138613863,Yes,0.8613861386138614
49063,49063,99.00,4,2,6,0.6666666666666666,0.3333333333333333,Yes,0.6666666666666666
49064,49064,99.00,40,18,58,0.6896551724137931,0.3103448275862069,Yes,0.6896551724137931
49065,49065,99.00,9,3,12,0.75,0.25,Yes,0.75
49066,49066,99.00,47,5,52,0.9038461538461539,0.09615384615384616,Yes,0.9038461538461539
49067,49067,66.67,6,5,11,0.5454545454545454,0.45454545454545453,Yes,0.5454545454545454
49068,49068,99.00,37,11,48,0.7708333333333334,0.22916666666666666,Yes,0.7708333333333334
49069,49069,99.00,2,1,3,0.6666666666666666,0.3333333333333333,Yes,0.6666666666666666
49070,49070,99.00,1,0,1,1.0,0.0,Yes,1.0
49071,49071,99.00,0,0,0,0,0,n/a,0
50001,50001,99.00,32,13,45,0.7111111111111111,0.28888888888888886,Yes,0.7111111111111111
50002,50002,99.00,153,40,193,0.7927461139896373,0.20725388601036268,Yes,0.7927461139896373
50003,50003,66.67,172,32,204,0.8431372549019608,0.1568627450980392,Yes,0.8431372549019608
50004,50004,99.00,1,2,3,0.3333333333333333,0.6666666666666666,No,0.6666666666666666
50005,50005,66.67,122,20,142,0.8591549295774648,0.14084507042253522,Yes,0.8591549295774648
50006,50006,66.67,114,31,145,0.7862068965517242,0.21379310344827587,Yes,0.7862068965517242
50007,50007,99.00,192,44,236,0.8135593220338984,0.1864406779661017,Yes,0.8135593220338984
50008,50008,99.00,172,30,202,0.8514851485148515,0.1485148514851485,Yes,0.8514851485148515
50009,50009,99.00,151,37,188,0.8031914893617021,0.19680851063829788,Yes,0.8031914893617021
50010,50010,99.00,257,63,320,0.803125,0.196875,Yes,0.803125
50011,50011,99.00,3,1,4,0.75,0.25,Yes,0.75
50012,50012,80.00,210,52,262,0.8015267175572519,0.1984732824427481,Yes,0.8015267175572519
50013,50013,99.00,3,2,5,0.6,0.4,Yes,0.6
50014,50014,99.00,95,11,106,0.8962264150943396,0.10377358490566038,Yes,0.8962264150943396
50015,50015,80.00,8,0,8,1.0,0.0,Yes,1.0
50016,50016,99.00,2,0,2,1.0,0.0,Yes,1.0
50017,50017,99.00,116,21,137,0.8467153284671532,0.15328467153284672,Yes,0.8467153284671532
50018,50018,80.00,7,5,12,0.5833333333333334,0.4166666666666667,Yes,0.5833333333333334
50019,50019,80.00,240,54,294,0.8163265306122449,0.1836734693877551,Yes,0.8163265306122449
50020,50020,99.00,13,1,14,0.9285714285714286,0.07142857142857142,Yes,0.9285714285714286
50021,50021,99.00,326,54,380,0.8578947368421053,0.14210526315789473,Yes,0.8578947368421053
50022,50022,99.00,78,28,106,0.7358490566037735,0.2641509433962264,Yes,0.7358490566037735
50023,50023,99.00,0,0,0,0,0,n/a,0
50024,50024,99.00,0,0,0,0,0,n/a,0
50025,50025,99.00,1,0,1,1.0,0.0,Yes,1.0
50026,50026,99.00,174,36,210,0.8285714285714286,0.17142857142857143,Yes,0.8285714285714286
50027,50027,99.00,168,33,201,0.835820895522388,0.16417910447761194,Yes,0.835820895522388
50028,50028,99.00,181,32,213,0.8497652582159625,0.15023474178403756,Yes,0.8497652582159625
50029,50029,99.00,9,4,13,0.6923076923076923,0.3076923076923077,Yes,0.6923076923076923
50030,50030,99.00,170,39,209,0.8133971291866029,0.18660287081339713,Yes,0.8133971291866029
50031,50031,99.00,8,1,9,0.8888888888888888,0.1111111111111111,Yes,0.8888888888888888
50032,50032,99.00,250,53,303,0.8250825082508251,0.17491749174917492,Yes,0.8250825082508251
50033,50033,80.00,180,28,208,0.8653846153846154,0.1346153846153846,Yes,0.8653846153846154
50034,50034,99.00,144,21,165,0.8727272727272727,0.12727272727272726,Yes,0.8727272727272727
50035,50035,99.00,153,28,181,0.8453038674033149,0.15469613259668508,Yes,0.8453038674033149
50036,50036,99.00,94,23,117,0.8034188034188035,0.19658119658119658,Yes,0.8034188034188035
50037,50037,99.00,122,35,157,0.7770700636942676,0.2229299363057325,Yes,0.7770700636942676
50038,50038,99.00,94,24,118,0.7966101694915254,0.2033898305084746,Yes,0.7966101694915254
50039,50039,99.00,98,40,138,0.7101449275362319,0.2898550724637681,Yes,0.7101449275362319
50040,50040,99.00,92,33,125,0.736,0.264,Yes,0.736
50041,50041,99.00,130,39,169,0.7692307692307693,0.23076923076923078,Yes,0.7692307692307693
50042,50042,80.00,164,50,214,0.7663551401869159,0.2336448598130841,Yes,0.7663551401869159
50043,50043,99.00,123,35,158,0.7784810126582279,0.22151898734177214,Yes,0.7784810126582279
50044,50044,99.00,6,4,10,0.6,0.4,Yes,0.6
50045,50045,99.00,1,0,1,1.0,0.0,Yes,1.0
50046,50046,99.00,108,29,137,0.7883211678832117,0.2116788321167883,Yes,0.7883211678832117
50047,50047,99.00,3,4,7,0.42857142857142855,0.5714285714285714,No,0.5714285714285714
50048,50048,99.00,104,35,139,0.7482014388489209,0.2517985611510791,Yes,0.7482014388489209
50049,50049,99.00,2,1,3,0.6666666666666666,0.3333333333333333,Yes,0.6666666666666666
50050,50050,99.00,182,45,227,0.801762114537445,0.19823788546255505,Yes,0.801762114537445
50051,50051,99.00,180,29,209,0.861244019138756,0.13875598086124402,Yes,0.861244019138756
50052,50052,99.00,95,17,112,0.8482142857142857,0.15178571428571427,Yes,0.8482142857142857
50053,50053,99.00,118,23,141,0.8368794326241135,0.16312056737588654,Yes,0.8368794326241135
50054,50054,99.00,2,0,2,1.0,0.0,Yes,1.0
50055,50055,99.00,0,0,0,0,0,n/a,0
50056,50056,99.00,17,4,21,0.8095238095238095,0.19047619047619047,Yes,0.8095238095238095
50057,50057,99.00,53,25,78,0.6794871794871795,0.32051282051282054,Yes,0.6794871794871795
50058,50058,99.00,1,0,1,1.0,0.0,Yes,1.0
50059,50059,99.00,127,24,151,0.8410596026490066,0.15894039735099338,Yes,0.8410596026490066
50060,50060,99.00,1,1,2,0.5,0.5,Tie,0.5
50061,50061,99.00,50,9,59,0.847457627118644,0.15254237288135594,Yes,0.847457627118644
50062,50062,99.00,0,0,0,0,0,n/a,0
50063,50063,99.00,28,18,46,0.6086956521739131,0.391304347826087,Yes,0.6086956521739131
50064,50064,99.00,20,4,24,0.8333333333333334,0.16666666666666666,Yes,0.8333333333333334
50065,50065,99.00,0,0,0,0,0,n/a,0
50066,50066,99.00,3,11,14,0.21428571428571427,0.7857142857142857,No,0.7857142857142857
50067,50067,99.00,1,0,1,1.0,0.0,Yes,1.0
50068,50068,99.00,17,11,28,0.6071428571428571,0.39285714285714285,Yes,0.6071428571428571
50069,50069,99.00,32,25,57,0.5614035087719298,0.43859649122807015,Yes,0.5614035087719298
50070,50070,99.00,0,0,0,0,0,n/a,0
50071,50071,99.00,0,0,0,0,0,n/a,0
50072,50072,99.00,50,26,76,0.6578947368421053,0.34210526315789475,Yes,0.6578947368421053
50073,50073,99.00,0,0,0,0,0,n/a,0
50074,50074,99.00,1,5,6,0.16666666666666666,0.8333333333333334,No,0.8333333333333334
50075,50075,99.00,18,8,26,0.6923076923076923,0.3076923076923077,Yes,0.6923076923076923
50076,50076,99.00,26,16,42,0.6190476190476191,0.38095238095238093,Yes,0.6190476190476191
50077,50077,99.00,10,18,28,0.35714285714285715,0.6428571428571429,No,0.6428571428571429
50078,50078,99.00,15,16,31,0.4838709677419355,0.5161290322580645,No,0.5161290322580645
50079,50079,99.00,0,0,0,0,0,n/a,0
50080,50080,99.00,3,0,3,1.0,0.0,Yes,1.0
50081,50081,99.00,0,0,0,0,0,n/a,0
50082,50082,99.00,37,16,53,0.6981132075471698,0.3018867924528302,Yes,0.6981132075471698
50083,50083,99.00,55,10,65,0.8461538461538461,0.15384615384615385,Yes,0.8461538461538461
50084,50084,99.00,0,0,0,0,0,n/a,0
50085,50085,99.00,38,8,46,0.8260869565217391,0.17391304347826086,Yes,0.8260869565217391
50086,50086,99.00,0,0,0,0,0,n/a,0
50087,50087,99.00,2,2,4,0.5,0.5,Tie,0.5
50088,50088,99.00,2,0,2,1.0,0.0,Yes,1.0
50089,50089,99.00,145,26,171,0.847953216374269,0.15204678362573099,Yes,0.847953216374269
50090,50090,99.00,102,17,119,0.8571428571428571,0.14285714285714285,Yes,0.8571428571428571
50091,50091,99.00,4,1,5,0.8,0.2,Yes,0.8
50092,50092,99.00,214,60,274,0.781021897810219,0.21897810218978103,Yes,0.781021897810219
50093,50093,99.00,0,0,0,0,0,n/a,0
50094,50094,99.00,0,1,1,0.0,1.0,No,1.0
50095,50095,99.00,138,49,187,0.7379679144385026,0.2620320855614973,Yes,0.7379679144385026
50096,50096,99.00,99,28,127,0.7795275590551181,0.2204724409448819,Yes,0.7795275590551181
50097,50097,99.00,198,36,234,0.8461538461538461,0.15384615384615385,Yes,0.8461538461538461
50098,50098,99.00,0,0,0,0,0,n/a,0
50099,50099,99.00,139,28,167,0.8323353293413174,0.16766467065868262,Yes,0.8323353293413174
50100,50100,99.00,0,0,0,0,0,n/a,0
50101,50101,99.00,4,2,6,0.6666666666666666,0.3333333333333333,Yes,0.6666666666666666
50102,50102,80.00,3,6,9,0.3333333333333333,0.6666666666666666,No,0.6666666666666666
50103,50103,99.00,0,0,0,0,0,n/a,0
50104,50104,99.00,0,0,0,0,0,n/a,0
50105,50105,99.00,0,0,0,0,0,n/a,0
50106,50106,99.00,0,0,0,0,0,n/a,0
50107,50107,99.00,0,0,0,0,0,n/a,0
51001,51001,99.00,144,27,171,0.8421052631578947,0.15789473684210525,Yes,0.8421052631578947
51002,51002,99.00,65,21,86,0.7558139534883721,0.2441860465116279,Yes,0.7558139534883721
51003,51003,99.00,121,26,147,0.8231292517006803,0.17687074829931973,Yes,0.8231292517006803
51004,51004,99.00,95,13,108,0.8796296296296297,0.12037037037037036,Yes,0.8796296296296297
51005,51005,99.00,57,9,66,0.8636363636363636,0.13636363636363635,Yes,0.8636363636363636
51006,51006,99.00,11,2,13,0.8461538461538461,0.15384615384615385,Yes,0.8461538461538461
51007,51007,99.00,189,39,228,0.8289473684210527,0.17105263157894737,Yes,0.8289473684210527
51008,51008,0.00,1,0,1,1.0,0.0,Yes,1.0
51009,51009,99.00,42,6,48,0.875,0.125,Yes,0.875
51010,51010,99.00,1,0,1,1.0,0.0,Yes,1.0
51011,51011,99.00,261,68,329,0.7933130699088146,0.2066869300911854,Yes,0.7933130699088146
51012,51012,99.00,199,32,231,0.8614718614718615,0.13852813852813853,Yes,0.8614718614718615
51013,51013,99.00,17,2,19,0.8947368421052632,0.10526315789473684,Yes,0.8947368421052632
51014,51014,99.00,82,70,152,0.5394736842105263,0.4605263157894737,Yes,0.5394736842105263
51015,51015,99.00,2,0,2,1.0,0.0,Yes,1.0
51016,51016,99.00,34,43,77,0.44155844155844154,0.5584415584415584,No,0.5584415584415584
51017,51017,99.00,69,24,93,0.7419354838709677,0.25806451612903225,Yes,0.7419354838709677
51018,51018,99.00,0,0,0,0,0,n/a,0
51019,51019,99.00,1,1,2,0.5,0.5,Tie,0.5
51020,51020,0.00,42,14,56,0.75,0.25,Yes,0.75
51021,51021,99.00,2,1,3,0.6666666666666666,0.3333333333333333,Yes,0.6666666666666666
51022,51022,99.00,9,2,11,0.8181818181818182,0.18181818181818182,Yes,0.8181818181818182
51023,51023,99.00,17,2,19,0.8947368421052632,0.10526315789473684,Yes,0.8947368421052632
51024,51024,50.00,39,13,52,0.75,0.25,Yes,0.75
51025,51025,99.00,0,0,0,0,0,n/a,0
51026,51026,99.00,95,26,121,0.7851239669421488,0.21487603305785125,Yes,0.7851239669421488
51027,51027,99.00,3,1,4,0.75,0.25,Yes,0.75
51028,51028,99.00,0,0,0,0,0,n/a,0
51029,51029,66.67,96,19,115,0.8347826086956521,0.16521739130434782,Yes,0.8347826086956521
51030,51030,99.00,2,3,5,0.4,0.6,No,0.6
51031,51031,99.00,128,38,166,0.7710843373493976,0.2289156626506024,Yes,0.7710843373493976
51032,51032,66.67,99,24,123,0.8048780487804879,0.1951219512195122,Yes,0.8048780487804879
51033,51033,66.67,67,9,76,0.881578947368421,0.11842105263157894,Yes,0.881578947368421
51034,51034,99.00,117,20,137,0.8540145985401459,0.145985401459854,Yes,0.8540145985401459
51035,51035,99.00,119,26,145,0.8206896551724138,0.1793103448275862,Yes,0.8206896551724138
51036,51036,99.00,99,17,116,0.853448275862069,0.14655172413793102,Yes,0.853448275862069
51037,51037,99.00,104,17,121,0.859504132231405,0.14049586776859505,Yes,0.859504132231405
51038,51038,99.00,176,32,208,0.8461538461538461,0.15384615384615385,Yes,0.8461538461538461
51039,51039,99.00,97,19,116,0.8362068965517241,0.16379310344827586,Yes,0.8362068965517241
51040,51040,99.00,173,40,213,0.812206572769953,0.18779342723004694,Yes,0.812206572769953
51041,51041,99.00,303,55,358,0.8463687150837989,0.15363128491620112,Yes,0.8463687150837989
51042,51042,99.00,202,36,238,0.8487394957983193,0.15126050420168066,Yes,0.8487394957983193
51043,51043,99.00,81,19,100,0.81,0.19,Yes,0.81
51044,51044,0.00,7,2,9,0.7777777777777778,0.2222222222222222,Yes,0.7777777777777778
51045,51045,0.00,0,0,0,0,0,n/a,0
51046,51046,99.00,2,0,2,1.0,0.0,Yes,1.0
51047,51047,99.00,3,3,6,0.5,0.5,Tie,0.5
51048,51048,99.00,0,0,0,0,0,n/a,0
51049,51049,99.00,205,38,243,0.8436213991769548,0.15637860082304528,Yes,0.8436213991769548
51050,51050,99.00,1,0,1,1.0,0.0,Yes,1.0
51051,51051,99.00,94,20,114,0.8245614035087719,0.17543859649122806,Yes,0.8245614035087719
51052,51052,99.00,130,23,153,0.8496732026143791,0.1503267973856209,Yes,0.8496732026143791
51053,51053,99.00,6,1,7,0.8571428571428571,0.14285714285714285,Yes,0.8571428571428571
51054,51054,99.00,91,21,112,0.8125,0.1875,Yes,0.8125
51055,51055,99.00,13,2,15,0.8666666666666667,0.13333333333333333,Yes,0.8666666666666667
51056,51056,99.00,0,0,0,0,0,n/a,0
51057,51057,99.00,0,0,0,0,0,n/a,0
51058,51058,99.00,1,0,1,1.0,0.0,Yes,1.0
51059,51059,99.00,5,1,6,0.8333333333333334,0.16666666666666666,Yes,0.8333333333333334
51060,51060,99.00,122,29,151,0.8079470198675497,0.19205298013245034,Yes,0.8079470198675497
51061,51061,99.00,117,28,145,0.8068965517241379,0.19310344827586207,Yes,0.8068965517241379
51062,51062,99.00,179,62,241,0.7427385892116183,0.2572614107883817,Yes,0.7427385892116183
51063,51063,99.00,123,30,153,0.803921568627451,0.19607843137254902,Yes,0.803921568627451
51064,51064,99.00,95,16,111,0.8558558558558559,0.14414414414414414,Yes,0.8558558558558559
51065,51065,99.00,58,17,75,0.7733333333333333,0.22666666666666666,Yes,0.7733333333333333
51066,51066,99.00,96,13,109,0.8807339449541285,0.11926605504587157,Yes,0.8807339449541285
51067,51067,99.00,2,2,4,0.5,0.5,Tie,0.5
51068,51068,99.00,2,2,4,0.5,0.5,Tie,0.5
51069,51069,0.00,2,1,3,0.6666666666666666,0.3333333333333333,Yes,0.6666666666666666
51070,51070,99.00,164,33,197,0.8324873096446701,0.16751269035532995,Yes,0.8324873096446701
51071,51071,99.00,56,14,70,0.8,0.2,Yes,0.8
51072,51072,99.00,4,1,5,0.8,0.2,Yes,0.8
51073,51073,99.00,105,16,121,0.8677685950413223,0.1322314049586777,Yes,0.8677685950413223
51074,51074,99.00,2,0,2,1.0,0.0,Yes,1.0
51075,51075,66.67,12,4,16,0.75,0.25,Yes,0.75
51076,51076,99.00,6,3,9,0.6666666666666666,0.3333333333333333,Yes,0.6666666666666666
51077,51077,99.00,144,61,205,0.7024390243902439,0.2975609756097561,Yes,0.7024390243902439
51078,51078,99.00,2,0,2,1.0,0.0,Yes,1.0
51079,51079,99.00,101,20,121,0.8347107438016529,0.1652892561983471,Yes,0.8347107438016529
51080,51080,99.00,1,0,1,1.0,0.0,Yes,1.0
51081,51081,99.00,79,16,95,0.8315789473684211,0.16842105263157894,Yes,0.8315789473684211
51082,51082,99.00,172,38,210,0.819047619047619,0.18095238095238095,Yes,0.819047619047619
51083,51083,99.00,237,44,281,0.8434163701067615,0.15658362989323843,Yes,0.8434163701067615
51084,51084,99.00,0,0,0,0,0,n/a,0
51085,51085,99.00,0,0,0,0,0,n/a,0
51086,51086,99.00,0,0,0,0,0,n/a,0
51087,51087,0.00,0,0,0,0,0,n/a,0
52001,52001,99.00,92,21,113,0.8141592920353983,0.18584070796460178,Yes,0.8141592920353983
52002,52002,99.00,82,21,103,0.7961165048543689,0.20388349514563106,Yes,0.7961165048543689
52003,52003,18.75,4,6,10,0.4,0.6,No,0.6
52004,52004,99.00,216,66,282,0.7659574468085106,0.23404255319148937,Yes,0.7659574468085106
52005,52005,99.00,5,2,7,0.7142857142857143,0.2857142857142857,Yes,0.7142857142857143
52006,52006,99.00,9,5,14,0.6428571428571429,0.35714285714285715,Yes,0.6428571428571429
52007,52007,99.00,270,89,359,0.7520891364902507,0.2479108635097493,Yes,0.7520891364902507
52008,52008,99.00,374,133,507,0.73767258382643,0.26232741617357,Yes,0.73767258382643
52009,52009,99.00,12,1,13,0.9230769230769231,0.07692307692307693,Yes,0.9230769230769231
52010,52010,99.00,249,87,336,0.7410714285714286,0.25892857142857145,Yes,0.7410714285714286
52011,52011,99.00,256,89,345,0.7420289855072464,0.2579710144927536,Yes,0.7420289855072464
52012,52012,99.00,251,78,329,0.7629179331306991,0.23708206686930092,Yes,0.7629179331306991
52013,52013,99.00,42,13,55,0.7636363636363637,0.23636363636363636,Yes,0.7636363636363637
52014,52014,99.00,16,8,24,0.6666666666666666,0.3333333333333333,Yes,0.6666666666666666
52015,52015,99.00,325,121,446,0.7286995515695067,0.2713004484304933,Yes,0.7286995515695067
52016,52016,99.00,318,98,416,0.7644230769230769,0.23557692307692307,Yes,0.7644230769230769
52017,52017,99.00,31,5,36,0.8611111111111112,0.1388888888888889,Yes,0.8611111111111112
52018,52018,99.00,286,97,383,0.7467362924281984,0.25326370757180156,Yes,0.7467362924281984
52019,52019,99.00,313,94,407,0.769041769041769,0.23095823095823095,Yes,0.769041769041769
52020,52020,99.00,123,54,177,0.6949152542372882,0.3050847457627119,Yes,0.6949152542372882
52021,52021,99.00,2,4,6,0.3333333333333333,0.6666666666666666,No,0.6666666666666666
52022,52022,99.00,10,4,14,0.7142857142857143,0.2857142857142857,Yes,0.7142857142857143
52023,52023,18.75,319,108,427,0.747072599531616,0.2529274004683841,Yes,0.747072599531616
52024,52024,99.00,58,14,72,0.8055555555555556,0.19444444444444445,Yes,0.8055555555555556
52025,52025,18.75,228,88,316,0.7215189873417721,0.27848101265822783,Yes,0.7215189873417721
52026,52026,99.00,7,2,9,0.7777777777777778,0.2222222222222222,Yes,0.7777777777777778
52027,52027,99.00,368,176,544,0.6764705882352942,0.3235294117647059,Yes,0.6764705882352942
52028,52028,99.00,132,64,196,0.673469387755102,0.32653061224489793,Yes,0.673469387755102
52029,52029,99.00,272,81,353,0.7705382436260623,0.22946175637393768,Yes,0.7705382436260623
52030,52030,99.00,184,46,230,0.8,0.2,Yes,0.8
52031,52031,99.00,199,54,253,0.7865612648221344,0.2134387351778656,Yes,0.7865612648221344
52032,52032,99.00,203,38,241,0.8423236514522822,0.15767634854771784,Yes,0.8423236514522822
52033,52033,99.00,228,53,281,0.8113879003558719,0.18861209964412812,Yes,0.8113879003558719
52034,52034,99.00,164,63,227,0.7224669603524229,0.2775330396475771,Yes,0.7224669603524229
52035,52035,80.00,152,51,203,0.7487684729064039,0.2512315270935961,Yes,0.7487684729064039
52036,52036,80.00,15,2,17,0.8823529411764706,0.11764705882352941,Yes,0.8823529411764706
52037,52037,80.00,27,11,38,0.7105263157894737,0.2894736842105263,Yes,0.7105263157894737
52038,52038,80.00,381,120,501,0.7604790419161677,0.23952095808383234,Yes,0.7604790419161677
52039,52039,80.00,211,63,274,0.7700729927007299,0.22992700729927007,Yes,0.7700729927007299
52040,52040,80.00,86,32,118,0.7288135593220338,0.2711864406779661,Yes,0.7288135593220338
52041,52041,99.00,2,3,5,0.4,0.6,No,0.6
52042,52042,99.00,205,49,254,0.8070866141732284,0.19291338582677164,Yes,0.8070866141732284
52043,52043,50.00,115,34,149,0.7718120805369127,0.22818791946308725,Yes,0.7718120805369127
52044,52044,99.00,312,107,419,0.7446300715990454,0.2553699284009546,Yes,0.7446300715990454
52045,52045,99.00,13,7,20,0.65,0.35,Yes,0.65
52046,52046,50.00,94,27,121,0.7768595041322314,0.2231404958677686,Yes,0.7768595041322314
52047,52047,99.00,11,5,16,0.6875,0.3125,Yes,0.6875
52048,52048,99.00,17,4,21,0.8095238095238095,0.19047619047619047,Yes,0.8095238095238095
52049,52049,99.00,12,2,14,0.8571428571428571,0.14285714285714285,Yes,0.8571428571428571
52050,52050,99.00,6,0,6,1.0,0.0,Yes,1.0
52051,52051,99.00,179,31,210,0.8523809523809524,0.14761904761904762,Yes,0.8523809523809524
52052,52052,99.00,80,15,95,0.8421052631578947,0.15789473684210525,Yes,0.8421052631578947
52053,52053,99.00,1,1,2,0.5,0.5,Tie,0.5
52054,52054,99.00,0,0,0,0,0,n/a,0
52055,52055,99.00,255,58,313,0.8146964856230032,0.1853035143769968,Yes,0.8146964856230032
52056,52056,99.00,156,39,195,0.8,0.2,Yes,0.8
52057,52057,99.00,304,69,373,0.8150134048257373,0.18498659517426275,Yes,0.8150134048257373
52058,52058,99.00,11,3,14,0.7857142857142857,0.21428571428571427,Yes,0.7857142857142857
52059,52059,99.00,349,88,437,0.7986270022883295,0.20137299771167047,Yes,0.7986270022883295
52060,52060,99.00,12,4,16,0.75,0.25,Yes,0.75
52061,52061,99.00,281,62,343,0.8192419825072886,0.18075801749271136,Yes,0.8192419825072886
52062,52062,99.00,9,5,14,0.6428571428571429,0.35714285714285715,Yes,0.6428571428571429
52063,52063,99.00,0,0,0,0,0,n/a,0
52064,52064,99.00,293,80,373,0.7855227882037533,0.21447721179624665,Yes,0.7855227882037533
52065,52065,99.00,9,2,11,0.8181818181818182,0.18181818181818182,Yes,0.8181818181818182
52066,52066,99.00,362,100,462,0.7835497835497836,0.21645021645021645,Yes,0.7835497835497836
52067,52067,99.00,8,0,8,1.0,0.0,Yes,1.0
52068,52068,99.00,32,13,45,0.7111111111111111,0.28888888888888886,Yes,0.7111111111111111
52069,52069,99.00,385,124,509,0.756385068762279,0.24361493123772102,Yes,0.756385068762279
52070,52070,99.00,235,98,333,0.7057057057057057,0.29429429429429427,Yes,0.7057057057057057
52071,52071,99.00,403,112,515,0.7825242718446602,0.2174757281553398,Yes,0.7825242718446602
52072,52072,99.00,28,4,32,0.875,0.125,Yes,0.875
52073,52073,99.00,291,85,376,0.773936170212766,0.22606382978723405,Yes,0.773936170212766
52074,52074,99.00,20,11,31,0.6451612903225806,0.3548387096774194,Yes,0.6451612903225806
52075,52075,99.00,348,83,431,0.8074245939675174,0.1925754060324826,Yes,0.8074245939675174
52076,52076,99.00,65,20,85,0.7647058823529411,0.23529411764705882,Yes,0.7647058823529411
52077,52077,99.00,12,1,13,0.9230769230769231,0.07692307692307693,Yes,0.9230769230769231
52078,52078,99.00,236,62,298,0.7919463087248322,0.2080536912751678,Yes,0.7919463087248322
52079,52079,99.00,5,1,6,0.8333333333333334,0.16666666666666666,Yes,0.8333333333333334
52080,52080,99.00,12,2,14,0.8571428571428571,0.14285714285714285,Yes,0.8571428571428571
52081,52081,99.00,227,61,288,0.7881944444444444,0.21180555555555555,Yes,0.7881944444444444
52082,52082,99.00,324,70,394,0.8223350253807107,0.17766497461928935,Yes,0.8223350253807107
52083,52083,99.00,39,14,53,0.7358490566037735,0.2641509433962264,Yes,0.7358490566037735
52084,52084,99.00,320,86,406,0.7881773399014779,0.21182266009852216,Yes,0.7881773399014779
52085,52085,99.00,314,78,392,0.8010204081632653,0.1989795918367347,Yes,0.8010204081632653
52086,52086,99.00,29,6,35,0.8285714285714286,0.17142857142857143,Yes,0.8285714285714286
52087,52087,99.00,404,131,535,0.7551401869158878,0.24485981308411214,Yes,0.7551401869158878
52088,52088,99.00,19,4,23,0.8260869565217391,0.17391304347826086,Yes,0.8260869565217391
52089,52089,99.00,330,98,428,0.7710280373831776,0.22897196261682243,Yes,0.7710280373831776
52090,52090,99.00,238,37,275,0.8654545454545455,0.13454545454545455,Yes,0.8654545454545455
52091,52091,99.00,8,4,12,0.6666666666666666,0.3333333333333333,Yes,0.6666666666666666
52092,52092,99.00,352,135,487,0.7227926078028748,0.27720739219712526,Yes,0.7227926078028748
52093,52093,99.00,22,8,30,0.7333333333333333,0.26666666666666666,Yes,0.7333333333333333
52094,52094,99.00,17,5,22,0.7727272727272727,0.22727272727272727,Yes,0.7727272727272727
52095,52095,0.00,1,0,1,1.0,0.0,Yes,1.0
52096,52096,99.00,182,55,237,0.7679324894514767,0.2320675105485232,Yes,0.7679324894514767
52097,52097,99.00,217,67,284,0.7640845070422535,0.23591549295774647,Yes,0.7640845070422535
52098,52098,99.00,358,96,454,0.788546255506608,0.21145374449339208,Yes,0.788546255506608
52099,52099,99.00,260,64,324,0.8024691358024691,0.19753086419753085,Yes,0.8024691358024691
52100,52100,99.00,290,91,381,0.7611548556430446,0.2388451443569554,Yes,0.7611548556430446
52101,52101,99.00,17,9,26,0.6538461538461539,0.34615384615384615,Yes,0.6538461538461539
52102,52102,99.00,204,63,267,0.7640449438202247,0.23595505617977527,Yes,0.7640449438202247
52103,52103,99.00,195,80,275,0.7090909090909091,0.2909090909090909,Yes,0.7090909090909091
52104,52104,99.00,12,3,15,0.8,0.2,Yes,0.8
52105,52105,99.00,255,80,335,0.7611940298507462,0.23880597014925373,Yes,0.7611940298507462
52106,52106,99.00,8,1,9,0.8888888888888888,0.1111111111111111,Yes,0.8888888888888888
52107,52107,99.00,288,73,361,0.7977839335180056,0.20221606648199447,Yes,0.7977839335180056
52108,52108,99.00,13,5,18,0.7222222222222222,0.2777777777777778,Yes,0.7222222222222222
52109,52109,99.00,4,0,4,1.0,0.0,Yes,1.0
52110,52110,80.00,9,3,12,0.75,0.25,Yes,0.75
52111,52111,99.00,7,5,12,0.5833333333333334,0.4166666666666667,Yes,0.5833333333333334
52112,52112,99.00,274,78,352,0.7784090909090909,0.2215909090909091,Yes,0.7784090909090909
52113,52113,99.00,226,61,287,0.7874564459930313,0.21254355400696864,Yes,0.7874564459930313
52114,52114,99.00,8,7,15,0.5333333333333333,0.4666666666666667,Yes,0.5333333333333333
52115,52115,18.75,35,14,49,0.7142857142857143,0.2857142857142857,Yes,0.7142857142857143
52116,52116,99.00,388,92,480,0.8083333333333333,0.19166666666666668,Yes,0.8083333333333333
52117,52117,99.00,24,15,39,0.6153846153846154,0.38461538461538464,Yes,0.6153846153846154
52118,52118,99.00,0,0,0,0,0,n/a,0
52119,52119,99.00,0,0,0,0,0,n/a,0
52120,52120,99.00,0,0,0,0,0,n/a,0
52121,52121,99.00,0,0,0,0,0,n/a,0
52122,52122,99.00,0,0,0,0,0,n/a,0
52123,52123,99.00,0,0,0,0,0,n/a,0
52124,52124,99.00,0,0,0,0,0,n/a,0
52125,52125,99.00,0,0,0,0,0,n/a,0
52126,52126,99.00,0,0,0,0,0,n/a,0
53001,53001,99.00,0,1,1,0.0,1.0,No,1.0
53002,53002,99.00,102,27,129,0.7906976744186046,0.20930232558139536,Yes,0.7906976744186046
53003,53003,99.00,75,11,86,0.872093023255814,0.12790697674418605,Yes,0.872093023255814
53004,53004,99.00,109,23,132,0.8257575757575758,0.17424242424242425,Yes,0.8257575757575758
53005,53005,99.00,115,17,132,0.8712121212121212,0.12878787878787878,Yes,0.8712121212121212
53006,53006,99.00,2,0,2,1.0,0.0,Yes,1.0
53007,53007,99.00,146,28,174,0.8390804597701149,0.16091954022988506,Yes,0.8390804597701149
53008,53008,99.00,151,25,176,0.8579545454545454,0.14204545454545456,Yes,0.8579545454545454
53009,53009,99.00,85,16,101,0.8415841584158416,0.15841584158415842,Yes,0.8415841584158416
53010,53010,99.00,0,0,0,0,0,n/a,0
53011,53011,99.00,3,0,3,1.0,0.0,Yes,1.0
53012,53012,99.00,122,13,135,0.9037037037037037,0.0962962962962963,Yes,0.9037037037037037
53013,53013,99.00,141,16,157,0.8980891719745223,0.10191082802547771,Yes,0.8980891719745223
53014,53014,99.00,0,0,0,0,0,n/a,0
53015,53015,99.00,3,0,3,1.0,0.0,Yes,1.0
53016,53016,30.00,118,28,146,0.8082191780821918,0.1917808219178082,Yes,0.8082191780821918
53017,53017,30.00,8,2,10,0.8,0.2,Yes,0.8
53018,53018,99.00,121,26,147,0.8231292517006803,0.17687074829931973,Yes,0.8231292517006803
53019,53019,99.00,2,2,4,0.5,0.5,Tie,0.5
53020,53020,99.00,128,37,165,0.7757575757575758,0.22424242424242424,Yes,0.7757575757575758
53021,53021,99.00,87,16,103,0.8446601941747572,0.1553398058252427,Yes,0.8446601941747572
53022,53022,30.00,138,14,152,0.9078947368421053,0.09210526315789473,Yes,0.9078947368421053
53023,53023,99.00,182,37,219,0.8310502283105022,0.1689497716894977,Yes,0.8310502283105022
53024,53024,99.00,1,0,1,1.0,0.0,Yes,1.0
53025,53025,99.00,161,32,193,0.8341968911917098,0.16580310880829016,Yes,0.8341968911917098
53026,53026,99.00,3,0,3,1.0,0.0,Yes,1.0
53027,53027,99.00,110,20,130,0.8461538461538461,0.15384615384615385,Yes,0.8461538461538461
53028,53028,99.00,112,13,125,0.896,0.104,Yes,0.896
53029,53029,99.00,88,18,106,0.8301886792452831,0.16981132075471697,Yes,0.8301886792452831
53030,53030,30.00,240,37,277,0.8664259927797834,0.13357400722021662,Yes,0.8664259927797834
53031,53031,99.00,5,1,6,0.8333333333333334,0.16666666666666666,Yes,0.8333333333333334
53032,53032,99.00,158,35,193,0.8186528497409327,0.18134715025906736,Yes,0.8186528497409327
53033,53033,99.00,240,52,292,0.821917808219178,0.1780821917808219,Yes,0.821917808219178
53034,53034,99.00,228,59,287,0.794425087108014,0.20557491289198607,Yes,0.794425087108014
53035,53035,99.00,6,0,6,1.0,0.0,Yes,1.0
53036,53036,99.00,228,54,282,0.8085106382978723,0.19148936170212766,Yes,0.8085106382978723
53037,53037,99.00,6,1,7,0.8571428571428571,0.14285714285714285,Yes,0.8571428571428571
53038,53038,99.00,4,0,4,1.0,0.0,Yes,1.0
53039,53039,99.00,172,29,201,0.8557213930348259,0.14427860696517414,Yes,0.8557213930348259
53040,53040,99.00,4,0,4,1.0,0.0,Yes,1.0
53041,53041,99.00,39,3,42,0.9285714285714286,0.07142857142857142,Yes,0.9285714285714286
53042,53042,99.00,47,7,54,0.8703703703703703,0.12962962962962962,Yes,0.8703703703703703
53043,53043,99.00,51,9,60,0.85,0.15,Yes,0.85
53044,53044,99.00,98,17,115,0.8521739130434782,0.14782608695652175,Yes,0.8521739130434782
53045,53045,99.00,130,28,158,0.8227848101265823,0.17721518987341772,Yes,0.8227848101265823
53046,53046,99.00,135,20,155,0.8709677419354839,0.12903225806451613,Yes,0.8709677419354839
53047,53047,99.00,116,16,132,0.8787878787878788,0.12121212121212122,Yes,0.8787878787878788
53048,53048,99.00,107,15,122,0.8770491803278688,0.12295081967213115,Yes,0.8770491803278688
53049,53049,99.00,4,2,6,0.6666666666666666,0.3333333333333333,Yes,0.6666666666666666
53050,53050,99.00,98,16,114,0.8596491228070176,0.14035087719298245,Yes,0.8596491228070176
53051,53051,99.00,0,0,0,0,0,n/a,0
53052,53052,99.00,0,0,0,0,0,n/a,0
53053,53053,99.00,2,0,2,1.0,0.0,Yes,1.0
53054,53054,99.00,126,18,144,0.875,0.125,Yes,0.875
53055,53055,99.00,88,14,102,0.8627450980392157,0.13725490196078433,Yes,0.8627450980392157
53056,53056,99.00,95,15,110,0.8636363636363636,0.13636363636363635,Yes,0.8636363636363636
53057,53057,99.00,103,15,118,0.8728813559322034,0.1271186440677966,Yes,0.8728813559322034
53058,53058,99.00,90,18,108,0.8333333333333334,0.16666666666666666,Yes,0.8333333333333334
53059,53059,99.00,111,26,137,0.8102189781021898,0.1897810218978102,Yes,0.8102189781021898
53060,53060,99.00,138,30,168,0.8214285714285714,0.17857142857142858,Yes,0.8214285714285714
53061,53061,99.00,106,22,128,0.828125,0.171875,Yes,0.828125
53062,53062,99.00,0,0,0,0,0,n/a,0
53063,53063,99.00,128,22,150,0.8533333333333334,0.14666666666666667,Yes,0.8533333333333334
53064,53064,99.00,77,15,92,0.8369565217391305,0.16304347826086957,Yes,0.8369565217391305
53065,53065,99.00,231,29,260,0.8884615384615384,0.11153846153846154,Yes,0.8884615384615384
53066,53066,99.00,198,22,220,0.9,0.1,Yes,0.9
53067,53067,99.00,116,25,141,0.8226950354609929,0.1773049645390071,Yes,0.8226950354609929
53068,53068,99.00,3,2,5,0.6,0.4,Yes,0.6
53069,53069,99.00,94,18,112,0.8392857142857143,0.16071428571428573,Yes,0.8392857142857143
53070,53070,37.50,111,8,119,0.9327731092436975,0.06722689075630252,Yes,0.9327731092436975
53071,53071,99.00,2,1,3,0.6666666666666666,0.3333333333333333,Yes,0.6666666666666666
53072,53072,99.00,96,16,112,0.8571428571428571,0.14285714285714285,Yes,0.8571428571428571
53073,53073,99.00,2,0,2,1.0,0.0,Yes,1.0
53074,53074,99.00,141,21,162,0.8703703703703703,0.12962962962962962,Yes,0.8703703703703703
53075,53075,99.00,1,1,2,0.5,0.5,Tie,0.5
53076,53076,99.00,200,25,225,0.8888888888888888,0.1111111111111111,Yes,0.8888888888888888
53077,53077,99.00,108,21,129,0.8372093023255814,0.16279069767441862,Yes,0.8372093023255814
53078,53078,99.00,8,22,30,0.26666666666666666,0.7333333333333333,No,0.7333333333333333
53079,53079,99.00,4,1,5,0.8,0.2,Yes,0.8
53080,53080,44.44,106,16,122,0.8688524590163934,0.13114754098360656,Yes,0.8688524590163934
53081,53081,99.00,0,0,0,0,0,n/a,0
53082,53082,99.00,116,14,130,0.8923076923076924,0.1076923076923077,Yes,0.8923076923076924
53083,53083,99.00,2,0,2,1.0,0.0,Yes,1.0
53084,53084,99.00,1,1,2,0.5,0.5,Tie,0.5
53085,53085,99.00,7,2,9,0.7777777777777778,0.2222222222222222,Yes,0.7777777777777778
53086,53086,99.00,104,12,116,0.896551724137931,0.10344827586206896,Yes,0.896551724137931
53087,53087,99.00,87,31,118,0.7372881355932204,0.2627118644067797,Yes,0.7372881355932204
53088,53088,99.00,102,18,120,0.85,0.15,Yes,0.85
53089,53089,99.00,0,0,0,0,0,n/a,0
54001,54001,99.00,2,1,3,0.6666666666666666,0.3333333333333333,Yes,0.6666666666666666
54002,54002,99.00,104,13,117,0.8888888888888888,0.1111111111111111,Yes,0.8888888888888888
54003,54003,99.00,66,22,88,0.75,0.25,Yes,0.75
54004,54004,99.00,35,5,40,0.875,0.125,Yes,0.875
54005,54005,99.00,2,0,2,1.0,0.0,Yes,1.0
54006,54006,99.00,0,0,0,0,0,n/a,0
54007,54007,99.00,3,2,5,0.6,0.4,Yes,0.6
54008,54008,99.00,135,21,156,0.8653846153846154,0.1346153846153846,Yes,0.8653846153846154
54009,54009,99.00,4,1,5,0.8,0.2,Yes,0.8
54010,54010,99.00,184,34,218,0.8440366972477065,0.1559633027522936,Yes,0.8440366972477065
54011,54011,99.00,79,11,90,0.8777777777777778,0.12222222222222222,Yes,0.8777777777777778
54012,54012,99.00,126,16,142,0.8873239436619719,0.11267605633802817,Yes,0.8873239436619719
54013,54013,99.00,2,2,4,0.5,0.5,Tie,0.5
54014,54014,99.00,13,2,15,0.8666666666666667,0.13333333333333333,Yes,0.8666666666666667
54015,54015,99.00,61,8,69,0.8840579710144928,0.11594202898550725,Yes,0.8840579710144928
54016,54016,99.00,0,1,1,0.0,1.0,No,1.0
54017,54017,99.00,1,0,1,1.0,0.0,Yes,1.0
54018,54018,99.00,0,0,0,0,0,n/a,0
54019,54019,99.00,112,23,135,0.8296296296296296,0.17037037037037037,Yes,0.8296296296296296
54020,54020,99.00,101,15,116,0.8706896551724138,0.12931034482758622,Yes,0.8706896551724138
54021,54021,50.00,3,0,3,1.0,0.0,Yes,1.0
54022,54022,99.00,168,29,197,0.8527918781725888,0.14720812182741116,Yes,0.8527918781725888
54023,54023,99.00,84,22,106,0.7924528301886793,0.20754716981132076,Yes,0.7924528301886793
54024,54024,99.00,102,19,121,0.8429752066115702,0.15702479338842976,Yes,0.8429752066115702
54025,54025,99.00,186,30,216,0.8611111111111112,0.1388888888888889,Yes,0.8611111111111112
54026,54026,99.00,0,0,0,0,0,n/a,0
54027,54027,99.00,157,17,174,0.9022988505747126,0.09770114942528736,Yes,0.9022988505747126
54028,54028,50.00,101,29,130,0.7769230769230769,0.2230769230769231,Yes,0.7769230769230769
54029,54029,99.00,107,9,116,0.9224137931034483,0.07758620689655173,Yes,0.9224137931034483
54030,54030,37.50,79,11,90,0.8777777777777778,0.12222222222222222,Yes,0.8777777777777778
54031,54031,37.50,120,21,141,0.851063829787234,0.14893617021276595,Yes,0.851063829787234
54032,54032,37.50,8,2,10,0.8,0.2,Yes,0.8
54033,54033,99.00,160,27,187,0.8556149732620321,0.1443850267379679,Yes,0.8556149732620321
54034,54034,99.00,2,0,2,1.0,0.0,Yes,1.0
54035,54035,99.00,6,0,6,1.0,0.0,Yes,1.0
54036,54036,99.00,7,2,9,0.7777777777777778,0.2222222222222222,Yes,0.7777777777777778
54037,54037,99.00,143,31,174,0.8218390804597702,0.1781609195402299,Yes,0.8218390804597702
54038,54038,99.00,0,0,0,0,0,n/a,0
54039,54039,99.00,147,17,164,0.8963414634146342,0.10365853658536585,Yes,0.8963414634146342
54040,54040,99.00,2,0,2,1.0,0.0,Yes,1.0
54041,54041,99.00,118,22,140,0.8428571428571429,0.15714285714285714,Yes,0.8428571428571429
54042,54042,99.00,0,0,0,0,0,n/a,0
54043,54043,99.00,78,18,96,0.8125,0.1875,Yes,0.8125
54044,54044,99.00,97,21,118,0.8220338983050848,0.17796610169491525,Yes,0.8220338983050848
54045,54045,99.00,2,1,3,0.6666666666666666,0.3333333333333333,Yes,0.6666666666666666
54046,54046,99.00,64,4,68,0.9411764705882353,0.058823529411764705,Yes,0.9411764705882353
54047,54047,66.67,86,18,104,0.8269230769230769,0.17307692307692307,Yes,0.8269230769230769
54048,54048,66.67,57,7,64,0.890625,0.109375,Yes,0.890625
54049,54049,99.00,72,22,94,0.7659574468085106,0.23404255319148937,Yes,0.7659574468085106
54050,54050,99.00,86,15,101,0.8514851485148515,0.1485148514851485,Yes,0.8514851485148515
54051,54051,99.00,54,13,67,0.8059701492537313,0.19402985074626866,Yes,0.8059701492537313
54052,54052,99.00,1,0,1,1.0,0.0,Yes,1.0
54053,54053,66.67,0,0,0,0,0,n/a,0
54054,54054,99.00,0,0,0,0,0,n/a,0
54055,54055,99.00,1,1,2,0.5,0.5,Tie,0.5
54056,54056,99.00,2,0,2,1.0,0.0,Yes,1.0
54057,54057,99.00,109,13,122,0.8934426229508197,0.10655737704918032,Yes,0.8934426229508197
54058,54058,99.00,97,14,111,0.8738738738738738,0.12612612612612611,Yes,0.8738738738738738
54059,54059,99.00,71,21,92,0.7717391304347826,0.22826086956521738,Yes,0.7717391304347826
54060,54060,99.00,230,33,263,0.8745247148288974,0.12547528517110265,Yes,0.8745247148288974
54061,54061,99.00,126,29,155,0.8129032258064516,0.1870967741935484,Yes,0.8129032258064516
54062,54062,99.00,3,0,3,1.0,0.0,Yes,1.0
54063,54063,99.00,149,34,183,0.8142076502732241,0.18579234972677597,Yes,0.8142076502732241
54064,54064,99.00,6,1,7,0.8571428571428571,0.14285714285714285,Yes,0.8571428571428571
54065,54065,99.00,1,2,3,0.3333333333333333,0.6666666666666666,No,0.6666666666666666
54066,54066,99.00,77,10,87,0.8850574712643678,0.11494252873563218,Yes,0.8850574712643678
54067,54067,99.00,98,17,115,0.8521739130434782,0.14782608695652175,Yes,0.8521739130434782
54068,54068,99.00,78,11,89,0.8764044943820225,0.12359550561797752,Yes,0.8764044943820225
54069,54069,99.00,85,18,103,0.8252427184466019,0.17475728155339806,Yes,0.8252427184466019
54070,54070,99.00,82,18,100,0.82,0.18,Yes,0.82
54071,54071,99.00,1,0,1,1.0,0.0,Yes,1.0
54072,54072,99.00,0,0,0,0,0,n/a,0
54073,54073,99.00,7,1,8,0.875,0.125,Yes,0.875
54074,54074,99.00,6,2,8,0.75,0.25,Yes,0.75
54075,54075,99.00,1,0,1,1.0,0.0,Yes,1.0
54076,54076,99.00,79,10,89,0.8876404494382022,0.11235955056179775,Yes,0.8876404494382022
54077,54077,99.00,1,0,1,1.0,0.0,Yes,1.0
54078,54078,99.00,0,0,0,0,0,n/a,0
54079,54079,99.00,0,0,0,0,0,n/a,0
54080,54080,99.00,63,17,80,0.7875,0.2125,Yes,0.7875
54081,54081,99.00,88,16,104,0.8461538461538461,0.15384615384615385,Yes,0.8461538461538461
54082,54082,99.00,0,0,0,0,0,n/a,0
54083,54083,99.00,103,23,126,0.8174603174603174,0.18253968253968253,Yes,0.8174603174603174
54084,54084,99.00,3,0,3,1.0,0.0,Yes,1.0
54085,54085,99.00,115,20,135,0.8518518518518519,0.14814814814814814,Yes,0.8518518518518519
54086,54086,99.00,109,15,124,0.8790322580645161,0.12096774193548387,Yes,0.8790322580645161
54087,54087,99.00,0,0,0,0,0,n/a,0
54088,54088,99.00,1,0,1,1.0,0.0,Yes,1.0
54089,54089,99.00,139,24,163,0.852760736196319,0.147239263803681,Yes,0.852760736196319
55001,55001,99.00,0,0,0,0,0,n/a,0
55002,55002,99.00,104,14,118,0.8813559322033898,0.11864406779661017,Yes,0.8813559322033898
55003,55003,99.00,0,1,1,0.0,1.0,No,1.0
55004,55004,99.00,8,1,9,0.8888888888888888,0.1111111111111111,Yes,0.8888888888888888
55005,55005,99.00,2,0,2,1.0,0.0,Yes,1.0
55006,55006,50.00,0,0,0,0,0,n/a,0
55007,55007,99.00,89,9,98,0.9081632653061225,0.09183673469387756,Yes,0.9081632653061225
55008,55008,99.00,0,0,0,0,0,n/a,0
55009,55009,99.00,196,26,222,0.8828828828828829,0.11711711711711711,Yes,0.8828828828828829
55010,55010,99.00,168,34,202,0.8316831683168316,0.16831683168316833,Yes,0.8316831683168316
55011,55011,50.00,72,10,82,0.8780487804878049,0.12195121951219512,Yes,0.8780487804878049
55012,55012,50.00,58,6,64,0.90625,0.09375,Yes,0.90625
55013,55013,99.00,3,0,3,1.0,0.0,Yes,1.0
55014,55014,99.00,101,10,111,0.9099099099099099,0.09009009009009009,Yes,0.9099099099099099
55015,55015,99.00,161,27,188,0.8563829787234043,0.14361702127659576,Yes,0.8563829787234043
55016,55016,99.00,126,33,159,0.7924528301886793,0.20754716981132076,Yes,0.7924528301886793
55017,55017,99.00,1,0,1,1.0,0.0,Yes,1.0
55018,55018,99.00,148,21,169,0.8757396449704142,0.1242603550295858,Yes,0.8757396449704142
55019,55019,99.00,154,18,172,0.8953488372093024,0.10465116279069768,Yes,0.8953488372093024
55020,55020,99.00,232,24,256,0.90625,0.09375,Yes,0.90625
55021,55021,99.00,74,16,90,0.8222222222222222,0.17777777777777778,Yes,0.8222222222222222
55022,55022,99.00,3,1,4,0.75,0.25,Yes,0.75
55023,55023,99.00,195,35,230,0.8478260869565217,0.15217391304347827,Yes,0.8478260869565217
55024,55024,99.00,97,16,113,0.8584070796460177,0.1415929203539823,Yes,0.8584070796460177
55025,55025,99.00,113,21,134,0.8432835820895522,0.15671641791044777,Yes,0.8432835820895522
55026,55026,99.00,1,0,1,1.0,0.0,Yes,1.0
55027,55027,99.00,88,18,106,0.8301886792452831,0.16981132075471697,Yes,0.8301886792452831
55028,55028,99.00,3,0,3,1.0,0.0,Yes,1.0
55029,55029,99.00,0,0,0,0,0,n/a,0
55030,55030,99.00,3,2,5,0.6,0.4,Yes,0.6
55031,55031,99.00,117,33,150,0.78,0.22,Yes,0.78
55032,55032,99.00,187,27,214,0.8738317757009346,0.1261682242990654,Yes,0.8738317757009346
55033,55033,99.00,214,29,243,0.8806584362139918,0.11934156378600823,Yes,0.8806584362139918
55034,55034,99.00,3,0,3,1.0,0.0,Yes,1.0
55035,55035,99.00,42,1,43,0.9767441860465116,0.023255813953488372,Yes,0.9767441860465116
55036,55036,99.00,0,0,0,0,0,n/a,0
55037,55037,99.00,11,0,11,1.0,0.0,Yes,1.0
55038,55038,99.00,55,15,70,0.7857142857142857,0.21428571428571427,Yes,0.7857142857142857
55039,55039,99.00,0,0,0,0,0,n/a,0
55040,55040,99.00,0,0,0,0,0,n/a,0
55041,55041,99.00,37,8,45,0.8222222222222222,0.17777777777777778,Yes,0.8222222222222222
55042,55042,99.00,1,0,1,1.0,0.0,Yes,1.0
55043,55043,99.00,0,0,0,0,0,n/a,0
55044,55044,99.00,0,0,0,0,0,n/a,0
55045,55045,99.00,40,7,47,0.851063829787234,0.14893617021276595,Yes,0.851063829787234
55046,55046,99.00,120,19,139,0.8633093525179856,0.1366906474820144,Yes,0.8633093525179856
55047,55047,99.00,48,8,56,0.8571428571428571,0.14285714285714285,Yes,0.8571428571428571
55048,55048,99.00,84,10,94,0.8936170212765957,0.10638297872340426,Yes,0.8936170212765957
55049,55049,99.00,62,8,70,0.8857142857142857,0.11428571428571428,Yes,0.8857142857142857
55050,55050,99.00,17,6,23,0.7391304347826086,0.2608695652173913,Yes,0.7391304347826086
55051,55051,99.00,0,0,0,0,0,n/a,0
55052,55052,99.00,33,8,41,0.8048780487804879,0.1951219512195122,Yes,0.8048780487804879
55053,55053,99.00,0,0,0,0,0,n/a,0
55054,55054,99.00,0,0,0,0,0,n/a,0
55055,55055,99.00,91,20,111,0.8198198198198198,0.18018018018018017,Yes,0.8198198198198198
55056,55056,99.00,0,0,0,0,0,n/a,0
55057,55057,99.00,58,8,66,0.8787878787878788,0.12121212121212122,Yes,0.8787878787878788
55058,55058,99.00,6,0,6,1.0,0.0,Yes,1.0
55059,55059,99.00,0,0,0,0,0,n/a,0
55060,55060,99.00,2,0,2,1.0,0.0,Yes,1.0
55061,55061,99.00,0,0,0,0,0,n/a,0
55062,55062,99.00,3,1,4,0.75,0.25,Yes,0.75
55063,55063,99.00,3,1,4,0.75,0.25,Yes,0.75
55064,55064,99.00,140,10,150,0.9333333333333333,0.06666666666666667,Yes,0.9333333333333333
55065,55065,44.44,103,24,127,0.8110236220472441,0.1889763779527559,Yes,0.8110236220472441
55066,55066,99.00,63,11,74,0.8513513513513513,0.14864864864864866,Yes,0.8513513513513513
55067,55067,99.00,84,28,112,0.75,0.25,Yes,0.75
55068,55068,44.44,7,0,7,1.0,0.0,Yes,1.0
55069,55069,44.44,125,28,153,0.8169934640522876,0.1830065359477124,Yes,0.8169934640522876
55070,55070,44.44,0,0,0,0,0,n/a,0
55071,55071,99.00,92,16,108,0.8518518518518519,0.14814814814814814,Yes,0.8518518518518519
55072,55072,99.00,3,2,5,0.6,0.4,Yes,0.6
55073,55073,99.00,0,0,0,0,0,n/a,0
55074,55074,99.00,70,17,87,0.8045977011494253,0.19540229885057472,Yes,0.8045977011494253
55075,55075,99.00,125,18,143,0.8741258741258742,0.1258741258741259,Yes,0.8741258741258742
55076,55076,99.00,124,13,137,0.9051094890510949,0.0948905109489051,Yes,0.9051094890510949
55077,55077,99.00,1,0,1,1.0,0.0,Yes,1.0
55078,55078,44.44,135,34,169,0.7988165680473372,0.20118343195266272,Yes,0.7988165680473372
55079,55079,99.00,114,27,141,0.8085106382978723,0.19148936170212766,Yes,0.8085106382978723
55080,55080,99.00,151,20,171,0.8830409356725146,0.11695906432748537,Yes,0.8830409356725146
55081,55081,99.00,84,12,96,0.875,0.125,Yes,0.875
55082,55082,99.00,146,22,168,0.8690476190476191,0.13095238095238096,Yes,0.8690476190476191
55083,55083,99.00,127,11,138,0.9202898550724637,0.07971014492753623,Yes,0.9202898550724637
55084,55084,99.00,91,10,101,0.900990099009901,0.09900990099009901,Yes,0.900990099009901
55085,55085,99.00,1,1,2,0.5,0.5,Tie,0.5
55086,55086,99.00,2,0,2,1.0,0.0,Yes,1.0
55087,55087,99.00,0,0,0,0,0,n/a,0
55088,55088,99.00,190,33,223,0.852017937219731,0.14798206278026907,Yes,0.852017937219731
55089,55089,99.00,177,24,201,0.8805970149253731,0.11940298507462686,Yes,0.8805970149253731
55090,55090,99.00,5,0,5,1.0,0.0,Yes,1.0
55091,55091,99.00,3,0,3,1.0,0.0,Yes,1.0
55092,55092,99.00,170,27,197,0.8629441624365483,0.13705583756345177,Yes,0.8629441624365483
55093,55093,99.00,199,25,224,0.8883928571428571,0.11160714285714286,Yes,0.8883928571428571
55094,55094,99.00,95,9,104,0.9134615384615384,0.08653846153846154,Yes,0.9134615384615384
55095,55095,99.00,27,9,36,0.75,0.25,Yes,0.75
55096,55096,99.00,103,17,120,0.8583333333333333,0.14166666666666666,Yes,0.8583333333333333
55097,55097,99.00,3,0,3,1.0,0.0,Yes,1.0
55098,55098,99.00,0,0,0,0,0,n/a,0
55099,55099,99.00,124,15,139,0.8920863309352518,0.1079136690647482,Yes,0.8920863309352518
55100,55100,99.00,3,0,3,1.0,0.0,Yes,1.0
55101,55101,99.00,3,2,5,0.6,0.4,Yes,0.6
55102,55102,99.00,139,38,177,0.7853107344632768,0.21468926553672316,Yes,0.7853107344632768
55103,55103,99.00,6,0,6,1.0,0.0,Yes,1.0
55104,55104,99.00,2,0,2,1.0,0.0,Yes,1.0
55105,55105,99.00,0,2,2,0.0,1.0,No,1.0
55106,55106,99.00,130,21,151,0.8609271523178808,0.1390728476821192,Yes,0.8609271523178808
55107,55107,99.00,147,21,168,0.875,0.125,Yes,0.875
55108,55108,99.00,141,25,166,0.8493975903614458,0.15060240963855423,Yes,0.8493975903614458
55109,55109,99.00,2,0,2,1.0,0.0,Yes,1.0
55110,55110,44.44,6,1,7,0.8571428571428571,0.14285714285714285,Yes,0.8571428571428571
55111,55111,99.00,0,0,0,0,0,n/a,0
55112,55112,99.00,0,0,0,0,0,n/a,0
55113,55113,99.00,0,0,0,0,0,n/a,0
56001,56001,44.44,96,14,110,0.8727272727272727,0.12727272727272726,Yes,0.8727272727272727
56002,56002,44.44,60,9,69,0.8695652173913043,0.13043478260869565,Yes,0.8695652173913043
56003,56003,99.00,51,7,58,0.8793103448275862,0.1206896551724138,Yes,0.8793103448275862
56004,56004,44.44,6,2,8,0.75,0.25,Yes,0.75
56005,56005,99.00,2,1,3,0.6666666666666666,0.3333333333333333,Yes,0.6666666666666666
56006,56006,44.44,97,12,109,0.8899082568807339,0.11009174311926606,Yes,0.8899082568807339
56007,56007,99.00,6,0,6,1.0,0.0,Yes,1.0
56008,56008,99.00,51,18,69,0.7391304347826086,0.2608695652173913,Yes,0.7391304347826086
56009,56009,99.00,60,9,69,0.8695652173913043,0.13043478260869565,Yes,0.8695652173913043
56010,56010,99.00,82,25,107,0.7663551401869159,0.2336448598130841,Yes,0.7663551401869159
56011,56011,99.00,127,22,149,0.8523489932885906,0.1476510067114094,Yes,0.8523489932885906
56012,56012,99.00,14,0,14,1.0,0.0,Yes,1.0
56013,56013,99.00,258,27,285,0.9052631578947369,0.09473684210526316,Yes,0.9052631578947369
56014,56014,99.00,117,36,153,0.7647058823529411,0.23529411764705882,Yes,0.7647058823529411
56015,56015,80.00,135,29,164,0.823170731707317,0.17682926829268292,Yes,0.823170731707317
56016,56016,80.00,134,14,148,0.9054054054054054,0.0945945945945946,Yes,0.9054054054054054
56017,56017,99.00,93,16,109,0.8532110091743119,0.14678899082568808,Yes,0.8532110091743119
56018,56018,99.00,16,1,17,0.9411764705882353,0.058823529411764705,Yes,0.9411764705882353
56019,56019,99.00,224,45,269,0.8327137546468402,0.16728624535315986,Yes,0.8327137546468402
56020,56020,99.00,1,0,1,1.0,0.0,Yes,1.0
56021,56021,99.00,197,27,224,0.8794642857142857,0.12053571428571429,Yes,0.8794642857142857
56022,56022,99.00,233,36,269,0.8661710037174721,0.13382899628252787,Yes,0.8661710037174721
56023,56023,99.00,149,28,177,0.8418079096045198,0.15819209039548024,Yes,0.8418079096045198
56024,56024,99.00,142,25,167,0.8502994011976048,0.1497005988023952,Yes,0.8502994011976048
56025,56025,99.00,142,26,168,0.8452380952380952,0.15476190476190477,Yes,0.8452380952380952
56026,56026,99.00,210,46,256,0.8203125,0.1796875,Yes,0.8203125
56027,56027,66.67,93,15,108,0.8611111111111112,0.1388888888888889,Yes,0.8611111111111112
56028,56028,66.67,102,15,117,0.8717948717948718,0.1282051282051282,Yes,0.8717948717948718
56029,56029,99.00,181,44,225,0.8044444444444444,0.19555555555555557,Yes,0.8044444444444444
56030,56030,99.00,104,17,121,0.859504132231405,0.14049586776859505,Yes,0.859504132231405
56031,56031,99.00,215,36,251,0.8565737051792829,0.14342629482071714,Yes,0.8565737051792829
56032,56032,99.00,168,33,201,0.835820895522388,0.16417910447761194,Yes,0.835820895522388
56033,56033,99.00,164,36,200,0.82,0.18,Yes,0.82
56034,56034,99.00,12,0,12,1.0,0.0,Yes,1.0
56035,56035,66.67,90,17,107,0.8411214953271028,0.1588785046728972,Yes,0.8411214953271028
56036,56036,99.00,133,27,160,0.83125,0.16875,Yes,0.83125
56037,56037,99.00,293,41,334,0.8772455089820359,0.12275449101796407,Yes,0.8772455089820359
56038,56038,99.00,194,37,231,0.8398268398268398,0.16017316017316016,Yes,0.8398268398268398
56039,56039,99.00,4,1,5,0.8,0.2,Yes,0.8
56040,56040,99.00,146,25,171,0.8538011695906432,0.14619883040935672,Yes,0.8538011695906432
56041,56041,99.00,179,28,207,0.8647342995169082,0.13526570048309178,Yes,0.8647342995169082
56042,56042,99.00,180,22,202,0.8910891089108911,0.10891089108910891,Yes,0.8910891089108911
56043,56043,99.00,6,2,8,0.75,0.25,Yes,0.75
56044,56044,99.00,267,51,318,0.839622641509434,0.16037735849056603,Yes,0.839622641509434
56045,56045,99.00,174,26,200,0.87,0.13,Yes,0.87
56046,56046,99.00,10,2,12,0.8333333333333334,0.16666666666666666,Yes,0.8333333333333334
56047,56047,99.00,10,0,10,1.0,0.0,Yes,1.0
56048,56048,99.00,285,44,329,0.8662613981762918,0.1337386018237082,Yes,0.8662613981762918
56049,56049,99.00,323,53,376,0.8590425531914894,0.14095744680851063,Yes,0.8590425531914894
56050,56050,99.00,7,1,8,0.875,0.125,Yes,0.875
56051,56051,99.00,7,1,8,0.875,0.125,Yes,0.875
56052,56052,99.00,157,24,181,0.8674033149171271,0.13259668508287292,Yes,0.8674033149171271
56053,56053,99.00,175,45,220,0.7954545454545454,0.20454545454545456,Yes,0.7954545454545454
56054,56054,99.00,266,41,307,0.8664495114006515,0.13355048859934854,Yes,0.8664495114006515
56055,56055,66.67,263,44,307,0.8566775244299675,0.14332247557003258,Yes,0.8566775244299675
56056,56056,66.67,2,1,3,0.6666666666666666,0.3333333333333333,Yes,0.6666666666666666
56057,56057,99.00,171,19,190,0.9,0.1,Yes,0.9
56058,56058,99.00,7,5,12,0.5833333333333334,0.4166666666666667,Yes,0.5833333333333334
56059,56059,0.00,5,2,7,0.7142857142857143,0.2857142857142857,Yes,0.7142857142857143
56060,56060,99.00,215,51,266,0.8082706766917294,0.19172932330827067,Yes,0.8082706766917294
56061,56061,99.00,7,0,7,1.0,0.0,Yes,1.0
56062,56062,99.00,71,10,81,0.8765432098765432,0.12345679012345678,Yes,0.8765432098765432
56063,56063,99.00,122,17,139,0.8776978417266187,0.1223021582733813,Yes,0.8776978417266187
56064,56064,99.00,158,30,188,0.8404255319148937,0.1595744680851064,Yes,0.8404255319148937
56065,56065,99.00,186,30,216,0.8611111111111112,0.1388888888888889,Yes,0.8611111111111112
56066,56066,99.00,2,0,2,1.0,0.0,Yes,1.0
56067,56067,99.00,3,1,4,0.75,0.25,Yes,0.75
56068,56068,99.00,14,2,16,0.875,0.125,Yes,0.875
56069,56069,0.00,16,7,23,0.6956521739130435,0.30434782608695654,Yes,0.6956521739130435
56070,56070,0.00,12,0,12,1.0,0.0,Yes,1.0
56071,56071,99.00,175,34,209,0.8373205741626795,0.16267942583732056,Yes,0.8373205741626795
56072,56072,99.00,186,24,210,0.8857142857142857,0.11428571428571428,Yes,0.8857142857142857
56073,56073,99.00,153,28,181,0.8453038674033149,0.15469613259668508,Yes,0.8453038674033149
56074,56074,99.00,12,1,13,0.9230769230769231,0.07692307692307693,Yes,0.9230769230769231
56075,56075,99.00,3,2,5,0.6,0.4,Yes,0.6
56076,56076,99.00,6,2,8,0.75,0.25,Yes,0.75
56077,56077,99.00,171,23,194,0.8814432989690721,0.11855670103092783,Yes,0.8814432989690721
56078,56078,99.00,207,36,243,0.8518518518518519,0.14814814814814814,Yes,0.8518518518518519
56079,56079,80.00,183,18,201,0.9104477611940298,0.08955223880597014,Yes,0.9104477611940298
56080,56080,99.00,333,48,381,0.8740157480314961,0.12598425196850394,Yes,0.8740157480314961
56081,56081,99.00,2,2,4,0.5,0.5,Tie,0.5
56082,56082,99.00,136,12,148,0.918918918918919,0.08108108108108109,Yes,0.918918918918919
56083,56083,0.00,0,0,0,0,0,n/a,0
56084,56084,99.00,5,2,7,0.7142857142857143,0.2857142857142857,Yes,0.7142857142857143
56085,56085,99.00,168,26,194,0.865979381443299,0.13402061855670103,Yes,0.865979381443299
56086,56086,99.00,120,15,135,0.8888888888888888,0.1111111111111111,Yes,0.8888888888888888
56087,56087,99.00,4,2,6,0.6666666666666666,0.3333333333333333,Yes,0.6666666666666666
56088,56088,99.00,133,35,168,0.7916666666666666,0.20833333333333334,Yes,0.7916666666666666
56089,56089,99.00,10,2,12,0.8333333333333334,0.16666666666666666,Yes,0.8333333333333334
56090,56090,99.00,287,65,352,0.8153409090909091,0.1846590909090909,Yes,0.8153409090909091
56091,56091,99.00,201,35,236,0.8516949152542372,0.1483050847457627,Yes,0.8516949152542372
56092,56092,99.00,0,0,0,0,0,n/a,0
57001,57001,99.00,91,19,110,0.8272727272727273,0.17272727272727273,Yes,0.8272727272727273
57002,57002,99.00,80,23,103,0.7766990291262136,0.22330097087378642,Yes,0.7766990291262136
57003,57003,99.00,1,2,3,0.3333333333333333,0.6666666666666666,No,0.6666666666666666
57004,57004,99.00,48,19,67,0.7164179104477612,0.2835820895522388,Yes,0.7164179104477612
57005,57005,99.00,2,0,2,1.0,0.0,Yes,1.0
57006,57006,99.00,49,11,60,0.8166666666666667,0.18333333333333332,Yes,0.8166666666666667
57007,57007,99.00,3,0,3,1.0,0.0,Yes,1.0
57008,57008,99.00,106,21,127,0.8346456692913385,0.16535433070866143,Yes,0.8346456692913385
57009,57009,99.00,113,31,144,0.7847222222222222,0.2152777777777778,Yes,0.7847222222222222
57010,57010,99.00,277,71,348,0.7959770114942529,0.20402298850574713,Yes,0.7959770114942529
57011,57011,99.00,179,36,215,0.8325581395348837,0.16744186046511628,Yes,0.8325581395348837
57012,57012,99.00,112,18,130,0.8615384615384616,0.13846153846153847,Yes,0.8615384615384616
57013,57013,99.00,3,0,3,1.0,0.0,Yes,1.0
57014,57014,99.00,112,43,155,0.7225806451612903,0.27741935483870966,Yes,0.7225806451612903
57015,57015,99.00,10,3,13,0.7692307692307693,0.23076923076923078,Yes,0.7692307692307693
57016,57016,99.00,231,54,285,0.8105263157894737,0.18947368421052632,Yes,0.8105263157894737
57017,57017,99.00,287,59,346,0.8294797687861272,0.17052023121387283,Yes,0.8294797687861272
57018,57018,99.00,296,40,336,0.8809523809523809,0.11904761904761904,Yes,0.8809523809523809
57019,57019,99.00,2,2,4,0.5,0.5,Tie,0.5
57020,57020,99.00,0,0,0,0,0,n/a,0
57021,57021,80.00,143,25,168,0.8511904761904762,0.1488095238095238,Yes,0.8511904761904762
57022,57022,99.00,151,20,171,0.8830409356725146,0.11695906432748537,Yes,0.8830409356725146
57023,57023,99.00,1,0,1,1.0,0.0,Yes,1.0
57024,57024,99.00,338,70,408,0.8284313725490197,0.1715686274509804,Yes,0.8284313725490197
57025,57025,99.00,268,64,332,0.8072289156626506,0.1927710843373494,Yes,0.8072289156626506
57026,57026,99.00,222,72,294,0.7551020408163265,0.24489795918367346,Yes,0.7551020408163265
57027,57027,99.00,315,60,375,0.84,0.16,Yes,0.84
57028,57028,99.00,6,3,9,0.6666666666666666,0.3333333333333333,Yes,0.6666666666666666
57029,57029,99.00,300,77,377,0.7957559681697612,0.20424403183023873,Yes,0.7957559681697612
57030,57030,99.00,198,28,226,0.8761061946902655,0.12389380530973451,Yes,0.8761061946902655
57031,57031,99.00,298,59,357,0.834733893557423,0.16526610644257703,Yes,0.834733893557423
57032,57032,99.00,113,19,132,0.8560606060606061,0.14393939393939395,Yes,0.8560606060606061
57033,57033,99.00,2,0,2,1.0,0.0,Yes,1.0
57034,57034,99.00,250,51,301,0.8305647840531561,0.16943521594684385,Yes,0.8305647840531561
57035,57035,99.00,205,42,247,0.8299595141700404,0.1700404858299595,Yes,0.8299595141700404
57036,57036,80.00,196,23,219,0.8949771689497716,0.1050228310502283,Yes,0.8949771689497716
57037,57037,80.00,121,23,144,0.8402777777777778,0.1597222222222222,Yes,0.8402777777777778
57038,57038,99.00,219,51,270,0.8111111111111111,0.18888888888888888,Yes,0.8111111111111111
57039,57039,99.00,213,36,249,0.8554216867469879,0.14457831325301204,Yes,0.8554216867469879
57040,57040,99.00,218,47,265,0.8226415094339623,0.17735849056603772,Yes,0.8226415094339623
57041,57041,99.00,202,43,245,0.8244897959183674,0.17551020408163265,Yes,0.8244897959183674
57042,57042,99.00,177,43,220,0.8045454545454546,0.19545454545454546,Yes,0.8045454545454546
57043,57043,99.00,259,58,317,0.8170347003154574,0.1829652996845426,Yes,0.8170347003154574
57044,57044,99.00,167,26,193,0.8652849740932642,0.13471502590673576,Yes,0.8652849740932642
57045,57045,99.00,267,50,317,0.8422712933753943,0.15772870662460567,Yes,0.8422712933753943
57046,57046,99.00,2,0,2,1.0,0.0,Yes,1.0
57047,57047,0.00,9,4,13,0.6923076923076923,0.3076923076923077,Yes,0.6923076923076923
57048,57048,99.00,356,87,443,0.8036117381489842,0.1963882618510158,Yes,0.8036117381489842
57049,57049,99.00,191,40,231,0.8268398268398268,0.17316017316017315,Yes,0.8268398268398268
57050,57050,99.00,10,3,13,0.7692307692307693,0.23076923076923078,Yes,0.7692307692307693
57051,57051,99.00,285,65,350,0.8142857142857143,0.18571428571428572,Yes,0.8142857142857143
57052,57052,99.00,1,0,1,1.0,0.0,Yes,1.0
57053,57053,99.00,5,2,7,0.7142857142857143,0.2857142857142857,Yes,0.7142857142857143
57054,57054,99.00,216,40,256,0.84375,0.15625,Yes,0.84375
57055,57055,99.00,290,58,348,0.8333333333333334,0.16666666666666666,Yes,0.8333333333333334
57056,57056,99.00,186,42,228,0.8157894736842105,0.18421052631578946,Yes,0.8157894736842105
57057,57057,99.00,154,36,190,0.8105263157894737,0.18947368421052632,Yes,0.8105263157894737
57058,57058,99.00,231,29,260,0.8884615384615384,0.11153846153846154,Yes,0.8884615384615384
57059,57059,99.00,310,47,357,0.8683473389355743,0.13165266106442577,Yes,0.8683473389355743
57060,57060,99.00,340,67,407,0.8353808353808354,0.16461916461916462,Yes,0.8353808353808354
57061,57061,0.00,31,5,36,0.8611111111111112,0.1388888888888889,Yes,0.8611111111111112
57062,57062,0.00,7,7,14,0.5,0.5,Tie,0.5
57063,57063,99.00,16,6,22,0.7272727272727273,0.2727272727272727,Yes,0.7272727272727273
57064,57064,99.00,363,85,448,0.8102678571428571,0.18973214285714285,Yes,0.8102678571428571
57065,57065,99.00,18,5,23,0.782608695652174,0.21739130434782608,Yes,0.782608695652174
57066,57066,99.00,11,1,12,0.9166666666666666,0.08333333333333333,Yes,0.9166666666666666
57067,57067,99.00,308,62,370,0.8324324324324325,0.16756756756756758,Yes,0.8324324324324325
57068,57068,99.00,217,29,246,0.8821138211382114,0.11788617886178862,Yes,0.8821138211382114
57069,57069,99.00,249,36,285,0.8736842105263158,0.12631578947368421,Yes,0.8736842105263158
57070,57070,99.00,248,60,308,0.8051948051948052,0.19480519480519481,Yes,0.8051948051948052
57071,57071,99.00,14,3,17,0.8235294117647058,0.17647058823529413,Yes,0.8235294117647058
57072,57072,99.00,189,43,232,0.8146551724137931,0.1853448275862069,Yes,0.8146551724137931
57073,57073,99.00,17,6,23,0.7391304347826086,0.2608695652173913,Yes,0.7391304347826086
57074,57074,99.00,198,51,249,0.7951807228915663,0.20481927710843373,Yes,0.7951807228915663
57075,57075,99.00,262,45,307,0.8534201954397395,0.1465798045602606,Yes,0.8534201954397395
57076,57076,99.00,434,88,522,0.8314176245210728,0.1685823754789272,Yes,0.8314176245210728
57077,57077,99.00,94,23,117,0.8034188034188035,0.19658119658119658,Yes,0.8034188034188035
57078,57078,99.00,13,0,13,1.0,0.0,Yes,1.0
57079,57079,99.00,10,4,14,0.7142857142857143,0.2857142857142857,Yes,0.7142857142857143
57080,57080,99.00,345,68,413,0.8353510895883777,0.16464891041162227,Yes,0.8353510895883777
57081,57081,99.00,318,54,372,0.8548387096774194,0.14516129032258066,Yes,0.8548387096774194
57082,57082,99.00,9,4,13,0.6923076923076923,0.3076923076923077,Yes,0.6923076923076923
57083,57083,99.00,115,21,136,0.8455882352941176,0.15441176470588236,Yes,0.8455882352941176
57084,57084,99.00,276,73,349,0.7908309455587392,0.20916905444126074,Yes,0.7908309455587392
57085,57085,30.00,222,44,266,0.8345864661654135,0.16541353383458646,Yes,0.8345864661654135
57086,57086,99.00,11,2,13,0.8461538461538461,0.15384615384615385,Yes,0.8461538461538461
57087,57087,30.00,292,49,341,0.8563049853372434,0.1436950146627566,Yes,0.8563049853372434
57088,57088,30.00,19,1,20,0.95,0.05,Yes,0.95
57089,57089,99.00,16,4,20,0.8,0.2,Yes,0.8
57090,57090,99.00,188,29,217,0.8663594470046083,0.1336405529953917,Yes,0.8663594470046083
57091,57091,99.00,236,26,262,0.9007633587786259,0.09923664122137404,Yes,0.9007633587786259
57092,57092,99.00,167,19,186,0.8978494623655914,0.10215053763440861,Yes,0.8978494623655914
57093,57093,99.00,128,15,143,0.8951048951048951,0.1048951048951049,Yes,0.8951048951048951
57094,57094,99.00,2,0,2,1.0,0.0,Yes,1.0
57095,57095,99.00,10,0,10,1.0,0.0,Yes,1.0
57096,57096,30.00,21,2,23,0.9130434782608695,0.08695652173913043,Yes,0.9130434782608695
57097,57097,99.00,1,0,1,1.0,0.0,Yes,1.0
57098,57098,99.00,3,3,6,0.5,0.5,Tie,0.5
57099,57099,99.00,115,19,134,0.8582089552238806,0.1417910447761194,Yes,0.8582089552238806
57100,57100,99.00,5,2,7,0.7142857142857143,0.2857142857142857,Yes,0.7142857142857143
57101,57101,99.00,315,49,364,0.8653846153846154,0.1346153846153846,Yes,0.8653846153846154
57102,57102,99.00,195,29,224,0.8705357142857143,0.12946428571428573,Yes,0.8705357142857143
57103,57103,0.00,20,6,26,0.7692307692307693,0.23076923076923078,Yes,0.7692307692307693
57104,57104,99.00,226,63,289,0.7820069204152249,0.2179930795847751,Yes,0.7820069204152249
57105,57105,99.00,14,5,19,0.7368421052631579,0.2631578947368421,Yes,0.7368421052631579
57106,57106,99.00,0,0,0,0,0,n/a,0
58001,58001,99.00,85,8,93,0.9139784946236559,0.08602150537634409,Yes,0.9139784946236559
58002,58002,99.00,198,14,212,0.9339622641509434,0.0660377358490566,Yes,0.9339622641509434
58003,58003,99.00,2,0,2,1.0,0.0,Yes,1.0
58004,58004,75.00,163,15,178,0.9157303370786517,0.08426966292134831,Yes,0.9157303370786517
58005,58005,75.00,141,23,164,0.8597560975609756,0.1402439024390244,Yes,0.8597560975609756
58006,58006,75.00,0,0,0,0,0,n/a,0
58007,58007,75.00,1,0,1,1.0,0.0,Yes,1.0
58008,58008,99.00,158,16,174,0.9080459770114943,0.09195402298850575,Yes,0.9080459770114943
58009,58009,99.00,137,19,156,0.8782051282051282,0.12179487179487179,Yes,0.8782051282051282
58010,58010,99.00,5,0,5,1.0,0.0,Yes,1.0
58011,58011,99.00,202,22,224,0.9017857142857143,0.09821428571428571,Yes,0.9017857142857143
58012,58012,99.00,135,13,148,0.9121621621621622,0.08783783783783784,Yes,0.9121621621621622
58013,58013,99.00,5,0,5,1.0,0.0,Yes,1.0
58014,58014,99.00,4,0,4,1.0,0.0,Yes,1.0
58015,58015,99.00,149,24,173,0.861271676300578,0.13872832369942195,Yes,0.861271676300578
58016,58016,99.00,78,7,85,0.9176470588235294,0.08235294117647059,Yes,0.9176470588235294
58017,58017,99.00,3,3,6,0.5,0.5,Tie,0.5
58018,58018,99.00,103,30,133,0.7744360902255639,0.22556390977443608,Yes,0.7744360902255639
58019,58019,99.00,174,30,204,0.8529411764705882,0.14705882352941177,Yes,0.8529411764705882
58020,58020,99.00,212,33,245,0.8653061224489796,0.1346938775510204,Yes,0.8653061224489796
58021,58021,99.00,131,22,153,0.8562091503267973,0.1437908496732026,Yes,0.8562091503267973
58022,58022,99.00,4,0,4,1.0,0.0,Yes,1.0
58023,58023,0.00,7,1,8,0.875,0.125,Yes,0.875
58024,58024,99.00,7,1,8,0.875,0.125,Yes,0.875
58025,58025,99.00,143,23,166,0.8614457831325302,0.13855421686746988,Yes,0.8614457831325302
58026,58026,99.00,236,19,255,0.9254901960784314,0.07450980392156863,Yes,0.9254901960784314
58027,58027,99.00,128,23,151,0.847682119205298,0.152317880794702,Yes,0.847682119205298
58028,58028,99.00,195,24,219,0.8904109589041096,0.1095890410958904,Yes,0.8904109589041096
58029,58029,99.00,8,0,8,1.0,0.0,Yes,1.0
58030,58030,99.00,156,30,186,0.8387096774193549,0.16129032258064516,Yes,0.8387096774193549
58031,58031,99.00,209,32,241,0.8672199170124482,0.13278008298755187,Yes,0.8672199170124482
58032,58032,99.00,3,1,4,0.75,0.25,Yes,0.75
58033,58033,0.00,6,3,9,0.6666666666666666,0.3333333333333333,Yes,0.6666666666666666
58034,58034,0.00,8,1,9,0.8888888888888888,0.1111111111111111,Yes,0.8888888888888888
58035,58035,0.00,4,0,4,1.0,0.0,Yes,1.0
58036,58036,99.00,7,0,7,1.0,0.0,Yes,1.0
58037,58037,99.00,7,1,8,0.875,0.125,Yes,0.875
58038,58038,99.00,194,22,216,0.8981481481481481,0.10185185185185185,Yes,0.8981481481481481
58039,58039,37.50,225,35,260,0.8653846153846154,0.1346153846153846,Yes,0.8653846153846154
58040,58040,99.00,3,0,3,1.0,0.0,Yes,1.0
58041,58041,37.50,152,28,180,0.8444444444444444,0.15555555555555556,Yes,0.8444444444444444
58042,58042,37.50,9,1,10,0.9,0.1,Yes,0.9
58043,58043,99.00,209,33,242,0.8636363636363636,0.13636363636363635,Yes,0.8636363636363636
58044,58044,99.00,1,0,1,1.0,0.0,Yes,1.0
58045,58045,99.00,148,23,171,0.8654970760233918,0.13450292397660818,Yes,0.8654970760233918
58046,58046,99.00,221,23,244,0.9057377049180327,0.0942622950819672,Yes,0.9057377049180327
58047,58047,0.00,5,1,6,0.8333333333333334,0.16666666666666666,Yes,0.8333333333333334
58048,58048,0.00,5,0,5,1.0,0.0,Yes,1.0
58049,58049,37.50,18,6,24,0.75,0.25,Yes,0.75
58050,58050,99.00,7,0,7,1.0,0.0,Yes,1.0
58051,58051,99.00,76,11,87,0.8735632183908046,0.12643678160919541,Yes,0.8735632183908046
58052,58052,99.00,119,4,123,0.967479674796748,0.032520325203252036,Yes,0.967479674796748
58053,58053,99.00,2,1,3,0.6666666666666666,0.3333333333333333,Yes,0.6666666666666666
58054,58054,99.00,162,24,186,0.8709677419354839,0.12903225806451613,Yes,0.8709677419354839
58055,58055,99.00,119,19,138,0.8623188405797102,0.13768115942028986,Yes,0.8623188405797102
58056,58056,99.00,3,0,3,1.0,0.0,Yes,1.0
58057,58057,50.00,84,9,93,0.9032258064516129,0.0967741935483871,Yes,0.9032258064516129
58058,58058,99.00,7,2,9,0.7777777777777778,0.2222222222222222,Yes,0.7777777777777778
58059,58059,99.00,162,18,180,0.9,0.1,Yes,0.9
58060,58060,99.00,8,1,9,0.8888888888888888,0.1111111111111111,Yes,0.8888888888888888
58061,58061,99.00,121,14,135,0.8962962962962963,0.1037037037037037,Yes,0.8962962962962963
58062,58062,99.00,156,23,179,0.8715083798882681,0.12849162011173185,Yes,0.8715083798882681
58063,58063,99.00,3,0,3,1.0,0.0,Yes,1.0
58064,58064,99.00,143,28,171,0.8362573099415205,0.16374269005847952,Yes,0.8362573099415205
58065,58065,99.00,180,30,210,0.8571428571428571,0.14285714285714285,Yes,0.8571428571428571
58066,58066,99.00,113,9,122,0.9262295081967213,0.07377049180327869,Yes,0.9262295081967213
58067,58067,99.00,211,22,233,0.9055793991416309,0.0944206008583691,Yes,0.9055793991416309
58068,58068,99.00,164,22,186,0.8817204301075269,0.11827956989247312,Yes,0.8817204301075269
58069,58069,99.00,0,0,0,0,0,n/a,0
58070,58070,99.00,86,11,97,0.8865979381443299,0.1134020618556701,Yes,0.8865979381443299
58071,58071,99.00,112,11,123,0.9105691056910569,0.08943089430894309,Yes,0.9105691056910569
58072,58072,99.00,57,7,64,0.890625,0.109375,Yes,0.890625
58073,58073,99.00,33,8,41,0.8048780487804879,0.1951219512195122,Yes,0.8048780487804879
58074,58074,99.00,4,0,4,1.0,0.0,Yes,1.0
58075,58075,99.00,105,12,117,0.8974358974358975,0.10256410256410256,Yes,0.8974358974358975
58076,58076,99.00,112,12,124,0.9032258064516129,0.0967741935483871,Yes,0.9032258064516129
58077,58077,99.00,121,15,136,0.8897058823529411,0.11029411764705882,Yes,0.8897058823529411
58078,58078,99.00,217,32,249,0.8714859437751004,0.1285140562248996,Yes,0.8714859437751004
58079,58079,99.00,122,16,138,0.8840579710144928,0.11594202898550725,Yes,0.8840579710144928
58080,58080,99.00,205,30,235,0.8723404255319149,0.1276595744680851,Yes,0.8723404255319149
58081,58081,99.00,5,0,5,1.0,0.0,Yes,1.0
58082,58082,99.00,8,0,8,1.0,0.0,Yes,1.0
58083,58083,99.00,7,1,8,0.875,0.125,Yes,0.875
58084,58084,75.00,105,11,116,0.9051724137931034,0.09482758620689655,Yes,0.9051724137931034
58085,58085,99.00,1,1,2,0.5,0.5,Tie,0.5
58086,58086,0.00,6,3,9,0.6666666666666666,0.3333333333333333,Yes,0.6666666666666666
59001,59001,99.00,0,3,3,0.0,1.0,No,1.0
59002,59002,99.00,0,3,3,0.0,1.0,No,1.0
59003,59003,99.00,83,15,98,0.8469387755102041,0.15306122448979592,Yes,0.8469387755102041
59004,59004,99.00,124,16,140,0.8857142857142857,0.11428571428571428,Yes,0.8857142857142857
59005,59005,50.00,72,15,87,0.8275862068965517,0.1724137931034483,Yes,0.8275862068965517
59006,59006,50.00,134,18,152,0.881578947368421,0.11842105263157894,Yes,0.881578947368421
59007,59007,99.00,10,2,12,0.8333333333333334,0.16666666666666666,Yes,0.8333333333333334
59008,59008,99.00,172,30,202,0.8514851485148515,0.1485148514851485,Yes,0.8514851485148515
59009,59009,99.00,0,4,4,0.0,1.0,No,1.0
59010,59010,99.00,113,22,135,0.837037037037037,0.16296296296296298,Yes,0.837037037037037
59011,59011,99.00,144,23,167,0.8622754491017964,0.1377245508982036,Yes,0.8622754491017964
59012,59012,99.00,148,12,160,0.925,0.075,Yes,0.925
59013,59013,50.00,105,26,131,0.8015267175572519,0.1984732824427481,Yes,0.8015267175572519
59014,59014,50.00,94,16,110,0.8545454545454545,0.14545454545454545,Yes,0.8545454545454545
59015,59015,50.00,96,6,102,0.9411764705882353,0.058823529411764705,Yes,0.9411764705882353
59016,59016,99.00,268,42,310,0.864516129032258,0.13548387096774195,Yes,0.864516129032258
59017,59017,99.00,98,25,123,0.7967479674796748,0.2032520325203252,Yes,0.7967479674796748
59018,59018,99.00,165,33,198,0.8333333333333334,0.16666666666666666,Yes,0.8333333333333334
59019,59019,99.00,4,2,6,0.6666666666666666,0.3333333333333333,Yes,0.6666666666666666
59020,59020,99.00,153,23,176,0.8693181818181818,0.13068181818181818,Yes,0.8693181818181818
59021,59021,99.00,128,20,148,0.8648648648648649,0.13513513513513514,Yes,0.8648648648648649
59022,59022,99.00,141,14,155,0.9096774193548387,0.09032258064516129,Yes,0.9096774193548387
59023,59023,99.00,96,24,120,0.8,0.2,Yes,0.8
59024,59024,99.00,99,19,118,0.8389830508474576,0.16101694915254236,Yes,0.8389830508474576
59025,59025,50.00,212,24,236,0.8983050847457628,0.1016949152542373,Yes,0.8983050847457628
59026,59026,99.00,109,25,134,0.8134328358208955,0.1865671641791045,Yes,0.8134328358208955
59027,59027,99.00,212,43,255,0.8313725490196079,0.16862745098039217,Yes,0.8313725490196079
59028,59028,99.00,175,54,229,0.7641921397379913,0.23580786026200873,Yes,0.7641921397379913
59029,59029,99.00,107,24,131,0.816793893129771,0.183206106870229,Yes,0.816793893129771
59030,59030,99.00,5,0,5,1.0,0.0,Yes,1.0
59031,59031,99.00,4,4,8,0.5,0.5,Tie,0.5
59032,59032,99.00,2,0,2,1.0,0.0,Yes,1.0
59033,59033,99.00,175,146,321,0.5451713395638629,0.45482866043613707,Yes,0.5451713395638629
59034,59034,99.00,4,2,6,0.6666666666666666,0.3333333333333333,Yes,0.6666666666666666
59035,59035,99.00,152,74,226,0.672566371681416,0.3274336283185841,Yes,0.672566371681416
59036,59036,99.00,133,88,221,0.6018099547511312,0.39819004524886875,Yes,0.6018099547511312
59037,59037,99.00,115,57,172,0.6686046511627907,0.3313953488372093,Yes,0.6686046511627907
59038,59038,99.00,140,125,265,0.5283018867924528,0.4716981132075472,Yes,0.5283018867924528
59039,59039,99.00,139,71,210,0.6619047619047619,0.3380952380952381,Yes,0.6619047619047619
59040,59040,99.00,121,80,201,0.6019900497512438,0.39800995024875624,Yes,0.6019900497512438
59041,59041,99.00,144,23,167,0.8622754491017964,0.1377245508982036,Yes,0.8622754491017964
59042,59042,99.00,186,136,322,0.577639751552795,0.422360248447205,Yes,0.577639751552795
59043,59043,99.00,3,2,5,0.6,0.4,Yes,0.6
59044,59044,99.00,182,168,350,0.52,0.48,Yes,0.52
59045,59045,99.00,3,4,7,0.42857142857142855,0.5714285714285714,No,0.5714285714285714
59046,59046,99.00,0,0,0,0,0,n/a,0
59047,59047,99.00,13,2,15,0.8666666666666667,0.13333333333333333,Yes,0.8666666666666667
59048,59048,99.00,0,0,0,0,0,n/a,0
59049,59049,99.00,6,1,7,0.8571428571428571,0.14285714285714285,Yes,0.8571428571428571
59050,59050,99.00,115,23,138,0.8333333333333334,0.16666666666666666,Yes,0.8333333333333334
59051,59051,99.00,111,55,166,0.6686746987951807,0.3313253012048193,Yes,0.6686746987951807
59052,59052,99.00,62,57,119,0.5210084033613446,0.4789915966386555,Yes,0.5210084033613446
59053,59053,99.00,39,56,95,0.4105263157894737,0.5894736842105263,No,0.5894736842105263
59054,59054,99.00,70,45,115,0.6086956521739131,0.391304347826087,Yes,0.6086956521739131
59055,59055,99.00,131,65,196,0.6683673469387755,0.33163265306122447,Yes,0.6683673469387755
59056,59056,99.00,103,11,114,0.9035087719298246,0.09649122807017543,Yes,0.9035087719298246
59057,59057,99.00,125,63,188,0.6648936170212766,0.3351063829787234,Yes,0.6648936170212766
59058,59058,99.00,67,23,90,0.7444444444444445,0.25555555555555554,Yes,0.7444444444444445
59059,59059,99.00,76,45,121,0.628099173553719,0.371900826446281,Yes,0.628099173553719
59060,59060,99.00,1,6,7,0.14285714285714285,0.8571428571428571,No,0.8571428571428571
59061,59061,99.00,132,86,218,0.6055045871559633,0.3944954128440367,Yes,0.6055045871559633
59062,59062,99.00,0,2,2,0.0,1.0,No,1.0
59063,59063,99.00,128,21,149,0.8590604026845637,0.14093959731543623,Yes,0.8590604026845637
59064,59064,99.00,13,2,15,0.8666666666666667,0.13333333333333333,Yes,0.8666666666666667
59065,59065,99.00,14,2,16,0.875,0.125,Yes,0.875
59066,59066,99.00,194,23,217,0.8940092165898618,0.10599078341013825,Yes,0.8940092165898618
59067,59067,85.71,15,0,15,1.0,0.0,Yes,1.0
59068,59068,85.71,4,0,4,1.0,0.0,Yes,1.0
59069,59069,85.71,9,0,9,1.0,0.0,Yes,1.0
59070,59070,85.71,154,24,178,0.8651685393258427,0.1348314606741573,Yes,0.8651685393258427
59071,59071,99.00,140,25,165,0.8484848484848485,0.15151515151515152,Yes,0.8484848484848485
59072,59072,99.00,184,54,238,0.773109243697479,0.226890756302521,Yes,0.773109243697479
59073,59073,85.71,169,30,199,0.8492462311557789,0.1507537688442211,Yes,0.8492462311557789
59074,59074,85.71,94,16,110,0.8545454545454545,0.14545454545454545,Yes,0.8545454545454545
59075,59075,85.71,185,31,216,0.8564814814814815,0.14351851851851852,Yes,0.8564814814814815
59076,59076,99.00,9,0,9,1.0,0.0,Yes,1.0
59077,59077,99.00,7,0,7,1.0,0.0,Yes,1.0
59078,59078,99.00,4,0,4,1.0,0.0,Yes,1.0
59079,59079,99.00,8,2,10,0.8,0.2,Yes,0.8
59080,59080,99.00,5,2,7,0.7142857142857143,0.2857142857142857,Yes,0.7142857142857143
59081,59081,85.71,5,1,6,0.8333333333333334,0.16666666666666666,Yes,0.8333333333333334
59082,59082,99.00,5,3,8,0.625,0.375,Yes,0.625
59083,59083,99.00,80,25,105,0.7619047619047619,0.23809523809523808,Yes,0.7619047619047619
59084,59084,85.71,155,21,176,0.8806818181818182,0.11931818181818182,Yes,0.8806818181818182
59085,59085,50.00,11,7,18,0.6111111111111112,0.3888888888888889,Yes,0.6111111111111112
59086,59086,99.00,0,0,0,0,0,n/a,0
59087,59087,99.00,0,0,0,0,0,n/a,0
59088,59088,99.00,0,0,0,0,0,n/a,0
59089,59089,99.00,0,0,0,0,0,n/a,0
59090,59090,99.00,0,0,0,0,0,n/a,0
60001,60001,99.00,39,10,49,0.7959183673469388,0.20408163265306123,Yes,0.7959183673469388
60002,60002,99.00,98,26,124,0.7903225806451613,0.20967741935483872,Yes,0.7903225806451613
60003,60003,99.00,85,16,101,0.8415841584158416,0.15841584158415842,Yes,0.8415841584158416
60004,60004,99.00,4,0,4,1.0,0.0,Yes,1.0
60005,60005,99.00,180,16,196,0.9183673469387755,0.08163265306122448,Yes,0.9183673469387755
60006,60006,99.00,27,5,32,0.84375,0.15625,Yes,0.84375
60007,60007,99.00,120,15,135,0.8888888888888888,0.1111111111111111,Yes,0.8888888888888888
60008,60008,99.00,131,8,139,0.9424460431654677,0.05755395683453238,Yes,0.9424460431654677
60009,60009,99.00,131,17,148,0.8851351351351351,0.11486486486486487,Yes,0.8851351351351351
60010,60010,99.00,74,15,89,0.8314606741573034,0.16853932584269662,Yes,0.8314606741573034
60011,60011,99.00,0,0,0,0,0,n/a,0
60012,60012,99.00,5,0,5,1.0,0.0,Yes,1.0
60013,60013,99.00,97,13,110,0.8818181818181818,0.11818181818181818,Yes,0.8818181818181818
60014,60014,99.00,144,14,158,0.9113924050632911,0.08860759493670886,Yes,0.9113924050632911
60015,60015,66.67,59,8,67,0.8805970149253731,0.11940298507462686,Yes,0.8805970149253731
60016,60016,99.00,0,0,0,0,0,n/a,0
60017,60017,99.00,177,32,209,0.84688995215311,0.15311004784688995,Yes,0.84688995215311
60018,60018,66.67,1,0,1,1.0,0.0,Yes,1.0
60019,60019,66.67,1,0,1,1.0,0.0,Yes,1.0
60020,60020,99.00,0,0,0,0,0,n/a,0
60021,60021,99.00,60,14,74,0.8108108108108109,0.1891891891891892,Yes,0.8108108108108109
60022,60022,99.00,65,11,76,0.8552631578947368,0.14473684210526316,Yes,0.8552631578947368
60023,60023,99.00,0,0,0,0,0,n/a,0
60024,60024,99.00,54,11,65,0.8307692307692308,0.16923076923076924,Yes,0.8307692307692308
60025,60025,99.00,0,0,0,0,0,n/a,0
60026,60026,99.00,109,81,190,0.5736842105263158,0.4263157894736842,Yes,0.5736842105263158
60027,60027,99.00,148,34,182,0.8131868131868132,0.18681318681318682,Yes,0.8131868131868132
60028,60028,99.00,198,54,252,0.7857142857142857,0.21428571428571427,Yes,0.7857142857142857
60029,60029,99.00,74,29,103,0.7184466019417476,0.2815533980582524,Yes,0.7184466019417476
60030,60030,99.00,4,0,4,1.0,0.0,Yes,1.0
60031,60031,66.67,49,10,59,0.8305084745762712,0.1694915254237288,Yes,0.8305084745762712
60032,60032,99.00,78,17,95,0.8210526315789474,0.17894736842105263,Yes,0.8210526315789474
60033,60033,99.00,196,22,218,0.8990825688073395,0.10091743119266056,Yes,0.8990825688073395
60034,60034,99.00,94,20,114,0.8245614035087719,0.17543859649122806,Yes,0.8245614035087719
60035,60035,99.00,4,0,4,1.0,0.0,Yes,1.0
60036,60036,99.00,88,10,98,0.8979591836734694,0.10204081632653061,Yes,0.8979591836734694
60037,60037,99.00,5,0,5,1.0,0.0,Yes,1.0
60038,60038,99.00,7,3,10,0.7,0.3,Yes,0.7
60039,60039,66.67,65,7,72,0.9027777777777778,0.09722222222222222,Yes,0.9027777777777778
60040,60040,66.67,63,10,73,0.863013698630137,0.136986301369863,Yes,0.863013698630137
60041,60041,66.67,69,14,83,0.8313253012048193,0.1686746987951807,Yes,0.8313253012048193
60042,60042,99.00,79,12,91,0.8681318681318682,0.13186813186813187,Yes,0.8681318681318682
60043,60043,99.00,78,11,89,0.8764044943820225,0.12359550561797752,Yes,0.8764044943820225
60044,60044,99.00,10,1,11,0.9090909090909091,0.09090909090909091,Yes,0.9090909090909091
60045,60045,99.00,121,16,137,0.8832116788321168,0.11678832116788321,Yes,0.8832116788321168
60046,60046,99.00,140,23,163,0.8588957055214724,0.1411042944785276,Yes,0.8588957055214724
60047,60047,99.00,105,14,119,0.8823529411764706,0.11764705882352941,Yes,0.8823529411764706
60048,60048,66.67,4,2,6,0.6666666666666666,0.3333333333333333,Yes,0.6666666666666666
60049,60049,66.67,78,17,95,0.8210526315789474,0.17894736842105263,Yes,0.8210526315789474
60050,60050,66.67,0,0,0,0,0,n/a,0
60051,60051,66.67,86,17,103,0.8349514563106796,0.1650485436893204,Yes,0.8349514563106796
60052,60052,99.00,77,7,84,0.9166666666666666,0.08333333333333333,Yes,0.9166666666666666
60053,60053,99.00,120,9,129,0.9302325581395349,0.06976744186046512,Yes,0.9302325581395349
60054,60054,99.00,140,20,160,0.875,0.125,Yes,0.875
60055,60055,99.00,195,31,226,0.8628318584070797,0.13716814159292035,Yes,0.8628318584070797
60056,60056,99.00,142,18,160,0.8875,0.1125,Yes,0.8875
60057,60057,99.00,103,14,117,0.8803418803418803,0.11965811965811966,Yes,0.8803418803418803
60058,60058,99.00,58,7,65,0.8923076923076924,0.1076923076923077,Yes,0.8923076923076924
60059,60059,99.00,5,0,5,1.0,0.0,Yes,1.0
60060,60060,99.00,113,17,130,0.8692307692307693,0.13076923076923078,Yes,0.8692307692307693
60061,60061,99.00,4,3,7,0.5714285714285714,0.42857142857142855,Yes,0.5714285714285714
60062,60062,99.00,109,20,129,0.8449612403100775,0.15503875968992248,Yes,0.8449612403100775
60063,60063,99.00,120,19,139,0.8633093525179856,0.1366906474820144,Yes,0.8633093525179856
60064,60064,99.00,4,0,4,1.0,0.0,Yes,1.0
60065,60065,99.00,122,19,141,0.8652482269503546,0.1347517730496454,Yes,0.8652482269503546
60066,60066,99.00,133,28,161,0.8260869565217391,0.17391304347826086,Yes,0.8260869565217391
60067,60067,99.00,0,0,0,0,0,n/a,0
60068,60068,99.00,3,0,3,1.0,0.0,Yes,1.0
60069,60069,99.00,3,0,3,1.0,0.0,Yes,1.0
60070,60070,99.00,6,1,7,0.8571428571428571,0.14285714285714285,Yes,0.8571428571428571
60071,60071,99.00,129,16,145,0.8896551724137931,0.1103448275862069,Yes,0.8896551724137931
60072,60072,99.00,149,25,174,0.8563218390804598,0.14367816091954022,Yes,0.8563218390804598
60073,60073,99.00,2,0,2,1.0,0.0,Yes,1.0
60074,60074,99.00,101,16,117,0.8632478632478633,0.13675213675213677,Yes,0.8632478632478633
60075,60075,99.00,129,26,155,0.832258064516129,0.16774193548387098,Yes,0.832258064516129
60076,60076,99.00,2,0,2,1.0,0.0,Yes,1.0
60077,60077,99.00,3,2,5,0.6,0.4,Yes,0.6
60078,60078,99.00,181,43,224,0.8080357142857143,0.19196428571428573,Yes,0.8080357142857143
60079,60079,99.00,91,13,104,0.875,0.125,Yes,0.875
60080,60080,99.00,101,20,121,0.8347107438016529,0.1652892561983471,Yes,0.8347107438016529
60081,60081,99.00,215,34,249,0.8634538152610441,0.13654618473895583,Yes,0.8634538152610441
60082,60082,99.00,227,31,258,0.8798449612403101,0.12015503875968993,Yes,0.8798449612403101
60083,60083,22.22,153,23,176,0.8693181818181818,0.13068181818181818,Yes,0.8693181818181818
60084,60084,22.22,17,2,19,0.8947368421052632,0.10526315789473684,Yes,0.8947368421052632
60085,60085,99.00,211,26,237,0.890295358649789,0.10970464135021098,Yes,0.890295358649789
60086,60086,22.22,240,34,274,0.8759124087591241,0.12408759124087591,Yes,0.8759124087591241
60087,60087,99.00,5,1,6,0.8333333333333334,0.16666666666666666,Yes,0.8333333333333334
60088,60088,99.00,76,18,94,0.8085106382978723,0.19148936170212766,Yes,0.8085106382978723
60089,60089,99.00,3,0,3,1.0,0.0,Yes,1.0
60090,60090,99.00,3,1,4,0.75,0.25,Yes,0.75
60091,60091,66.67,73,12,85,0.8588235294117647,0.1411764705882353,Yes,0.8588235294117647
64001,64001,50.00,88,47,135,0.6518518518518519,0.34814814814814815,Yes,0.6518518518518519
64002,64002,50.00,123,76,199,0.6180904522613065,0.38190954773869346,Yes,0.6180904522613065
64003,64003,99.00,188,166,354,0.5310734463276836,0.4689265536723164,Yes,0.5310734463276836
64004,64004,99.00,5,2,7,0.7142857142857143,0.2857142857142857,Yes,0.7142857142857143
64005,64005,99.00,219,141,360,0.6083333333333333,0.39166666666666666,Yes,0.6083333333333333
64006,64006,50.00,134,87,221,0.6063348416289592,0.3936651583710407,Yes,0.6063348416289592
64007,64007,50.00,148,83,231,0.6406926406926406,0.3593073593073593,Yes,0.6406926406926406
64008,64008,99.00,13,10,23,0.5652173913043478,0.43478260869565216,Yes,0.5652173913043478
64009,64009,99.00,147,141,288,0.5104166666666666,0.4895833333333333,Yes,0.5104166666666666
64010,64010,99.00,7,2,9,0.7777777777777778,0.2222222222222222,Yes,0.7777777777777778
64011,64011,99.00,148,99,247,0.5991902834008097,0.4008097165991903,Yes,0.5991902834008097
64012,64012,99.00,3,2,5,0.6,0.4,Yes,0.6
64013,64013,99.00,5,0,5,1.0,0.0,Yes,1.0
64014,64014,99.00,213,156,369,0.5772357723577236,0.42276422764227645,Yes,0.5772357723577236
64015,64015,99.00,8,9,17,0.47058823529411764,0.5294117647058824,No,0.5294117647058824
64016,64016,57.14,220,123,343,0.641399416909621,0.358600583090379,Yes,0.641399416909621
64017,64017,57.14,30,10,40,0.75,0.25,Yes,0.75
64018,64018,99.00,87,39,126,0.6904761904761905,0.30952380952380953,Yes,0.6904761904761905
64019,64019,57.14,58,27,85,0.6823529411764706,0.3176470588235294,Yes,0.6823529411764706
64020,64020,99.00,91,40,131,0.6946564885496184,0.3053435114503817,Yes,0.6946564885496184
64021,64021,99.00,89,58,147,0.6054421768707483,0.3945578231292517,Yes,0.6054421768707483
64022,64022,57.14,197,148,345,0.5710144927536231,0.4289855072463768,Yes,0.5710144927536231
64023,64023,99.00,202,106,308,0.6558441558441559,0.34415584415584416,Yes,0.6558441558441559
64024,64024,99.00,154,93,247,0.6234817813765182,0.3765182186234818,Yes,0.6234817813765182
64025,64025,99.00,91,54,145,0.6275862068965518,0.3724137931034483,Yes,0.6275862068965518
64026,64026,99.00,6,2,8,0.75,0.25,Yes,0.75
64027,64027,99.00,74,60,134,0.5522388059701493,0.44776119402985076,Yes,0.5522388059701493
64028,64028,99.00,147,91,238,0.6176470588235294,0.38235294117647056,Yes,0.6176470588235294
64029,64029,99.00,10,6,16,0.625,0.375,Yes,0.625
64030,64030,99.00,174,92,266,0.6541353383458647,0.3458646616541353,Yes,0.6541353383458647
64031,64031,99.00,9,1,10,0.9,0.1,Yes,0.9
64032,64032,99.00,175,93,268,0.6529850746268657,0.34701492537313433,Yes,0.6529850746268657
64033,64033,99.00,67,66,133,0.5037593984962406,0.49624060150375937,Yes,0.5037593984962406
64034,64034,99.00,11,1,12,0.9166666666666666,0.08333333333333333,Yes,0.9166666666666666
64035,64035,99.00,109,37,146,0.7465753424657534,0.2534246575342466,Yes,0.7465753424657534
64036,64036,99.00,164,84,248,0.6612903225806451,0.3387096774193548,Yes,0.6612903225806451
64037,64037,99.00,147,101,248,0.592741935483871,0.40725806451612906,Yes,0.592741935483871
64038,64038,99.00,103,43,146,0.7054794520547946,0.2945205479452055,Yes,0.7054794520547946
64039,64039,99.00,5,1,6,0.8333333333333334,0.16666666666666666,Yes,0.8333333333333334
64040,64040,99.00,99,21,120,0.825,0.175,Yes,0.825
64041,64041,99.00,142,75,217,0.6543778801843319,0.3456221198156682,Yes,0.6543778801843319
64042,64042,99.00,81,37,118,0.6864406779661016,0.3135593220338983,Yes,0.6864406779661016
64043,64043,99.00,126,34,160,0.7875,0.2125,Yes,0.7875
64044,64044,99.00,88,25,113,0.7787610619469026,0.22123893805309736,Yes,0.7787610619469026
64045,64045,99.00,13,4,17,0.7647058823529411,0.23529411764705882,Yes,0.7647058823529411
64046,64046,99.00,16,5,21,0.7619047619047619,0.23809523809523808,Yes,0.7619047619047619
64047,64047,99.00,216,107,323,0.6687306501547987,0.33126934984520123,Yes,0.6687306501547987
64048,64048,99.00,113,78,191,0.5916230366492147,0.4083769633507853,Yes,0.5916230366492147
64049,64049,99.00,101,55,156,0.6474358974358975,0.3525641025641026,Yes,0.6474358974358975
64050,64050,99.00,6,1,7,0.8571428571428571,0.14285714285714285,Yes,0.8571428571428571
64051,64051,99.00,196,71,267,0.7340823970037453,0.26591760299625467,Yes,0.7340823970037453
64052,64052,99.00,6,4,10,0.6,0.4,Yes,0.6
64053,64053,99.00,160,64,224,0.7142857142857143,0.2857142857142857,Yes,0.7142857142857143
64054,64054,99.00,114,88,202,0.5643564356435643,0.43564356435643564,Yes,0.5643564356435643
64055,64055,99.00,104,55,159,0.6540880503144654,0.34591194968553457,Yes,0.6540880503144654
64056,64056,57.14,24,12,36,0.6666666666666666,0.3333333333333333,Yes,0.6666666666666666
64057,64057,99.00,3,2,5,0.6,0.4,Yes,0.6
64058,64058,50.00,97,62,159,0.610062893081761,0.389937106918239,Yes,0.610062893081761
64059,64059,99.00,75,45,120,0.625,0.375,Yes,0.625
64060,64060,99.00,8,2,10,0.8,0.2,Yes,0.8
64061,64061,99.00,4,4,8,0.5,0.5,Tie,0.5
64062,64062,99.00,113,42,155,0.7290322580645161,0.2709677419354839,Yes,0.7290322580645161
64063,64063,99.00,96,42,138,0.6956521739130435,0.30434782608695654,Yes,0.6956521739130435
64064,64064,99.00,0,0,0,0,0,n/a,0
64065,64065,99.00,0,0,0,0,0,n/a,0
64066,64066,99.00,0,0,0,0,0,n/a,0
64067,64067,99.00,0,0,0,0,0,n/a,0
64068,64068,99.00,0,0,0,0,0,n/a,0
64069,64069,99.00,0,0,0,0,0,n/a,0
64070,64070,99.00,0,0,0,0,0,n/a,0
64075,64075,99.00,136,54,190,0.7157894736842105,0.28421052631578947,Yes,0.7157894736842105
64076,64076,99.00,126,56,182,0.6923076923076923,0.3076923076923077,Yes,0.6923076923076923
64077,64077,99.00,165,51,216,0.7638888888888888,0.2361111111111111,Yes,0.7638888888888888
64078,64078,99.00,6,6,12,0.5,0.5,Tie,0.5
64079,64079,99.00,225,102,327,0.6880733944954128,0.3119266055045872,Yes,0.6880733944954128
64080,64080,99.00,136,52,188,0.723404255319149,0.2765957446808511,Yes,0.723404255319149
64081,64081,99.00,3,1,4,0.75,0.25,Yes,0.75
64082,64082,99.00,0,1,1,0.0,1.0,No,1.0
64083,64083,99.00,147,61,208,0.7067307692307693,0.2932692307692308,Yes,0.7067307692307693
64084,64084,99.00,152,60,212,0.7169811320754716,0.2830188679245283,Yes,0.7169811320754716
64085,64085,99.00,13,5,18,0.7222222222222222,0.2777777777777778,Yes,0.7222222222222222
64086,64086,99.00,120,57,177,0.6779661016949152,0.3220338983050847,Yes,0.6779661016949152
64087,64087,99.00,143,38,181,0.7900552486187845,0.20994475138121546,Yes,0.7900552486187845
64088,64088,99.00,126,53,179,0.7039106145251397,0.29608938547486036,Yes,0.7039106145251397
64089,64089,33.33,138,98,236,0.5847457627118644,0.4152542372881356,Yes,0.5847457627118644
64090,64090,0.00,10,6,16,0.625,0.375,Yes,0.625
64091,64091,33.33,17,3,20,0.85,0.15,Yes,0.85
64092,64092,99.00,188,62,250,0.752,0.248,Yes,0.752
64093,64093,99.00,161,57,218,0.7385321100917431,0.26146788990825687,Yes,0.7385321100917431
64094,64094,99.00,0,0,0,0,0,n/a,0
64095,64095,99.00,0,0,0,0,0,n/a,0
64096,64096,33.33,0,0,0,0,0,n/a,0
64097,64097,99.00,0,0,0,0,0,n/a,0
64098,64098,33.33,0,0,0,0,0,n/a,0
64099,64099,33.33,0,0,0,0,0,n/a,0
23001,23001,99.00,235,141,376,0.625,0.375,Yes,0.625
23002,23002,99.00,250,156,406,0.6157635467980296,0.3842364532019704,Yes,0.6157635467980296
23003,23003,99.00,273,141,414,0.6594202898550725,0.34057971014492755,Yes,0.6594202898550725
23004,23004,99.00,3,0,3,1.0,0.0,Yes,1.0
23005,23005,99.00,133,109,242,0.5495867768595041,0.45041322314049587,Yes,0.5495867768595041
23006,23006,99.00,311,225,536,0.5802238805970149,0.4197761194029851,Yes,0.5802238805970149
23007,23007,99.00,13,8,21,0.6190476190476191,0.38095238095238093,Yes,0.6190476190476191
23008,23008,99.00,314,267,581,0.540447504302926,0.459552495697074,Yes,0.540447504302926
23009,23009,99.00,16,10,26,0.6153846153846154,0.38461538461538464,Yes,0.6153846153846154
23010,23010,99.00,283,192,475,0.5957894736842105,0.40421052631578946,Yes,0.5957894736842105
23011,23011,99.00,183,85,268,0.6828358208955224,0.31716417910447764,Yes,0.6828358208955224
23012,23012,99.00,124,54,178,0.6966292134831461,0.30337078651685395,Yes,0.6966292134831461
23013,23013,99.00,159,83,242,0.6570247933884298,0.34297520661157027,Yes,0.6570247933884298
23014,23014,99.00,182,101,283,0.6431095406360424,0.3568904593639576,Yes,0.6431095406360424
23015,23015,99.00,178,44,222,0.8018018018018018,0.1981981981981982,Yes,0.8018018018018018
23016,23016,99.00,149,40,189,0.7883597883597884,0.21164021164021163,Yes,0.7883597883597884
23017,23017,99.00,202,65,267,0.7565543071161048,0.24344569288389514,Yes,0.7565543071161048
23018,23018,99.00,89,18,107,0.8317757009345794,0.16822429906542055,Yes,0.8317757009345794
23019,23019,99.00,187,43,230,0.8130434782608695,0.18695652173913044,Yes,0.8130434782608695
23020,23020,99.00,0,0,0,0,0,n/a,0
23021,23021,99.00,40,11,51,0.7843137254901961,0.21568627450980393,Yes,0.7843137254901961
23022,23022,99.00,0,0,0,0,0,n/a,0
23023,23023,99.00,131,49,180,0.7277777777777777,0.2722222222222222,Yes,0.7277777777777777
23024,23024,99.00,6,0,6,1.0,0.0,Yes,1.0
23025,23025,99.00,57,74,131,0.4351145038167939,0.5648854961832062,No,0.5648854961832062
23026,23026,99.00,93,29,122,0.7622950819672131,0.23770491803278687,Yes,0.7622950819672131
23027,23027,99.00,76,195,271,0.28044280442804426,0.7195571955719557,No,0.7195571955719557
23028,23028,99.00,44,118,162,0.2716049382716049,0.7283950617283951,No,0.7283950617283951
23029,23029,99.00,98,62,160,0.6125,0.3875,Yes,0.6125
23030,23030,99.00,4,2,6,0.6666666666666666,0.3333333333333333,Yes,0.6666666666666666
23031,23031,99.00,124,168,292,0.4246575342465753,0.5753424657534246,No,0.5753424657534246
23032,23032,99.00,6,1,7,0.8571428571428571,0.14285714285714285,Yes,0.8571428571428571
23033,23033,99.00,191,28,219,0.8721461187214612,0.1278538812785388,Yes,0.8721461187214612
23034,23034,99.00,64,16,80,0.8,0.2,Yes,0.8
23035,23035,99.00,3,3,6,0.5,0.5,Tie,0.5
23036,23036,99.00,83,81,164,0.5060975609756098,0.49390243902439024,Yes,0.5060975609756098
23037,23037,99.00,166,84,250,0.664,0.336,Yes,0.664
23038,23038,99.00,77,14,91,0.8461538461538461,0.15384615384615385,Yes,0.8461538461538461
23039,23039,99.00,3,3,6,0.5,0.5,Tie,0.5
23040,23040,99.00,193,210,403,0.47890818858560796,0.5210918114143921,No,0.5210918114143921
23041,23041,99.00,5,7,12,0.4166666666666667,0.5833333333333334,No,0.5833333333333334
23042,23042,99.00,112,20,132,0.8484848484848485,0.15151515151515152,Yes,0.8484848484848485
23043,23043,99.00,53,14,67,0.7910447761194029,0.208955223880597,Yes,0.7910447761194029
23044,23044,99.00,114,176,290,0.3931034482758621,0.6068965517241379,No,0.6068965517241379
23045,23045,99.00,161,175,336,0.4791666666666667,0.5208333333333334,No,0.5208333333333334
23046,23046,99.00,4,2,6,0.6666666666666666,0.3333333333333333,Yes,0.6666666666666666
23047,23047,99.00,109,140,249,0.43775100401606426,0.5622489959839357,No,0.5622489959839357
23048,23048,99.00,3,0,3,1.0,0.0,Yes,1.0
23049,23049,99.00,114,112,226,0.504424778761062,0.49557522123893805,Yes,0.504424778761062
23050,23050,99.00,100,86,186,0.5376344086021505,0.46236559139784944,Yes,0.5376344086021505
23051,23051,99.00,105,115,220,0.4772727272727273,0.5227272727272727,No,0.5227272727272727
23052,23052,99.00,115,73,188,0.6117021276595744,0.3882978723404255,Yes,0.6117021276595744
23053,23053,99.00,102,56,158,0.6455696202531646,0.35443037974683544,Yes,0.6455696202531646
23054,23054,99.00,106,33,139,0.762589928057554,0.23741007194244604,Yes,0.762589928057554
23055,23055,99.00,73,24,97,0.7525773195876289,0.24742268041237114,Yes,0.7525773195876289
23056,23056,99.00,67,21,88,0.7613636363636364,0.23863636363636365,Yes,0.7613636363636364
23057,23057,99.00,74,34,108,0.6851851851851852,0.3148148148148148,Yes,0.6851851851851852
23058,23058,99.00,88,35,123,0.7154471544715447,0.2845528455284553,Yes,0.7154471544715447
23059,23059,99.00,69,17,86,0.8023255813953488,0.19767441860465115,Yes,0.8023255813953488
23060,23060,99.00,128,44,172,0.7441860465116279,0.2558139534883721,Yes,0.7441860465116279
23061,23061,99.00,206,64,270,0.762962962962963,0.23703703703703705,Yes,0.762962962962963
23062,23062,99.00,243,117,360,0.675,0.325,Yes,0.675
23063,23063,99.00,6,0,6,1.0,0.0,Yes,1.0
23064,23064,99.00,184,113,297,0.6195286195286195,0.38047138047138046,Yes,0.6195286195286195
23065,23065,99.00,88,43,131,0.6717557251908397,0.3282442748091603,Yes,0.6717557251908397
23066,23066,99.00,2,0,2,1.0,0.0,Yes,1.0
23067,23067,99.00,88,24,112,0.7857142857142857,0.21428571428571427,Yes,0.7857142857142857
23068,23068,99.00,0,0,0,0,0,n/a,0
23069,23069,99.00,3,0,3,1.0,0.0,Yes,1.0
23070,23070,99.00,54,25,79,0.6835443037974683,0.31645569620253167,Yes,0.6835443037974683
23071,23071,99.00,0,0,0,0,0,n/a,0
23072,23072,99.00,0,0,0,0,0,n/a,0
23073,23073,99.00,0,0,0,0,0,n/a,0
23074,23074,99.00,0,0,0,0,0,n/a,0
23075,23075,99.00,0,0,0,0,0,n/a,0
23076,23076,99.00,0,0,0,0,0,n/a,0
23077,23077,99.00,0,0,0,0,0,n/a,0
23078,23078,99.00,0,0,0,0,0,n/a,0
23079,23079,99.00,0,0,0,0,0,n/a,0
23080,23080,99.00,0,0,0,0,0,n/a,0
23081,23081,99.00,0,0,0,0,0,n/a,0
23082,23082,99.00,0,0,0,0,0,n/a,0
23083,23083,99.00,0,0,0,0,0,n/a,0
23084,23084,99.00,3,0,3,1.0,0.0,Yes,1.0
23085,23085,99.00,10,5,15,0.6666666666666666,0.3333333333333333,Yes,0.6666666666666666
23086,23086,99.00,11,6,17,0.6470588235294118,0.35294117647058826,Yes,0.6470588235294118
23087,23087,99.00,8,7,15,0.5333333333333333,0.4666666666666667,Yes,0.5333333333333333
23088,23088,99.00,3,3,6,0.5,0.5,Tie,0.5
23089,23089,99.00,3,1,4,0.75,0.25,Yes,0.75
23090,23090,99.00,1,0,1,1.0,0.0,Yes,1.0
23091,23091,99.00,1,0,1,1.0,0.0,Yes,1.0
23092,23092,99.00,14,7,21,0.6666666666666666,0.3333333333333333,Yes,0.6666666666666666
23093,23093,99.00,0,0,0,0,0,n/a,0
24001,24001,99.00,6,4,10,0.6,0.4,Yes,0.6
24002,24002,99.00,217,73,290,0.7482758620689656,0.2517241379310345,Yes,0.7482758620689656
24003,24003,99.00,207,67,274,0.7554744525547445,0.24452554744525548,Yes,0.7554744525547445
24004,24004,99.00,7,8,15,0.4666666666666667,0.5333333333333333,No,0.5333333333333333
24005,24005,99.00,88,44,132,0.6666666666666666,0.3333333333333333,Yes,0.6666666666666666
24006,24006,99.00,171,53,224,0.7633928571428571,0.23660714285714285,Yes,0.7633928571428571
24007,24007,99.00,6,3,9,0.6666666666666666,0.3333333333333333,Yes,0.6666666666666666
24008,24008,99.00,23,5,28,0.8214285714285714,0.17857142857142858,Yes,0.8214285714285714
24009,24009,99.00,0,0,0,0,0,n/a,0
24010,24010,99.00,122,34,156,0.782051282051282,0.21794871794871795,Yes,0.782051282051282
24011,24011,99.00,3,0,3,1.0,0.0,Yes,1.0
24012,24012,99.00,0,1,1,0.0,1.0,No,1.0
24013,24013,99.00,175,60,235,0.7446808510638298,0.2553191489361702,Yes,0.7446808510638298
24014,24014,99.00,10,4,14,0.7142857142857143,0.2857142857142857,Yes,0.7142857142857143
24015,24015,99.00,226,50,276,0.8188405797101449,0.18115942028985507,Yes,0.8188405797101449
24016,24016,99.00,164,64,228,0.7192982456140351,0.2807017543859649,Yes,0.7192982456140351
24017,24017,99.00,124,37,161,0.7701863354037267,0.22981366459627328,Yes,0.7701863354037267
24018,24018,99.00,5,0,5,1.0,0.0,Yes,1.0
24019,24019,99.00,225,112,337,0.6676557863501483,0.3323442136498516,Yes,0.6676557863501483
24020,24020,99.00,163,61,224,0.7276785714285714,0.27232142857142855,Yes,0.7276785714285714
24021,24021,99.00,132,47,179,0.7374301675977654,0.26256983240223464,Yes,0.7374301675977654
24022,24022,99.00,8,3,11,0.7272727272727273,0.2727272727272727,Yes,0.7272727272727273
24023,24023,99.00,2,0,2,1.0,0.0,Yes,1.0
24024,24024,99.00,205,93,298,0.6879194630872483,0.31208053691275167,Yes,0.6879194630872483
24025,24025,99.00,7,2,9,0.7777777777777778,0.2222222222222222,Yes,0.7777777777777778
24026,24026,99.00,49,8,57,0.8596491228070176,0.14035087719298245,Yes,0.8596491228070176
24027,24027,99.00,145,28,173,0.838150289017341,0.16184971098265896,Yes,0.838150289017341
24028,24028,99.00,190,90,280,0.6785714285714286,0.32142857142857145,Yes,0.6785714285714286
24029,24029,99.00,291,48,339,0.8584070796460177,0.1415929203539823,Yes,0.8584070796460177
24030,24030,99.00,10,0,10,1.0,0.0,Yes,1.0
24031,24031,99.00,177,48,225,0.7866666666666666,0.21333333333333335,Yes,0.7866666666666666
24032,24032,99.00,0,0,0,0,0,n/a,0
24033,24033,99.00,97,49,146,0.6643835616438356,0.3356164383561644,Yes,0.6643835616438356
24034,24034,99.00,114,65,179,0.6368715083798883,0.36312849162011174,Yes,0.6368715083798883
24035,24035,99.00,3,1,4,0.75,0.25,Yes,0.75
24036,24036,99.00,150,39,189,0.7936507936507936,0.20634920634920634,Yes,0.7936507936507936
24037,24037,99.00,1,0,1,1.0,0.0,Yes,1.0
24038,24038,99.00,0,0,0,0,0,n/a,0
24039,24039,99.00,1,0,1,1.0,0.0,Yes,1.0
24040,24040,99.00,255,50,305,0.8360655737704918,0.16393442622950818,Yes,0.8360655737704918
24041,24041,99.00,156,35,191,0.8167539267015707,0.18324607329842932,Yes,0.8167539267015707
24042,24042,99.00,0,0,0,0,0,n/a,0
24043,24043,99.00,106,22,128,0.828125,0.171875,Yes,0.828125
24044,24044,99.00,61,17,78,0.782051282051282,0.21794871794871795,Yes,0.782051282051282
24045,24045,99.00,169,36,205,0.824390243902439,0.17560975609756097,Yes,0.824390243902439
24046,24046,99.00,10,2,12,0.8333333333333334,0.16666666666666666,Yes,0.8333333333333334
24047,24047,99.00,0,0,0,0,0,n/a,0
24048,24048,99.00,1,0,1,1.0,0.0,Yes,1.0
24049,24049,99.00,238,83,321,0.7414330218068536,0.2585669781931464,Yes,0.7414330218068536
24050,24050,99.00,8,1,9,0.8888888888888888,0.1111111111111111,Yes,0.8888888888888888
24051,24051,99.00,69,37,106,0.6509433962264151,0.3490566037735849,Yes,0.6509433962264151
24052,24052,99.00,3,0,3,1.0,0.0,Yes,1.0
24053,24053,99.00,80,19,99,0.8080808080808081,0.1919191919191919,Yes,0.8080808080808081
24054,24054,99.00,67,16,83,0.8072289156626506,0.1927710843373494,Yes,0.8072289156626506
24055,24055,99.00,120,19,139,0.8633093525179856,0.1366906474820144,Yes,0.8633093525179856
24056,24056,99.00,0,0,0,0,0,n/a,0
24057,24057,99.00,0,0,0,0,0,n/a,0
24058,24058,99.00,94,19,113,0.831858407079646,0.168141592920354,Yes,0.831858407079646
24059,24059,99.00,101,44,145,0.696551724137931,0.30344827586206896,Yes,0.696551724137931
24060,24060,99.00,0,0,0,0,0,n/a,0
24061,24061,99.00,5,1,6,0.8333333333333334,0.16666666666666666,Yes,0.8333333333333334
24062,24062,99.00,0,0,0,0,0,n/a,0
24063,24063,99.00,2,0,2,1.0,0.0,Yes,1.0
24064,24064,99.00,99,17,116,0.853448275862069,0.14655172413793102,Yes,0.853448275862069
24065,24065,0.00,0,0,0,0,0,n/a,0
24066,24066,0.00,2,0,2,1.0,0.0,Yes,1.0
24067,24067,99.00,127,30,157,0.8089171974522293,0.1910828025477707,Yes,0.8089171974522293
24068,24068,99.00,87,25,112,0.7767857142857143,0.22321428571428573,Yes,0.7767857142857143
24069,24069,99.00,1,0,1,1.0,0.0,Yes,1.0
24070,24070,99.00,46,5,51,0.9019607843137255,0.09803921568627451,Yes,0.9019607843137255
24071,24071,99.00,70,8,78,0.8974358974358975,0.10256410256410256,Yes,0.8974358974358975
24072,24072,99.00,88,19,107,0.822429906542056,0.17757009345794392,Yes,0.822429906542056
24073,24073,99.00,53,13,66,0.803030303030303,0.19696969696969696,Yes,0.803030303030303
24074,24074,99.00,39,7,46,0.8478260869565217,0.15217391304347827,Yes,0.8478260869565217
24075,24075,99.00,96,17,113,0.8495575221238938,0.1504424778761062,Yes,0.8495575221238938
24076,24076,99.00,64,18,82,0.7804878048780488,0.21951219512195122,Yes,0.7804878048780488
24077,24077,99.00,54,17,71,0.7605633802816901,0.23943661971830985,Yes,0.7605633802816901
24078,24078,99.00,108,20,128,0.84375,0.15625,Yes,0.84375
24079,24079,99.00,67,12,79,0.8481012658227848,0.1518987341772152,Yes,0.8481012658227848
24080,24080,99.00,0,0,0,0,0,n/a,0
24081,24081,99.00,0,0,0,0,0,n/a,0
24082,24082,99.00,0,0,0,0,0,n/a,0
24083,24083,99.00,0,0,0,0,0,n/a,0
24084,24084,99.00,208,82,290,0.7172413793103448,0.2827586206896552,Yes,0.7172413793103448
24085,24085,99.00,122,30,152,0.8026315789473685,0.19736842105263158,Yes,0.8026315789473685
24086,24086,99.00,3,1,4,0.75,0.25,Yes,0.75
24087,24087,99.00,0,0,0,0,0,n/a,0
24088,24088,99.00,1,0,1,1.0,0.0,Yes,1.0
24089,24089,99.00,13,2,15,0.8666666666666667,0.13333333333333333,Yes,0.8666666666666667
24090,24090,99.00,0,0,0,0,0,n/a,0
24091,24091,99.00,102,38,140,0.7285714285714285,0.2714285714285714,Yes,0.7285714285714285
25001,25001,99.00,0,0,0,0,0,n/a,0
25002,25002,99.00,0,0,0,0,0,n/a,0
25003,25003,99.00,117,43,160,0.73125,0.26875,Yes,0.73125
25004,25004,99.00,99,22,121,0.8181818181818182,0.18181818181818182,Yes,0.8181818181818182
25005,25005,99.00,0,0,0,0,0,n/a,0
25006,25006,99.00,116,52,168,0.6904761904761905,0.30952380952380953,Yes,0.6904761904761905
25007,25007,99.00,141,91,232,0.6077586206896551,0.3922413793103448,Yes,0.6077586206896551
25008,25008,99.00,115,64,179,0.6424581005586593,0.3575418994413408,Yes,0.6424581005586593
25009,25009,99.00,0,0,0,0,0,n/a,0
25010,25010,99.00,0,0,0,0,0,n/a,0
25011,25011,99.00,4,3,7,0.5714285714285714,0.42857142857142855,Yes,0.5714285714285714
25012,25012,99.00,165,121,286,0.5769230769230769,0.4230769230769231,Yes,0.5769230769230769
25013,25013,99.00,97,29,126,0.7698412698412699,0.23015873015873015,Yes,0.7698412698412699
25014,25014,99.00,5,2,7,0.7142857142857143,0.2857142857142857,Yes,0.7142857142857143
25015,25015,99.00,3,0,3,1.0,0.0,Yes,1.0
25016,25016,99.00,198,51,249,0.7951807228915663,0.20481927710843373,Yes,0.7951807228915663
25017,25017,99.00,168,54,222,0.7567567567567568,0.24324324324324326,Yes,0.7567567567567568
25018,25018,99.00,11,1,12,0.9166666666666666,0.08333333333333333,Yes,0.9166666666666666
25019,25019,99.00,167,61,228,0.7324561403508771,0.2675438596491228,Yes,0.7324561403508771
25020,25020,99.00,109,25,134,0.8134328358208955,0.1865671641791045,Yes,0.8134328358208955
25021,25021,99.00,78,30,108,0.7222222222222222,0.2777777777777778,Yes,0.7222222222222222
25022,25022,99.00,164,63,227,0.7224669603524229,0.2775330396475771,Yes,0.7224669603524229
25023,25023,99.00,104,54,158,0.6582278481012658,0.34177215189873417,Yes,0.6582278481012658
25024,25024,99.00,95,28,123,0.7723577235772358,0.22764227642276422,Yes,0.7723577235772358
25025,25025,99.00,86,31,117,0.7350427350427351,0.26495726495726496,Yes,0.7350427350427351
25026,25026,99.00,0,0,0,0,0,n/a,0
25027,25027,99.00,197,109,306,0.6437908496732027,0.3562091503267974,Yes,0.6437908496732027
25028,25028,99.00,144,60,204,0.7058823529411765,0.29411764705882354,Yes,0.7058823529411765
25029,25029,99.00,16,7,23,0.6956521739130435,0.30434782608695654,Yes,0.6956521739130435
25030,25030,99.00,160,68,228,0.7017543859649122,0.2982456140350877,Yes,0.7017543859649122
25031,25031,99.00,8,5,13,0.6153846153846154,0.38461538461538464,Yes,0.6153846153846154
25032,25032,99.00,5,1,6,0.8333333333333334,0.16666666666666666,Yes,0.8333333333333334
25033,25033,99.00,133,49,182,0.7307692307692307,0.2692307692307692,Yes,0.7307692307692307
25034,25034,99.00,105,48,153,0.6862745098039216,0.3137254901960784,Yes,0.6862745098039216
25035,25035,99.00,5,2,7,0.7142857142857143,0.2857142857142857,Yes,0.7142857142857143
25036,25036,99.00,107,33,140,0.7642857142857142,0.2357142857142857,Yes,0.7642857142857142
25037,25037,99.00,125,43,168,0.7440476190476191,0.25595238095238093,Yes,0.7440476190476191
25038,25038,99.00,75,34,109,0.6880733944954128,0.3119266055045872,Yes,0.6880733944954128
25039,25039,99.00,184,53,237,0.7763713080168776,0.22362869198312235,Yes,0.7763713080168776
25040,25040,99.00,168,67,235,0.7148936170212766,0.2851063829787234,Yes,0.7148936170212766
25041,25041,99.00,3,0,3,1.0,0.0,Yes,1.0
25042,25042,99.00,2,2,4,0.5,0.5,Tie,0.5
25043,25043,99.00,126,45,171,0.7368421052631579,0.2631578947368421,Yes,0.7368421052631579
25044,25044,75.00,92,30,122,0.7540983606557377,0.2459016393442623,Yes,0.7540983606557377
25045,25045,75.00,62,14,76,0.8157894736842105,0.18421052631578946,Yes,0.8157894736842105
25046,25046,75.00,61,22,83,0.7349397590361446,0.26506024096385544,Yes,0.7349397590361446
25047,25047,99.00,54,12,66,0.8181818181818182,0.18181818181818182,Yes,0.8181818181818182
25048,25048,99.00,59,19,78,0.7564102564102564,0.24358974358974358,Yes,0.7564102564102564
25049,25049,99.00,105,30,135,0.7777777777777778,0.2222222222222222,Yes,0.7777777777777778
25050,25050,99.00,53,10,63,0.8412698412698413,0.15873015873015872,Yes,0.8412698412698413
25051,25051,99.00,50,25,75,0.6666666666666666,0.3333333333333333,Yes,0.6666666666666666
25052,25052,99.00,110,20,130,0.8461538461538461,0.15384615384615385,Yes,0.8461538461538461
25053,25053,99.00,106,17,123,0.8617886178861789,0.13821138211382114,Yes,0.8617886178861789
25054,25054,99.00,118,35,153,0.7712418300653595,0.22875816993464052,Yes,0.7712418300653595
25055,25055,99.00,0,0,0,0,0,n/a,0
25056,25056,99.00,3,1,4,0.75,0.25,Yes,0.75
25057,25057,99.00,137,36,173,0.791907514450867,0.20809248554913296,Yes,0.791907514450867
25058,25058,99.00,99,32,131,0.7557251908396947,0.24427480916030533,Yes,0.7557251908396947
25059,25059,99.00,89,34,123,0.7235772357723578,0.2764227642276423,Yes,0.7235772357723578
25060,25060,99.00,0,0,0,0,0,n/a,0
25061,25061,99.00,82,38,120,0.6833333333333333,0.31666666666666665,Yes,0.6833333333333333
25062,25062,99.00,152,54,206,0.7378640776699029,0.2621359223300971,Yes,0.7378640776699029
25063,25063,99.00,122,38,160,0.7625,0.2375,Yes,0.7625
25064,25064,99.00,8,2,10,0.8,0.2,Yes,0.8
25065,25065,99.00,15,0,15,1.0,0.0,Yes,1.0
25066,25066,99.00,1,0,1,1.0,0.0,Yes,1.0
25067,25067,99.00,0,0,0,0,0,n/a,0
25068,25068,99.00,3,2,5,0.6,0.4,Yes,0.6
25069,25069,99.00,2,1,3,0.6666666666666666,0.3333333333333333,Yes,0.6666666666666666
25070,25070,99.00,5,0,5,1.0,0.0,Yes,1.0
25071,25071,99.00,3,0,3,1.0,0.0,Yes,1.0
25072,25072,99.00,104,42,146,0.7123287671232876,0.2876712328767123,Yes,0.7123287671232876
25073,25073,99.00,5,1,6,0.8333333333333334,0.16666666666666666,Yes,0.8333333333333334
25074,25074,99.00,3,0,3,1.0,0.0,Yes,1.0
25075,25075,99.00,11,2,13,0.8461538461538461,0.15384615384615385,Yes,0.8461538461538461
25076,25076,99.00,3,2,5,0.6,0.4,Yes,0.6
25077,25077,99.00,1,4,5,0.2,0.8,No,0.8
25078,25078,99.00,8,3,11,0.7272727272727273,0.2727272727272727,Yes,0.7272727272727273
25079,25079,99.00,1,0,1,1.0,0.0,Yes,1.0
26001,26001,99.00,6,3,9,0.6666666666666666,0.3333333333333333,Yes,0.6666666666666666
26002,26002,99.00,3,1,4,0.75,0.25,Yes,0.75
26003,26003,99.00,209,81,290,0.7206896551724138,0.2793103448275862,Yes,0.7206896551724138
26004,26004,99.00,162,69,231,0.7012987012987013,0.2987012987012987,Yes,0.7012987012987013
26005,26005,99.00,2,0,2,1.0,0.0,Yes,1.0
26006,26006,99.00,165,96,261,0.632183908045977,0.367816091954023,Yes,0.632183908045977
26007,26007,99.00,8,1,9,0.8888888888888888,0.1111111111111111,Yes,0.8888888888888888
26008,26008,99.00,142,63,205,0.6926829268292682,0.3073170731707317,Yes,0.6926829268292682
26009,26009,99.00,155,72,227,0.6828193832599119,0.31718061674008813,Yes,0.6828193832599119
26010,26010,99.00,180,99,279,0.6451612903225806,0.3548387096774194,Yes,0.6451612903225806
26011,26011,99.00,245,127,372,0.6586021505376344,0.34139784946236557,Yes,0.6586021505376344
26012,26012,99.00,16,5,21,0.7619047619047619,0.23809523809523808,Yes,0.7619047619047619
26013,26013,99.00,109,51,160,0.68125,0.31875,Yes,0.68125
26014,26014,99.00,96,70,166,0.5783132530120482,0.42168674698795183,Yes,0.5783132530120482
26015,26015,99.00,144,75,219,0.6575342465753424,0.3424657534246575,Yes,0.6575342465753424
26016,26016,99.00,149,66,215,0.6930232558139535,0.30697674418604654,Yes,0.6930232558139535
26017,26017,99.00,107,75,182,0.5879120879120879,0.41208791208791207,Yes,0.5879120879120879
26018,26018,99.00,101,72,173,0.5838150289017341,0.4161849710982659,Yes,0.5838150289017341
26019,26019,99.00,180,111,291,0.6185567010309279,0.38144329896907214,Yes,0.6185567010309279
26020,26020,99.00,18,14,32,0.5625,0.4375,Yes,0.5625
26021,26021,99.00,189,71,260,0.7269230769230769,0.27307692307692305,Yes,0.7269230769230769
26022,26022,99.00,176,94,270,0.6518518518518519,0.34814814814814815,Yes,0.6518518518518519
26023,26023,99.00,220,90,310,0.7096774193548387,0.2903225806451613,Yes,0.7096774193548387
26024,26024,99.00,22,11,33,0.6666666666666666,0.3333333333333333,Yes,0.6666666666666666
26025,26025,99.00,13,5,18,0.7222222222222222,0.2777777777777778,Yes,0.7222222222222222
26026,26026,99.00,212,82,294,0.7210884353741497,0.2789115646258503,Yes,0.7210884353741497
26027,26027,99.00,21,5,26,0.8076923076923077,0.19230769230769232,Yes,0.8076923076923077
26028,26028,99.00,143,57,200,0.715,0.285,Yes,0.715
26029,26029,99.00,148,72,220,0.6727272727272727,0.32727272727272727,Yes,0.6727272727272727
26030,26030,99.00,174,71,245,0.710204081632653,0.2897959183673469,Yes,0.710204081632653
26031,26031,99.00,134,54,188,0.7127659574468085,0.2872340425531915,Yes,0.7127659574468085
26032,26032,99.00,107,47,154,0.6948051948051948,0.3051948051948052,Yes,0.6948051948051948
26033,26033,99.00,136,53,189,0.7195767195767195,0.2804232804232804,Yes,0.7195767195767195
26034,26034,99.00,143,65,208,0.6875,0.3125,Yes,0.6875
26035,26035,99.00,97,52,149,0.6510067114093959,0.348993288590604,Yes,0.6510067114093959
26036,26036,99.00,0,2,2,0.0,1.0,No,1.0
26037,26037,99.00,229,62,291,0.7869415807560137,0.21305841924398625,Yes,0.7869415807560137
26038,26038,99.00,3,0,3,1.0,0.0,Yes,1.0
26039,26039,99.00,149,76,225,0.6622222222222223,0.3377777777777778,Yes,0.6622222222222223
26040,26040,99.00,152,40,192,0.7916666666666666,0.20833333333333334,Yes,0.7916666666666666
26041,26041,99.00,0,0,0,0,0,n/a,0
26042,26042,99.00,9,0,9,1.0,0.0,Yes,1.0
26043,26043,99.00,3,0,3,1.0,0.0,Yes,1.0
26044,26044,99.00,3,1,4,0.75,0.25,Yes,0.75
26045,26045,99.00,131,54,185,0.7081081081081081,0.2918918918918919,Yes,0.7081081081081081
26046,26046,99.00,300,98,398,0.7537688442211056,0.24623115577889448,Yes,0.7537688442211056
26047,26047,99.00,13,5,18,0.7222222222222222,0.2777777777777778,Yes,0.7222222222222222
26048,26048,99.00,206,77,283,0.7279151943462897,0.27208480565371024,Yes,0.7279151943462897
26049,26049,99.00,5,6,11,0.45454545454545453,0.5454545454545454,No,0.5454545454545454
26050,26050,99.00,20,7,27,0.7407407407407407,0.25925925925925924,Yes,0.7407407407407407
26051,26051,99.00,2,4,6,0.3333333333333333,0.6666666666666666,No,0.6666666666666666
26052,26052,99.00,176,58,234,0.7521367521367521,0.24786324786324787,Yes,0.7521367521367521
26053,26053,99.00,190,56,246,0.7723577235772358,0.22764227642276422,Yes,0.7723577235772358
26054,26054,99.00,163,46,209,0.7799043062200957,0.22009569377990432,Yes,0.7799043062200957
26055,26055,99.00,119,31,150,0.7933333333333333,0.20666666666666667,Yes,0.7933333333333333
26056,26056,99.00,6,1,7,0.8571428571428571,0.14285714285714285,Yes,0.8571428571428571
26057,26057,99.00,12,1,13,0.9230769230769231,0.07692307692307693,Yes,0.9230769230769231
26058,26058,75.00,182,66,248,0.7338709677419355,0.2661290322580645,Yes,0.7338709677419355
26059,26059,99.00,9,2,11,0.8181818181818182,0.18181818181818182,Yes,0.8181818181818182
26060,26060,99.00,246,123,369,0.6666666666666666,0.3333333333333333,Yes,0.6666666666666666
26061,26061,75.00,92,43,135,0.6814814814814815,0.31851851851851853,Yes,0.6814814814814815
26062,26062,75.00,86,26,112,0.7678571428571429,0.23214285714285715,Yes,0.7678571428571429
26063,26063,75.00,100,46,146,0.684931506849315,0.3150684931506849,Yes,0.684931506849315
26064,26064,75.00,12,6,18,0.6666666666666666,0.3333333333333333,Yes,0.6666666666666666
26065,26065,99.00,6,7,13,0.46153846153846156,0.5384615384615384,No,0.5384615384615384
26066,26066,99.00,188,98,286,0.6573426573426573,0.34265734265734266,Yes,0.6573426573426573
26067,26067,99.00,194,102,296,0.6554054054054054,0.34459459459459457,Yes,0.6554054054054054
26068,26068,99.00,192,102,294,0.6530612244897959,0.3469387755102041,Yes,0.6530612244897959
26069,26069,99.00,9,3,12,0.75,0.25,Yes,0.75
26070,26070,99.00,215,96,311,0.6913183279742765,0.3086816720257235,Yes,0.6913183279742765
26071,26071,99.00,100,87,187,0.5347593582887701,0.46524064171123,Yes,0.5347593582887701
26072,26072,99.00,15,8,23,0.6521739130434783,0.34782608695652173,Yes,0.6521739130434783
26073,26073,99.00,223,129,352,0.6335227272727273,0.3664772727272727,Yes,0.6335227272727273
26074,26074,99.00,50,16,66,0.7575757575757576,0.24242424242424243,Yes,0.7575757575757576
26075,26075,99.00,169,62,231,0.7316017316017316,0.2683982683982684,Yes,0.7316017316017316
26076,26076,99.00,14,0,14,1.0,0.0,Yes,1.0
26077,26077,99.00,0,0,0,0,0,n/a,0
26078,26078,99.00,0,0,0,0,0,n/a,0
26079,26079,99.00,5,1,6,0.8333333333333334,0.16666666666666666,Yes,0.8333333333333334
26080,26080,99.00,9,2,11,0.8181818181818182,0.18181818181818182,Yes,0.8181818181818182
26081,26081,99.00,8,1,9,0.8888888888888888,0.1111111111111111,Yes,0.8888888888888888
26082,26082,99.00,4,1,5,0.8,0.2,Yes,0.8
26083,26083,99.00,117,62,179,0.6536312849162011,0.3463687150837989,Yes,0.6536312849162011
26084,26084,99.00,5,2,7,0.7142857142857143,0.2857142857142857,Yes,0.7142857142857143
26085,26085,99.00,5,1,6,0.8333333333333334,0.16666666666666666,Yes,0.8333333333333334
27001,27001,99.00,104,206,310,0.33548387096774196,0.6645161290322581,No,0.6645161290322581
27002,27002,0.00,2,0,2,1.0,0.0,Yes,1.0
27003,27003,99.00,183,45,228,0.8026315789473685,0.19736842105263158,Yes,0.8026315789473685
27004,27004,99.00,5,4,9,0.5555555555555556,0.4444444444444444,Yes,0.5555555555555556
27005,27005,0.00,15,1,16,0.9375,0.0625,Yes,0.9375
27006,27006,99.00,303,110,413,0.7336561743341404,0.26634382566585957,Yes,0.7336561743341404
27007,27007,99.00,231,68,299,0.7725752508361204,0.22742474916387959,Yes,0.7725752508361204
27008,27008,99.00,246,60,306,0.803921568627451,0.19607843137254902,Yes,0.803921568627451
27009,27009,99.00,76,18,94,0.8085106382978723,0.19148936170212766,Yes,0.8085106382978723
27010,27010,99.00,0,0,0,0,0,n/a,0
27011,27011,99.00,6,1,7,0.8571428571428571,0.14285714285714285,Yes,0.8571428571428571
27012,27012,99.00,103,21,124,0.8306451612903226,0.1693548387096774,Yes,0.8306451612903226
27013,27013,99.00,273,42,315,0.8666666666666667,0.13333333333333333,Yes,0.8666666666666667
27014,27014,99.00,199,45,244,0.8155737704918032,0.18442622950819673,Yes,0.8155737704918032
27015,27015,99.00,14,2,16,0.875,0.125,Yes,0.875
27016,27016,99.00,30,7,37,0.8108108108108109,0.1891891891891892,Yes,0.8108108108108109
27017,27017,99.00,5,0,5,1.0,0.0,Yes,1.0
27018,27018,99.00,1,0,1,1.0,0.0,Yes,1.0
27019,27019,99.00,8,8,16,0.5,0.5,Tie,0.5
27020,27020,99.00,224,84,308,0.7272727272727273,0.2727272727272727,Yes,0.7272727272727273
27021,27021,99.00,211,56,267,0.7902621722846442,0.20973782771535582,Yes,0.7902621722846442
27022,27022,99.00,17,6,23,0.7391304347826086,0.2608695652173913,Yes,0.7391304347826086
27023,27023,99.00,117,99,216,0.5416666666666666,0.4583333333333333,Yes,0.5416666666666666
27024,27024,99.00,9,6,15,0.6,0.4,Yes,0.6
27025,27025,99.00,101,311,412,0.24514563106796117,0.7548543689320388,No,0.7548543689320388
27026,27026,99.00,106,163,269,0.3940520446096654,0.6059479553903345,No,0.6059479553903345
27027,27027,99.00,110,171,281,0.3914590747330961,0.608540925266904,No,0.608540925266904
27028,27028,99.00,143,110,253,0.5652173913043478,0.43478260869565216,Yes,0.5652173913043478
27029,27029,99.00,0,0,0,0,0,n/a,0
27030,27030,99.00,108,122,230,0.46956521739130436,0.5304347826086957,No,0.5304347826086957
27031,27031,99.00,103,24,127,0.8110236220472441,0.1889763779527559,Yes,0.8110236220472441
27032,27032,99.00,0,0,0,0,0,n/a,0
27033,27033,99.00,1,0,1,1.0,0.0,Yes,1.0
27034,27034,99.00,3,1,4,0.75,0.25,Yes,0.75
27035,27035,99.00,104,14,118,0.8813559322033898,0.11864406779661017,Yes,0.8813559322033898
27036,27036,99.00,0,0,0,0,0,n/a,0
27037,27037,99.00,140,46,186,0.7526881720430108,0.24731182795698925,Yes,0.7526881720430108
27038,27038,99.00,138,47,185,0.745945945945946,0.25405405405405407,Yes,0.745945945945946
27039,27039,99.00,190,51,241,0.7883817427385892,0.21161825726141079,Yes,0.7883817427385892
27040,27040,99.00,2,1,3,0.6666666666666666,0.3333333333333333,Yes,0.6666666666666666
27041,27041,99.00,99,24,123,0.8048780487804879,0.1951219512195122,Yes,0.8048780487804879
27042,27042,99.00,175,73,248,0.7056451612903226,0.29435483870967744,Yes,0.7056451612903226
27043,27043,99.00,5,0,5,1.0,0.0,Yes,1.0
27044,27044,99.00,4,2,6,0.6666666666666666,0.3333333333333333,Yes,0.6666666666666666
27045,27045,99.00,118,32,150,0.7866666666666666,0.21333333333333335,Yes,0.7866666666666666
27046,27046,99.00,89,34,123,0.7235772357723578,0.2764227642276423,Yes,0.7235772357723578
27047,27047,99.00,104,31,135,0.7703703703703704,0.22962962962962963,Yes,0.7703703703703704
27048,27048,99.00,2,0,2,1.0,0.0,Yes,1.0
27049,27049,99.00,5,1,6,0.8333333333333334,0.16666666666666666,Yes,0.8333333333333334
27050,27050,99.00,192,50,242,0.7933884297520661,0.2066115702479339,Yes,0.7933884297520661
27051,27051,99.00,104,78,182,0.5714285714285714,0.42857142857142855,Yes,0.5714285714285714
27052,27052,99.00,148,48,196,0.7551020408163265,0.24489795918367346,Yes,0.7551020408163265
27053,27053,99.00,108,45,153,0.7058823529411765,0.29411764705882354,Yes,0.7058823529411765
27054,27054,99.00,105,32,137,0.7664233576642335,0.23357664233576642,Yes,0.7664233576642335
27055,27055,99.00,77,30,107,0.719626168224299,0.2803738317757009,Yes,0.719626168224299
27056,27056,99.00,2,0,2,1.0,0.0,Yes,1.0
27057,27057,99.00,0,2,2,0.0,1.0,No,1.0
27058,27058,99.00,0,0,0,0,0,n/a,0
27059,27059,99.00,60,40,100,0.6,0.4,Yes,0.6
27060,27060,99.00,2,0,2,1.0,0.0,Yes,1.0
27061,27061,99.00,120,39,159,0.7547169811320755,0.24528301886792453,Yes,0.7547169811320755
27062,27062,99.00,54,27,81,0.6666666666666666,0.3333333333333333,Yes,0.6666666666666666
27063,27063,99.00,58,20,78,0.7435897435897436,0.2564102564102564,Yes,0.7435897435897436
27064,27064,99.00,71,20,91,0.7802197802197802,0.21978021978021978,Yes,0.7802197802197802
27065,27065,99.00,95,32,127,0.7480314960629921,0.25196850393700787,Yes,0.7480314960629921
27066,27066,99.00,134,47,181,0.7403314917127072,0.2596685082872928,Yes,0.7403314917127072
27067,27067,99.00,138,71,209,0.6602870813397129,0.3397129186602871,Yes,0.6602870813397129
27068,27068,99.00,87,41,128,0.6796875,0.3203125,Yes,0.6796875
27069,27069,99.00,0,0,0,0,0,n/a,0
27070,27070,99.00,0,0,0,0,0,n/a,0
27071,27071,99.00,0,0,0,0,0,n/a,0
27072,27072,99.00,0,0,0,0,0,n/a,0
27073,27073,99.00,0,0,0,0,0,n/a,0
27074,27074,99.00,0,0,0,0,0,n/a,0
27075,27075,99.00,0,0,0,0,0,n/a,0
27076,27076,99.00,0,0,0,0,0,n/a,0
27077,27077,99.00,0,0,0,0,0,n/a,0
27078,27078,99.00,0,0,0,0,0,n/a,0
27079,27079,99.00,120,57,177,0.6779661016949152,0.3220338983050847,Yes,0.6779661016949152
27080,27080,99.00,4,1,5,0.8,0.2,Yes,0.8
27081,27081,99.00,98,34,132,0.7424242424242424,0.25757575757575757,Yes,0.7424242424242424
27082,27082,0.00,2,0,2,1.0,0.0,Yes,1.0
27083,27083,0.00,14,2,16,0.875,0.125,Yes,0.875
27084,27084,99.00,3,0,3,1.0,0.0,Yes,1.0
27085,27085,99.00,0,2,2,0.0,1.0,No,1.0
27086,27086,99.00,131,33,164,0.7987804878048781,0.20121951219512196,Yes,0.7987804878048781
27087,27087,99.00,0,2,2,0.0,1.0,No,1.0
27088,27088,99.00,7,4,11,0.6363636363636364,0.36363636363636365,Yes,0.6363636363636364
27089,27089,99.00,2,3,5,0.4,0.6,No,0.6
28001,28001,99.00,149,48,197,0.7563451776649747,0.2436548223350254,Yes,0.7563451776649747
28002,28002,99.00,3,0,3,1.0,0.0,Yes,1.0
28003,28003,99.00,183,77,260,0.7038461538461539,0.29615384615384616,Yes,0.7038461538461539
28004,28004,99.00,129,74,203,0.6354679802955665,0.3645320197044335,Yes,0.6354679802955665
28005,28005,99.00,2,1,3,0.6666666666666666,0.3333333333333333,Yes,0.6666666666666666
28006,28006,99.00,143,39,182,0.7857142857142857,0.21428571428571427,Yes,0.7857142857142857
28007,28007,99.00,6,1,7,0.8571428571428571,0.14285714285714285,Yes,0.8571428571428571
28008,28008,99.00,3,0,3,1.0,0.0,Yes,1.0
28009,28009,99.00,11,1,12,0.9166666666666666,0.08333333333333333,Yes,0.9166666666666666
28010,28010,99.00,174,62,236,0.7372881355932204,0.2627118644067797,Yes,0.7372881355932204
28011,28011,99.00,10,2,12,0.8333333333333334,0.16666666666666666,Yes,0.8333333333333334
28012,28012,99.00,23,9,32,0.71875,0.28125,Yes,0.71875
28013,28013,99.00,3,0,3,1.0,0.0,Yes,1.0
28014,28014,99.00,99,34,133,0.7443609022556391,0.2556390977443609,Yes,0.7443609022556391
28015,28015,99.00,135,70,205,0.6585365853658537,0.34146341463414637,Yes,0.6585365853658537
28016,28016,99.00,123,81,204,0.6029411764705882,0.39705882352941174,Yes,0.6029411764705882
28017,28017,99.00,196,103,299,0.6555183946488294,0.34448160535117056,Yes,0.6555183946488294
28018,28018,99.00,125,46,171,0.7309941520467836,0.26900584795321636,Yes,0.7309941520467836
28019,28019,99.00,267,91,358,0.7458100558659218,0.2541899441340782,Yes,0.7458100558659218
28020,28020,99.00,28,7,35,0.8,0.2,Yes,0.8
28021,28021,99.00,2,0,2,1.0,0.0,Yes,1.0
28022,28022,99.00,301,128,429,0.7016317016317016,0.29836829836829837,Yes,0.7016317016317016
28023,28023,99.00,315,118,433,0.7274826789838337,0.27251732101616627,Yes,0.7274826789838337
28024,28024,99.00,16,6,22,0.7272727272727273,0.2727272727272727,Yes,0.7272727272727273
28025,28025,99.00,187,62,249,0.751004016064257,0.24899598393574296,Yes,0.751004016064257
28026,28026,99.00,190,46,236,0.8050847457627118,0.19491525423728814,Yes,0.8050847457627118
28027,28027,99.00,7,4,11,0.6363636363636364,0.36363636363636365,Yes,0.6363636363636364
28028,28028,99.00,263,110,373,0.7050938337801609,0.2949061662198391,Yes,0.7050938337801609
28029,28029,50.00,112,26,138,0.8115942028985508,0.18840579710144928,Yes,0.8115942028985508
28030,28030,50.00,124,43,167,0.7425149700598802,0.25748502994011974,Yes,0.7425149700598802
28031,28031,99.00,211,72,283,0.7455830388692579,0.254416961130742,Yes,0.7455830388692579
28032,28032,50.00,3,3,6,0.5,0.5,Tie,0.5
28033,28033,99.00,0,0,0,0,0,n/a,0
28034,28034,99.00,1,3,4,0.25,0.75,No,0.75
28035,28035,99.00,223,75,298,0.7483221476510067,0.2516778523489933,Yes,0.7483221476510067
28036,28036,99.00,242,67,309,0.7831715210355987,0.2168284789644013,Yes,0.7831715210355987
28037,28037,99.00,8,1,9,0.8888888888888888,0.1111111111111111,Yes,0.8888888888888888
28038,28038,99.00,254,83,337,0.7537091988130564,0.24629080118694363,Yes,0.7537091988130564
28039,28039,99.00,13,4,17,0.7647058823529411,0.23529411764705882,Yes,0.7647058823529411
28040,28040,99.00,118,30,148,0.7972972972972973,0.20270270270270271,Yes,0.7972972972972973
28041,28041,99.00,223,71,294,0.7585034013605442,0.24149659863945577,Yes,0.7585034013605442
28042,28042,99.00,225,65,290,0.7758620689655172,0.22413793103448276,Yes,0.7758620689655172
28043,28043,99.00,158,62,220,0.7181818181818181,0.2818181818181818,Yes,0.7181818181818181
28044,28044,99.00,8,0,8,1.0,0.0,Yes,1.0
28045,28045,99.00,3,3,6,0.5,0.5,Tie,0.5
28046,28046,99.00,111,24,135,0.8222222222222222,0.17777777777777778,Yes,0.8222222222222222
28047,28047,99.00,207,77,284,0.7288732394366197,0.2711267605633803,Yes,0.7288732394366197
28048,28048,99.00,250,92,342,0.7309941520467836,0.26900584795321636,Yes,0.7309941520467836
28049,28049,99.00,5,4,9,0.5555555555555556,0.4444444444444444,Yes,0.5555555555555556
28050,28050,99.00,176,52,228,0.7719298245614035,0.22807017543859648,Yes,0.7719298245614035
28051,28051,99.00,165,51,216,0.7638888888888888,0.2361111111111111,Yes,0.7638888888888888
28052,28052,99.00,0,0,0,0,0,n/a,0
28053,28053,99.00,4,2,6,0.6666666666666666,0.3333333333333333,Yes,0.6666666666666666
28054,28054,99.00,123,39,162,0.7592592592592593,0.24074074074074073,Yes,0.7592592592592593
28055,28055,99.00,0,2,2,0.0,1.0,No,1.0
28056,28056,99.00,153,24,177,0.864406779661017,0.13559322033898305,Yes,0.864406779661017
28057,28057,99.00,1,0,1,1.0,0.0,Yes,1.0
28058,28058,99.00,2,3,5,0.4,0.6,No,0.6
28059,28059,99.00,2,0,2,1.0,0.0,Yes,1.0
28060,28060,99.00,4,0,4,1.0,0.0,Yes,1.0
28061,28061,99.00,178,56,234,0.7606837606837606,0.23931623931623933,Yes,0.7606837606837606
28062,28062,99.00,177,57,234,0.7564102564102564,0.24358974358974358,Yes,0.7564102564102564
28063,28063,99.00,6,1,7,0.8571428571428571,0.14285714285714285,Yes,0.8571428571428571
28064,28064,99.00,147,66,213,0.6901408450704225,0.30985915492957744,Yes,0.6901408450704225
28065,28065,99.00,126,46,172,0.7325581395348837,0.26744186046511625,Yes,0.7325581395348837
28066,28066,99.00,160,65,225,0.7111111111111111,0.28888888888888886,Yes,0.7111111111111111
28067,28067,99.00,155,70,225,0.6888888888888889,0.3111111111111111,Yes,0.6888888888888889
28068,28068,99.00,157,75,232,0.6767241379310345,0.3232758620689655,Yes,0.6767241379310345
28069,28069,99.00,158,63,221,0.7149321266968326,0.2850678733031674,Yes,0.7149321266968326
28070,28070,99.00,188,109,297,0.632996632996633,0.367003367003367,Yes,0.632996632996633
28071,28071,99.00,116,67,183,0.6338797814207651,0.366120218579235,Yes,0.6338797814207651
28072,28072,99.00,107,62,169,0.6331360946745562,0.3668639053254438,Yes,0.6331360946745562
28073,28073,99.00,94,49,143,0.6573426573426573,0.34265734265734266,Yes,0.6573426573426573
28074,28074,99.00,4,2,6,0.6666666666666666,0.3333333333333333,Yes,0.6666666666666666
28075,28075,99.00,215,145,360,0.5972222222222222,0.4027777777777778,Yes,0.5972222222222222
28076,28076,99.00,129,92,221,0.583710407239819,0.416289592760181,Yes,0.583710407239819
28077,28077,99.00,111,65,176,0.6306818181818182,0.3693181818181818,Yes,0.6306818181818182
28078,28078,99.00,72,19,91,0.7912087912087912,0.2087912087912088,Yes,0.7912087912087912
28079,28079,99.00,0,0,0,0,0,n/a,0
28080,28080,99.00,7,1,8,0.875,0.125,Yes,0.875
28081,28081,99.00,9,5,14,0.6428571428571429,0.35714285714285715,Yes,0.6428571428571429
28082,28082,99.00,4,1,5,0.8,0.2,Yes,0.8
28083,28083,99.00,122,41,163,0.7484662576687117,0.25153374233128833,Yes,0.7484662576687117
28084,28084,99.00,8,2,10,0.8,0.2,Yes,0.8
28085,28085,99.00,0,0,0,0,0,n/a,0
28086,28086,99.00,4,0,4,1.0,0.0,Yes,1.0
28087,28087,99.00,10,1,11,0.9090909090909091,0.09090909090909091,Yes,0.9090909090909091
28088,28088,99.00,2,0,2,1.0,0.0,Yes,1.0
28089,28089,99.00,2,0,2,1.0,0.0,Yes,1.0
29001,29001,99.00,8,2,10,0.8,0.2,Yes,0.8
29002,29002,99.00,116,19,135,0.8592592592592593,0.14074074074074075,Yes,0.8592592592592593
29003,29003,99.00,121,51,172,0.7034883720930233,0.29651162790697677,Yes,0.7034883720930233
29004,29004,99.00,80,32,112,0.7142857142857143,0.2857142857142857,Yes,0.7142857142857143
29005,29005,99.00,1,1,2,0.5,0.5,Tie,0.5
29006,29006,99.00,2,1,3,0.6666666666666666,0.3333333333333333,Yes,0.6666666666666666
29007,29007,99.00,0,1,1,0.0,1.0,No,1.0
29008,29008,99.00,3,0,3,1.0,0.0,Yes,1.0
29009,29009,99.00,73,14,87,0.8390804597701149,0.16091954022988506,Yes,0.8390804597701149
29010,29010,99.00,39,12,51,0.7647058823529411,0.23529411764705882,Yes,0.7647058823529411
29011,29011,99.00,65,13,78,0.8333333333333334,0.16666666666666666,Yes,0.8333333333333334
29012,29012,99.00,76,23,99,0.7676767676767676,0.23232323232323232,Yes,0.7676767676767676
29013,29013,99.00,135,33,168,0.8035714285714286,0.19642857142857142,Yes,0.8035714285714286
29014,29014,99.00,1,0,1,1.0,0.0,Yes,1.0
29015,29015,99.00,66,8,74,0.8918918918918919,0.10810810810810811,Yes,0.8918918918918919
29016,29016,99.00,58,12,70,0.8285714285714286,0.17142857142857143,Yes,0.8285714285714286
29017,29017,99.00,118,23,141,0.8368794326241135,0.16312056737588654,Yes,0.8368794326241135
29018,29018,99.00,153,24,177,0.864406779661017,0.13559322033898305,Yes,0.864406779661017
29019,29019,99.00,8,0,8,1.0,0.0,Yes,1.0
29020,29020,99.00,5,2,7,0.7142857142857143,0.2857142857142857,Yes,0.7142857142857143
29021,29021,99.00,2,0,2,1.0,0.0,Yes,1.0
29022,29022,99.00,10,0,10,1.0,0.0,Yes,1.0
29023,29023,80.00,160,26,186,0.8602150537634409,0.13978494623655913,Yes,0.8602150537634409
29024,29024,80.00,197,36,233,0.8454935622317596,0.15450643776824036,Yes,0.8454935622317596
29025,29025,80.00,176,29,205,0.8585365853658536,0.14146341463414633,Yes,0.8585365853658536
29026,29026,80.00,176,34,210,0.8380952380952381,0.1619047619047619,Yes,0.8380952380952381
29027,29027,0.00,8,0,8,1.0,0.0,Yes,1.0
29028,29028,0.00,13,0,13,1.0,0.0,Yes,1.0
29029,29029,99.00,132,20,152,0.868421052631579,0.13157894736842105,Yes,0.868421052631579
29030,29030,99.00,160,23,183,0.8743169398907104,0.12568306010928962,Yes,0.8743169398907104
29031,29031,99.00,147,31,178,0.8258426966292135,0.17415730337078653,Yes,0.8258426966292135
29032,29032,99.00,140,24,164,0.8536585365853658,0.14634146341463414,Yes,0.8536585365853658
29033,29033,0.00,20,0,20,1.0,0.0,Yes,1.0
29034,29034,0.00,8,2,10,0.8,0.2,Yes,0.8
29035,29035,99.00,107,24,131,0.816793893129771,0.183206106870229,Yes,0.816793893129771
29036,29036,99.00,102,14,116,0.8793103448275862,0.1206896551724138,Yes,0.8793103448275862
29037,29037,99.00,7,0,7,1.0,0.0,Yes,1.0
29038,29038,99.00,138,17,155,0.8903225806451613,0.10967741935483871,Yes,0.8903225806451613
29039,29039,99.00,2,0,2,1.0,0.0,Yes,1.0
29040,29040,99.00,7,1,8,0.875,0.125,Yes,0.875
29041,29041,99.00,10,5,15,0.6666666666666666,0.3333333333333333,Yes,0.6666666666666666
29042,29042,99.00,169,35,204,0.8284313725490197,0.1715686274509804,Yes,0.8284313725490197
29043,29043,99.00,4,1,5,0.8,0.2,Yes,0.8
29044,29044,99.00,177,31,208,0.8509615384615384,0.14903846153846154,Yes,0.8509615384615384
29045,29045,99.00,237,28,265,0.8943396226415095,0.10566037735849057,Yes,0.8943396226415095
29046,29046,99.00,82,14,96,0.8541666666666666,0.14583333333333334,Yes,0.8541666666666666
29047,29047,99.00,173,27,200,0.865,0.135,Yes,0.865
29048,29048,99.00,7,0,7,1.0,0.0,Yes,1.0
29049,29049,99.00,163,31,194,0.8402061855670103,0.15979381443298968,Yes,0.8402061855670103
29050,29050,99.00,118,22,140,0.8428571428571429,0.15714285714285714,Yes,0.8428571428571429
29051,29051,99.00,260,44,304,0.8552631578947368,0.14473684210526316,Yes,0.8552631578947368
29052,29052,99.00,212,29,241,0.8796680497925311,0.12033195020746888,Yes,0.8796680497925311
29053,29053,99.00,6,0,6,1.0,0.0,Yes,1.0
29054,29054,99.00,180,37,217,0.8294930875576036,0.17050691244239632,Yes,0.8294930875576036
29055,29055,99.00,146,26,172,0.8488372093023255,0.1511627906976744,Yes,0.8488372093023255
29056,29056,99.00,96,17,113,0.8495575221238938,0.1504424778761062,Yes,0.8495575221238938
29057,29057,99.00,132,26,158,0.8354430379746836,0.16455696202531644,Yes,0.8354430379746836
29058,29058,99.00,134,22,156,0.8589743589743589,0.14102564102564102,Yes,0.8589743589743589
29059,29059,99.00,165,38,203,0.812807881773399,0.18719211822660098,Yes,0.812807881773399
29060,29060,99.00,189,27,216,0.875,0.125,Yes,0.875
29061,29061,99.00,175,28,203,0.8620689655172413,0.13793103448275862,Yes,0.8620689655172413
29062,29062,99.00,188,22,210,0.8952380952380953,0.10476190476190476,Yes,0.8952380952380953
29063,29063,99.00,173,25,198,0.8737373737373737,0.12626262626262627,Yes,0.8737373737373737
29064,29064,99.00,130,20,150,0.8666666666666667,0.13333333333333333,Yes,0.8666666666666667
29065,29065,99.00,142,16,158,0.8987341772151899,0.10126582278481013,Yes,0.8987341772151899
29066,29066,99.00,120,26,146,0.821917808219178,0.1780821917808219,Yes,0.821917808219178
29067,29067,99.00,119,25,144,0.8263888888888888,0.1736111111111111,Yes,0.8263888888888888
29068,29068,99.00,109,19,128,0.8515625,0.1484375,Yes,0.8515625
29069,29069,99.00,3,1,4,0.75,0.25,Yes,0.75
29070,29070,99.00,7,0,7,1.0,0.0,Yes,1.0
29071,29071,99.00,4,1,5,0.8,0.2,Yes,0.8
29072,29072,99.00,55,13,68,0.8088235294117647,0.19117647058823528,Yes,0.8088235294117647
29073,29073,99.00,2,0,2,1.0,0.0,Yes,1.0
29074,29074,99.00,7,1,8,0.875,0.125,Yes,0.875
29075,29075,0.00,4,1,5,0.8,0.2,Yes,0.8
29076,29076,99.00,102,30,132,0.7727272727272727,0.22727272727272727,Yes,0.7727272727272727
29077,29077,99.00,1,0,1,1.0,0.0,Yes,1.0
29078,29078,99.00,3,1,4,0.75,0.25,Yes,0.75
29079,29079,99.00,124,30,154,0.8051948051948052,0.19480519480519481,Yes,0.8051948051948052
29080,29080,99.00,5,2,7,0.7142857142857143,0.2857142857142857,Yes,0.7142857142857143
30001,30001,99.00,7,0,7,1.0,0.0,Yes,1.0
30002,30002,99.00,50,23,73,0.684931506849315,0.3150684931506849,Yes,0.684931506849315
30003,30003,99.00,1,0,1,1.0,0.0,Yes,1.0
30004,30004,99.00,111,64,175,0.6342857142857142,0.3657142857142857,Yes,0.6342857142857142
30005,30005,99.00,160,70,230,0.6956521739130435,0.30434782608695654,Yes,0.6956521739130435
30006,30006,99.00,140,76,216,0.6481481481481481,0.35185185185185186,Yes,0.6481481481481481
30007,30007,99.00,128,75,203,0.6305418719211823,0.3694581280788177,Yes,0.6305418719211823
30008,30008,99.00,157,77,234,0.6709401709401709,0.32905982905982906,Yes,0.6709401709401709
30009,30009,99.00,145,60,205,0.7073170731707317,0.2926829268292683,Yes,0.7073170731707317
30010,30010,99.00,161,67,228,0.706140350877193,0.29385964912280704,Yes,0.706140350877193
30011,30011,99.00,146,80,226,0.6460176991150443,0.35398230088495575,Yes,0.6460176991150443
30012,30012,99.00,111,64,175,0.6342857142857142,0.3657142857142857,Yes,0.6342857142857142
30013,30013,99.00,97,48,145,0.6689655172413793,0.3310344827586207,Yes,0.6689655172413793
30014,30014,99.00,105,59,164,0.6402439024390244,0.3597560975609756,Yes,0.6402439024390244
30015,30015,99.00,106,80,186,0.5698924731182796,0.43010752688172044,Yes,0.5698924731182796
30016,30016,99.00,75,35,110,0.6818181818181818,0.3181818181818182,Yes,0.6818181818181818
30017,30017,99.00,123,62,185,0.6648648648648648,0.33513513513513515,Yes,0.6648648648648648
30018,30018,99.00,130,64,194,0.6701030927835051,0.32989690721649484,Yes,0.6701030927835051
30019,30019,99.00,59,24,83,0.7108433734939759,0.2891566265060241,Yes,0.7108433734939759
30020,30020,99.00,9,2,11,0.8181818181818182,0.18181818181818182,Yes,0.8181818181818182
30021,30021,99.00,154,75,229,0.6724890829694323,0.32751091703056767,Yes,0.6724890829694323
30022,30022,99.00,1,1,2,0.5,0.5,Tie,0.5
30023,30023,99.00,176,91,267,0.6591760299625468,0.3408239700374532,Yes,0.6591760299625468
30024,30024,99.00,179,65,244,0.7336065573770492,0.26639344262295084,Yes,0.7336065573770492
30025,30025,99.00,139,57,196,0.7091836734693877,0.29081632653061223,Yes,0.7091836734693877
30026,30026,99.00,68,55,123,0.5528455284552846,0.44715447154471544,Yes,0.5528455284552846
30027,30027,99.00,182,70,252,0.7222222222222222,0.2777777777777778,Yes,0.7222222222222222
30028,30028,99.00,0,0,0,0,0,n/a,0
30029,30029,99.00,0,0,0,0,0,n/a,0
30030,30030,99.00,150,54,204,0.7352941176470589,0.2647058823529412,Yes,0.7352941176470589
30031,30031,99.00,3,2,5,0.6,0.4,Yes,0.6
30032,30032,99.00,0,1,1,0.0,1.0,No,1.0
30033,30033,99.00,4,0,4,1.0,0.0,Yes,1.0
30034,30034,99.00,0,0,0,0,0,n/a,0
30035,30035,99.00,0,0,0,0,0,n/a,0
30036,30036,99.00,2,0,2,1.0,0.0,Yes,1.0
30037,30037,99.00,5,1,6,0.8333333333333334,0.16666666666666666,Yes,0.8333333333333334
30038,30038,99.00,247,52,299,0.8260869565217391,0.17391304347826086,Yes,0.8260869565217391
30039,30039,99.00,136,72,208,0.6538461538461539,0.34615384615384615,Yes,0.6538461538461539
30040,30040,99.00,145,70,215,0.6744186046511628,0.32558139534883723,Yes,0.6744186046511628
30041,30041,99.00,116,28,144,0.8055555555555556,0.19444444444444445,Yes,0.8055555555555556
30042,30042,99.00,5,0,5,1.0,0.0,Yes,1.0
30043,30043,99.00,3,1,4,0.75,0.25,Yes,0.75
30044,30044,99.00,200,44,244,0.819672131147541,0.18032786885245902,Yes,0.819672131147541
30045,30045,99.00,74,25,99,0.7474747474747475,0.25252525252525254,Yes,0.7474747474747475
30046,30046,99.00,146,42,188,0.776595744680851,0.22340425531914893,Yes,0.776595744680851
30047,30047,99.00,134,26,160,0.8375,0.1625,Yes,0.8375
30048,30048,99.00,222,81,303,0.7326732673267327,0.26732673267326734,Yes,0.7326732673267327
30049,30049,99.00,175,46,221,0.7918552036199095,0.2081447963800905,Yes,0.7918552036199095
30050,30050,80.00,208,64,272,0.7647058823529411,0.23529411764705882,Yes,0.7647058823529411
30051,30051,99.00,126,35,161,0.782608695652174,0.21739130434782608,Yes,0.782608695652174
30052,30052,99.00,83,21,104,0.7980769230769231,0.20192307692307693,Yes,0.7980769230769231
30053,30053,99.00,2,1,3,0.6666666666666666,0.3333333333333333,Yes,0.6666666666666666
30054,30054,99.00,0,0,0,0,0,n/a,0
30055,30055,99.00,132,35,167,0.7904191616766467,0.20958083832335328,Yes,0.7904191616766467
30056,30056,99.00,29,8,37,0.7837837837837838,0.21621621621621623,Yes,0.7837837837837838
30057,30057,99.00,5,1,6,0.8333333333333334,0.16666666666666666,Yes,0.8333333333333334
30058,30058,99.00,99,41,140,0.7071428571428572,0.29285714285714287,Yes,0.7071428571428572
30059,30059,99.00,73,31,104,0.7019230769230769,0.2980769230769231,Yes,0.7019230769230769
30060,30060,99.00,119,31,150,0.7933333333333333,0.20666666666666667,Yes,0.7933333333333333
30061,30061,99.00,324,94,418,0.7751196172248804,0.22488038277511962,Yes,0.7751196172248804
30062,30062,99.00,199,46,245,0.8122448979591836,0.18775510204081633,Yes,0.8122448979591836
30063,30063,99.00,11,4,15,0.7333333333333333,0.26666666666666666,Yes,0.7333333333333333
30064,30064,99.00,4,3,7,0.5714285714285714,0.42857142857142855,Yes,0.5714285714285714
30065,30065,99.00,299,82,381,0.7847769028871391,0.2152230971128609,Yes,0.7847769028871391
30066,30066,99.00,16,7,23,0.6956521739130435,0.30434782608695654,Yes,0.6956521739130435
30067,30067,99.00,139,43,182,0.7637362637362637,0.23626373626373626,Yes,0.7637362637362637
30068,30068,99.00,192,35,227,0.8458149779735683,0.15418502202643172,Yes,0.8458149779735683
30069,30069,99.00,246,55,301,0.8172757475083057,0.18272425249169436,Yes,0.8172757475083057
30070,30070,99.00,0,0,0,0,0,n/a,0
30071,30071,99.00,0,0,0,0,0,n/a,0
30072,30072,99.00,0,0,0,0,0,n/a,0
30073,30073,99.00,117,61,178,0.6573033707865169,0.34269662921348315,Yes,0.6573033707865169
30074,30074,99.00,0,0,0,0,0,n/a,0
30075,30075,99.00,2,0,2,1.0,0.0,Yes,1.0
30076,30076,99.00,174,31,205,0.848780487804878,0.15121951219512195,Yes,0.848780487804878
30077,30077,99.00,121,20,141,0.8581560283687943,0.14184397163120568,Yes,0.8581560283687943
30078,30078,99.00,20,4,24,0.8333333333333334,0.16666666666666666,Yes,0.8333333333333334
30079,30079,99.00,12,3,15,0.8,0.2,Yes,0.8
30080,30080,80.00,3,3,6,0.5,0.5,Tie,0.5
30081,30081,99.00,86,39,125,0.688,0.312,Yes,0.688
30082,30082,99.00,143,53,196,0.7295918367346939,0.27040816326530615,Yes,0.7295918367346939
31001,31001,99.00,84,36,120,0.7,0.3,Yes,0.7
31002,31002,99.00,6,0,6,1.0,0.0,Yes,1.0
31003,31003,99.00,66,14,80,0.825,0.175,Yes,0.825
31004,31004,99.00,55,14,69,0.7971014492753623,0.2028985507246377,Yes,0.7971014492753623
31005,31005,99.00,67,12,79,0.8481012658227848,0.1518987341772152,Yes,0.8481012658227848
31006,31006,99.00,0,0,0,0,0,n/a,0
31007,31007,99.00,47,7,54,0.8703703703703703,0.12962962962962962,Yes,0.8703703703703703
31008,31008,99.00,47,17,64,0.734375,0.265625,Yes,0.734375
31009,31009,99.00,40,6,46,0.8695652173913043,0.13043478260869565,Yes,0.8695652173913043
31010,31010,99.00,84,15,99,0.8484848484848485,0.15151515151515152,Yes,0.8484848484848485
31011,31011,99.00,78,16,94,0.8297872340425532,0.1702127659574468,Yes,0.8297872340425532
31012,31012,99.00,50,11,61,0.819672131147541,0.18032786885245902,Yes,0.819672131147541
31013,31013,99.00,49,16,65,0.7538461538461538,0.24615384615384617,Yes,0.7538461538461538
31014,31014,99.00,66,8,74,0.8918918918918919,0.10810810810810811,Yes,0.8918918918918919
31015,31015,99.00,113,35,148,0.7635135135135135,0.23648648648648649,Yes,0.7635135135135135
31016,31016,99.00,4,2,6,0.6666666666666666,0.3333333333333333,Yes,0.6666666666666666
31017,31017,99.00,79,17,96,0.8229166666666666,0.17708333333333334,Yes,0.8229166666666666
31018,31018,99.00,83,19,102,0.8137254901960784,0.18627450980392157,Yes,0.8137254901960784
31019,31019,99.00,106,28,134,0.7910447761194029,0.208955223880597,Yes,0.7910447761194029
31020,31020,99.00,1,0,1,1.0,0.0,Yes,1.0
31021,31021,99.00,103,26,129,0.7984496124031008,0.20155038759689922,Yes,0.7984496124031008
31022,31022,99.00,35,14,49,0.7142857142857143,0.2857142857142857,Yes,0.7142857142857143
31023,31023,99.00,117,36,153,0.7647058823529411,0.23529411764705882,Yes,0.7647058823529411
31024,31024,99.00,116,23,139,0.8345323741007195,0.16546762589928057,Yes,0.8345323741007195
31025,31025,99.00,81,18,99,0.8181818181818182,0.18181818181818182,Yes,0.8181818181818182
31026,31026,99.00,8,3,11,0.7272727272727273,0.2727272727272727,Yes,0.7272727272727273
31027,31027,99.00,7,4,11,0.6363636363636364,0.36363636363636365,Yes,0.6363636363636364
31028,31028,99.00,5,0,5,1.0,0.0,Yes,1.0
31029,31029,99.00,5,0,5,1.0,0.0,Yes,1.0
31030,31030,99.00,0,0,0,0,0,n/a,0
31031,31031,99.00,1,0,1,1.0,0.0,Yes,1.0
31032,31032,99.00,104,16,120,0.8666666666666667,0.13333333333333333,Yes,0.8666666666666667
31033,31033,99.00,4,4,8,0.5,0.5,Tie,0.5
31034,31034,99.00,141,36,177,0.7966101694915254,0.2033898305084746,Yes,0.7966101694915254
31035,31035,99.00,119,18,137,0.8686131386861314,0.13138686131386862,Yes,0.8686131386861314
31036,31036,99.00,106,16,122,0.8688524590163934,0.13114754098360656,Yes,0.8688524590163934
31037,31037,99.00,117,18,135,0.8666666666666667,0.13333333333333333,Yes,0.8666666666666667
31038,31038,99.00,261,29,290,0.9,0.1,Yes,0.9
31039,31039,99.00,137,28,165,0.8303030303030303,0.1696969696969697,Yes,0.8303030303030303
31040,31040,99.00,129,21,150,0.86,0.14,Yes,0.86
31041,31041,99.00,124,23,147,0.8435374149659864,0.1564625850340136,Yes,0.8435374149659864
31042,31042,99.00,187,32,219,0.8538812785388128,0.1461187214611872,Yes,0.8538812785388128
31043,31043,99.00,4,1,5,0.8,0.2,Yes,0.8
31044,31044,99.00,145,23,168,0.8630952380952381,0.13690476190476192,Yes,0.8630952380952381
31045,31045,99.00,209,44,253,0.8260869565217391,0.17391304347826086,Yes,0.8260869565217391
31046,31046,99.00,166,30,196,0.8469387755102041,0.15306122448979592,Yes,0.8469387755102041
31047,31047,99.00,115,21,136,0.8455882352941176,0.15441176470588236,Yes,0.8455882352941176
31048,31048,99.00,12,1,13,0.9230769230769231,0.07692307692307693,Yes,0.9230769230769231
31049,31049,99.00,117,36,153,0.7647058823529411,0.23529411764705882,Yes,0.7647058823529411
31050,31050,99.00,2,0,2,1.0,0.0,Yes,1.0
31051,31051,99.00,77,20,97,0.7938144329896907,0.20618556701030927,Yes,0.7938144329896907
31052,31052,99.00,133,20,153,0.869281045751634,0.13071895424836602,Yes,0.869281045751634
31053,31053,99.00,90,15,105,0.8571428571428571,0.14285714285714285,Yes,0.8571428571428571
31054,31054,99.00,82,43,125,0.656,0.344,Yes,0.656
31055,31055,99.00,109,24,133,0.8195488721804511,0.18045112781954886,Yes,0.8195488721804511
31056,31056,99.00,63,19,82,0.7682926829268293,0.23170731707317074,Yes,0.7682926829268293
31057,31057,99.00,89,19,108,0.8240740740740741,0.17592592592592593,Yes,0.8240740740740741
31058,31058,99.00,136,27,163,0.8343558282208589,0.1656441717791411,Yes,0.8343558282208589
31059,31059,99.00,68,9,77,0.8831168831168831,0.11688311688311688,Yes,0.8831168831168831
31060,31060,99.00,0,0,0,0,0,n/a,0
31061,31061,99.00,0,0,0,0,0,n/a,0
31062,31062,0.00,3,0,3,1.0,0.0,Yes,1.0
31063,31063,0.00,6,2,8,0.75,0.25,Yes,0.75
31064,31064,99.00,4,3,7,0.5714285714285714,0.42857142857142855,Yes,0.5714285714285714
31065,31065,99.00,0,0,0,0,0,n/a,0
31066,31066,99.00,0,0,0,0,0,n/a,0
31067,31067,99.00,0,0,0,0,0,n/a,0
31068,31068,99.00,0,0,0,0,0,n/a,0
31069,31069,99.00,0,0,0,0,0,n/a,0
31070,31070,99.00,0,0,0,0,0,n/a,0
31071,31071,99.00,0,0,0,0,0,n/a,0
31072,31072,99.00,0,0,0,0,0,n/a,0
31073,31073,99.00,0,0,0,0,0,n/a,0
31074,31074,99.00,0,0,0,0,0,n/a,0
31075,31075,99.00,0,0,0,0,0,n/a,0
31076,31076,99.00,0,0,0,0,0,n/a,0
31077,31077,99.00,0,0,0,0,0,n/a,0
31078,31078,99.00,77,19,96,0.8020833333333334,0.19791666666666666,Yes,0.8020833333333334
31079,31079,99.00,88,11,99,0.8888888888888888,0.1111111111111111,Yes,0.8888888888888888
31080,31080,99.00,0,0,0,0,0,n/a,0
31081,31081,99.00,1,1,2,0.5,0.5,Tie,0.5
31082,31082,99.00,74,10,84,0.8809523809523809,0.11904761904761904,Yes,0.8809523809523809
31083,31083,99.00,3,1,4,0.75,0.25,Yes,0.75
31084,31084,99.00,4,1,5,0.8,0.2,Yes,0.8
31085,31085,99.00,11,1,12,0.9166666666666666,0.08333333333333333,Yes,0.9166666666666666
31086,31086,99.00,116,16,132,0.8787878787878788,0.12121212121212122,Yes,0.8787878787878788
32001,32001,66.67,88,11,99,0.8888888888888888,0.1111111111111111,Yes,0.8888888888888888
32002,32002,66.67,1,0,1,1.0,0.0,Yes,1.0
32003,32003,99.00,124,19,143,0.8671328671328671,0.13286713286713286,Yes,0.8671328671328671
32004,32004,99.00,112,26,138,0.8115942028985508,0.18840579710144928,Yes,0.8115942028985508
32005,32005,66.67,96,10,106,0.9056603773584906,0.09433962264150944,Yes,0.9056603773584906
32006,32006,99.00,148,27,175,0.8457142857142858,0.15428571428571428,Yes,0.8457142857142858
32007,32007,66.67,1,0,1,1.0,0.0,Yes,1.0
32008,32008,66.67,0,0,0,0,0,n/a,0
32009,32009,99.00,0,0,0,0,0,n/a,0
32010,32010,99.00,0,0,0,0,0,n/a,0
32011,32011,99.00,150,16,166,0.9036144578313253,0.0963855421686747,Yes,0.9036144578313253
32012,32012,75.00,0,0,0,0,0,n/a,0
32013,32013,75.00,0,1,1,0.0,1.0,No,1.0
32014,32014,99.00,0,0,0,0,0,n/a,0
32015,32015,75.00,10,1,11,0.9090909090909091,0.09090909090909091,Yes,0.9090909090909091
32016,32016,75.00,99,25,124,0.7983870967741935,0.20161290322580644,Yes,0.7983870967741935
32017,32017,75.00,73,24,97,0.7525773195876289,0.24742268041237114,Yes,0.7525773195876289
32018,32018,75.00,50,6,56,0.8928571428571429,0.10714285714285714,Yes,0.8928571428571429
32019,32019,99.00,1,0,1,1.0,0.0,Yes,1.0
32020,32020,99.00,43,4,47,0.9148936170212766,0.0851063829787234,Yes,0.9148936170212766
32021,32021,75.00,78,7,85,0.9176470588235294,0.08235294117647059,Yes,0.9176470588235294
32022,32022,99.00,3,2,5,0.6,0.4,Yes,0.6
32023,32023,75.00,122,9,131,0.9312977099236641,0.06870229007633588,Yes,0.9312977099236641
32024,32024,75.00,1,0,1,1.0,0.0,Yes,1.0
32025,32025,99.00,134,24,158,0.8481012658227848,0.1518987341772152,Yes,0.8481012658227848
32026,32026,75.00,6,0,6,1.0,0.0,Yes,1.0
32027,32027,75.00,93,16,109,0.8532110091743119,0.14678899082568808,Yes,0.8532110091743119
32028,32028,99.00,154,19,173,0.8901734104046243,0.10982658959537572,Yes,0.8901734104046243
32029,32029,83.33,92,21,113,0.8141592920353983,0.18584070796460178,Yes,0.8141592920353983
32030,32030,83.33,85,25,110,0.7727272727272727,0.22727272727272727,Yes,0.7727272727272727
32031,32031,99.00,77,16,93,0.8279569892473119,0.17204301075268819,Yes,0.8279569892473119
32032,32032,99.00,37,9,46,0.8043478260869565,0.1956521739130435,Yes,0.8043478260869565
32033,32033,83.33,104,20,124,0.8387096774193549,0.16129032258064516,Yes,0.8387096774193549
32034,32034,83.33,112,23,135,0.8296296296296296,0.17037037037037037,Yes,0.8296296296296296
32035,32035,83.33,82,9,91,0.9010989010989011,0.0989010989010989,Yes,0.9010989010989011
32036,32036,99.00,94,10,104,0.9038461538461539,0.09615384615384616,Yes,0.9038461538461539
32037,32037,99.00,144,37,181,0.7955801104972375,0.20441988950276244,Yes,0.7955801104972375
32038,32038,99.00,143,21,164,0.8719512195121951,0.12804878048780488,Yes,0.8719512195121951
32039,32039,99.00,107,16,123,0.8699186991869918,0.13008130081300814,Yes,0.8699186991869918
32040,32040,99.00,141,21,162,0.8703703703703703,0.12962962962962962,Yes,0.8703703703703703
32041,32041,99.00,178,39,217,0.8202764976958525,0.17972350230414746,Yes,0.8202764976958525
32042,32042,99.00,109,15,124,0.8790322580645161,0.12096774193548387,Yes,0.8790322580645161
32043,32043,99.00,116,17,133,0.8721804511278195,0.12781954887218044,Yes,0.8721804511278195
32044,32044,99.00,0,1,1,0.0,1.0,No,1.0
32045,32045,99.00,196,22,218,0.8990825688073395,0.10091743119266056,Yes,0.8990825688073395
32046,32046,99.00,173,33,206,0.8398058252427184,0.16019417475728157,Yes,0.8398058252427184
32047,32047,99.00,141,38,179,0.7877094972067039,0.2122905027932961,Yes,0.7877094972067039
32048,32048,99.00,2,1,3,0.6666666666666666,0.3333333333333333,Yes,0.6666666666666666
32049,32049,99.00,102,33,135,0.7555555555555555,0.24444444444444444,Yes,0.7555555555555555
32050,32050,99.00,97,28,125,0.776,0.224,Yes,0.776
32051,32051,99.00,134,18,152,0.881578947368421,0.11842105263157894,Yes,0.881578947368421
32052,32052,99.00,106,17,123,0.8617886178861789,0.13821138211382114,Yes,0.8617886178861789
32053,32053,99.00,93,20,113,0.8230088495575221,0.17699115044247787,Yes,0.8230088495575221
32054,32054,99.00,214,30,244,0.8770491803278688,0.12295081967213115,Yes,0.8770491803278688
32055,32055,99.00,8,0,8,1.0,0.0,Yes,1.0
32056,32056,99.00,2,0,2,1.0,0.0,Yes,1.0
32057,32057,99.00,149,18,167,0.8922155688622755,0.10778443113772455,Yes,0.8922155688622755
32058,32058,99.00,150,21,171,0.8771929824561403,0.12280701754385964,Yes,0.8771929824561403
32059,32059,99.00,110,24,134,0.8208955223880597,0.1791044776119403,Yes,0.8208955223880597
32060,32060,99.00,201,35,236,0.8516949152542372,0.1483050847457627,Yes,0.8516949152542372
32061,32061,99.00,4,4,8,0.5,0.5,Tie,0.5
32062,32062,99.00,192,39,231,0.8311688311688312,0.16883116883116883,Yes,0.8311688311688312
32063,32063,99.00,267,55,322,0.8291925465838509,0.17080745341614906,Yes,0.8291925465838509
32064,32064,75.00,208,39,247,0.8421052631578947,0.15789473684210525,Yes,0.8421052631578947
32065,32065,75.00,35,14,49,0.7142857142857143,0.2857142857142857,Yes,0.7142857142857143
32066,32066,75.00,196,51,247,0.7935222672064778,0.20647773279352227,Yes,0.7935222672064778
32067,32067,75.00,49,14,63,0.7777777777777778,0.2222222222222222,Yes,0.7777777777777778
32068,32068,99.00,161,39,200,0.805,0.195,Yes,0.805
32069,32069,99.00,303,61,364,0.8324175824175825,0.16758241758241757,Yes,0.8324175824175825
32070,32070,99.00,31,6,37,0.8378378378378378,0.16216216216216217,Yes,0.8378378378378378
32071,32071,75.00,91,39,130,0.7,0.3,Yes,0.7
32072,32072,99.00,83,26,109,0.7614678899082569,0.23853211009174313,Yes,0.7614678899082569
32073,32073,0.00,17,6,23,0.7391304347826086,0.2608695652173913,Yes,0.7391304347826086
32074,32074,0.00,1,0,1,1.0,0.0,Yes,1.0
32075,32075,99.00,132,26,158,0.8354430379746836,0.16455696202531644,Yes,0.8354430379746836
32076,32076,99.00,0,0,0,0,0,n/a,0
32077,32077,75.00,83,8,91,0.9120879120879121,0.08791208791208792,Yes,0.9120879120879121
32078,32078,99.00,5,1,6,0.8333333333333334,0.16666666666666666,Yes,0.8333333333333334
32079,32079,99.00,149,66,215,0.6930232558139535,0.30697674418604654,Yes,0.6930232558139535
32080,32080,66.67,3,0,3,1.0,0.0,Yes,1.0
32081,32081,99.00,3,3,6,0.5,0.5,Tie,0.5
32082,32082,83.33,100,27,127,0.7874015748031497,0.2125984251968504,Yes,0.7874015748031497
32083,32083,83.33,7,0,7,1.0,0.0,Yes,1.0
32084,32084,99.00,6,2,8,0.75,0.25,Yes,0.75
33001,33001,99.00,96,45,141,0.6808510638297872,0.3191489361702128,Yes,0.6808510638297872
33002,33002,99.00,86,56,142,0.6056338028169014,0.39436619718309857,Yes,0.6056338028169014
33003,33003,99.00,82,23,105,0.780952380952381,0.21904761904761905,Yes,0.780952380952381
33004,33004,99.00,210,89,299,0.7023411371237458,0.2976588628762542,Yes,0.7023411371237458
33005,33005,99.00,111,28,139,0.7985611510791367,0.2014388489208633,Yes,0.7985611510791367
33006,33006,99.00,120,59,179,0.6703910614525139,0.329608938547486,Yes,0.6703910614525139
33007,33007,99.00,14,3,17,0.8235294117647058,0.17647058823529413,Yes,0.8235294117647058
33008,33008,99.00,131,50,181,0.7237569060773481,0.27624309392265195,Yes,0.7237569060773481
33009,33009,99.00,121,53,174,0.6954022988505747,0.3045977011494253,Yes,0.6954022988505747
33010,33010,99.00,165,60,225,0.7333333333333333,0.26666666666666666,Yes,0.7333333333333333
33011,33011,99.00,120,52,172,0.6976744186046512,0.3023255813953488,Yes,0.6976744186046512
33012,33012,99.00,6,1,7,0.8571428571428571,0.14285714285714285,Yes,0.8571428571428571
33013,33013,99.00,97,19,116,0.8362068965517241,0.16379310344827586,Yes,0.8362068965517241
33014,33014,99.00,67,22,89,0.7528089887640449,0.24719101123595505,Yes,0.7528089887640449
33015,33015,99.00,89,49,138,0.644927536231884,0.35507246376811596,Yes,0.644927536231884
33016,33016,99.00,3,0,3,1.0,0.0,Yes,1.0
33017,33017,99.00,102,40,142,0.7183098591549296,0.28169014084507044,Yes,0.7183098591549296
33018,33018,99.00,87,17,104,0.8365384615384616,0.16346153846153846,Yes,0.8365384615384616
33019,33019,99.00,89,27,116,0.7672413793103449,0.23275862068965517,Yes,0.7672413793103449
33020,33020,99.00,56,17,73,0.7671232876712328,0.2328767123287671,Yes,0.7671232876712328
33021,33021,99.00,86,13,99,0.8686868686868687,0.13131313131313133,Yes,0.8686868686868687
33022,33022,99.00,53,16,69,0.7681159420289855,0.2318840579710145,Yes,0.7681159420289855
33023,33023,99.00,55,11,66,0.8333333333333334,0.16666666666666666,Yes,0.8333333333333334
33024,33024,99.00,4,2,6,0.6666666666666666,0.3333333333333333,Yes,0.6666666666666666
33025,33025,99.00,82,16,98,0.8367346938775511,0.16326530612244897,Yes,0.8367346938775511
33026,33026,99.00,64,19,83,0.7710843373493976,0.2289156626506024,Yes,0.7710843373493976
33027,33027,99.00,143,31,174,0.8218390804597702,0.1781609195402299,Yes,0.8218390804597702
33028,33028,99.00,5,2,7,0.7142857142857143,0.2857142857142857,Yes,0.7142857142857143
33029,33029,99.00,213,36,249,0.8554216867469879,0.14457831325301204,Yes,0.8554216867469879
33030,33030,99.00,196,41,237,0.8270042194092827,0.1729957805907173,Yes,0.8270042194092827
33031,33031,99.00,122,27,149,0.8187919463087249,0.18120805369127516,Yes,0.8187919463087249
33032,33032,99.00,123,29,152,0.8092105263157895,0.19078947368421054,Yes,0.8092105263157895
33033,33033,99.00,110,18,128,0.859375,0.140625,Yes,0.859375
33034,33034,99.00,103,20,123,0.8373983739837398,0.16260162601626016,Yes,0.8373983739837398
33035,33035,99.00,157,25,182,0.8626373626373627,0.13736263736263737,Yes,0.8626373626373627
33036,33036,99.00,99,26,125,0.792,0.208,Yes,0.792
33037,33037,99.00,142,31,173,0.8208092485549133,0.1791907514450867,Yes,0.8208092485549133
33038,33038,99.00,127,21,148,0.8581081081081081,0.14189189189189189,Yes,0.8581081081081081
33039,33039,99.00,115,30,145,0.7931034482758621,0.20689655172413793,Yes,0.7931034482758621
33040,33040,99.00,108,20,128,0.84375,0.15625,Yes,0.84375
33041,33041,99.00,115,30,145,0.7931034482758621,0.20689655172413793,Yes,0.7931034482758621
33042,33042,99.00,110,23,133,0.8270676691729323,0.17293233082706766,Yes,0.8270676691729323
33043,33043,85.71,77,7,84,0.9166666666666666,0.08333333333333333,Yes,0.9166666666666666
33044,33044,99.00,134,32,166,0.8072289156626506,0.1927710843373494,Yes,0.8072289156626506
33045,33045,99.00,133,27,160,0.83125,0.16875,Yes,0.83125
33046,33046,99.00,143,17,160,0.89375,0.10625,Yes,0.89375
33047,33047,85.71,210,36,246,0.8536585365853658,0.14634146341463414,Yes,0.8536585365853658
33048,33048,85.71,96,19,115,0.8347826086956521,0.16521739130434782,Yes,0.8347826086956521
33049,33049,99.00,158,34,192,0.8229166666666666,0.17708333333333334,Yes,0.8229166666666666
33050,33050,99.00,6,2,8,0.75,0.25,Yes,0.75
33051,33051,99.00,113,19,132,0.8560606060606061,0.14393939393939395,Yes,0.8560606060606061
33052,33052,85.71,91,29,120,0.7583333333333333,0.24166666666666667,Yes,0.7583333333333333
33053,33053,85.71,92,26,118,0.7796610169491526,0.22033898305084745,Yes,0.7796610169491526
33054,33054,85.71,130,30,160,0.8125,0.1875,Yes,0.8125
33055,33055,85.71,101,24,125,0.808,0.192,Yes,0.808
33056,33056,57.14,158,35,193,0.8186528497409327,0.18134715025906736,Yes,0.8186528497409327
33057,33057,99.00,124,31,155,0.8,0.2,Yes,0.8
33058,33058,99.00,128,33,161,0.7950310559006211,0.20496894409937888,Yes,0.7950310559006211
33059,33059,99.00,164,35,199,0.8241206030150754,0.17587939698492464,Yes,0.8241206030150754
33060,33060,99.00,133,25,158,0.8417721518987342,0.15822784810126583,Yes,0.8417721518987342
33061,33061,99.00,107,16,123,0.8699186991869918,0.13008130081300814,Yes,0.8699186991869918
33062,33062,99.00,130,25,155,0.8387096774193549,0.16129032258064516,Yes,0.8387096774193549
33063,33063,99.00,145,24,169,0.8579881656804734,0.14201183431952663,Yes,0.8579881656804734
33064,33064,99.00,170,24,194,0.8762886597938144,0.12371134020618557,Yes,0.8762886597938144
33065,33065,57.14,202,24,226,0.8938053097345132,0.10619469026548672,Yes,0.8938053097345132
33066,33066,57.14,177,37,214,0.8271028037383178,0.17289719626168223,Yes,0.8271028037383178
33067,33067,57.14,146,27,173,0.8439306358381503,0.15606936416184972,Yes,0.8439306358381503
33068,33068,99.00,152,21,173,0.8786127167630058,0.12138728323699421,Yes,0.8786127167630058
33069,33069,57.14,152,29,181,0.8397790055248618,0.16022099447513813,Yes,0.8397790055248618
33070,33070,99.00,157,40,197,0.7969543147208121,0.20304568527918782,Yes,0.7969543147208121
33071,33071,99.00,189,29,218,0.8669724770642202,0.13302752293577982,Yes,0.8669724770642202
33072,33072,99.00,110,22,132,0.8333333333333334,0.16666666666666666,Yes,0.8333333333333334
33073,33073,85.71,107,15,122,0.8770491803278688,0.12295081967213115,Yes,0.8770491803278688
33074,33074,99.00,83,24,107,0.7757009345794392,0.22429906542056074,Yes,0.7757009345794392
33075,33075,99.00,95,38,133,0.7142857142857143,0.2857142857142857,Yes,0.7142857142857143
33076,33076,99.00,3,2,5,0.6,0.4,Yes,0.6
33077,33077,99.00,207,37,244,0.8483606557377049,0.15163934426229508,Yes,0.8483606557377049
33078,33078,99.00,131,20,151,0.8675496688741722,0.13245033112582782,Yes,0.8675496688741722
33079,33079,85.71,8,1,9,0.8888888888888888,0.1111111111111111,Yes,0.8888888888888888
34001,34001,99.00,74,11,85,0.8705882352941177,0.12941176470588237,Yes,0.8705882352941177
34002,34002,99.00,71,14,85,0.8352941176470589,0.16470588235294117,Yes,0.8352941176470589
34003,34003,99.00,46,6,52,0.8846153846153846,0.11538461538461539,Yes,0.8846153846153846
34004,34004,99.00,110,26,136,0.8088235294117647,0.19117647058823528,Yes,0.8088235294117647
34005,34005,99.00,48,10,58,0.8275862068965517,0.1724137931034483,Yes,0.8275862068965517
34006,34006,99.00,30,6,36,0.8333333333333334,0.16666666666666666,Yes,0.8333333333333334
34007,34007,99.00,4,1,5,0.8,0.2,Yes,0.8
34008,34008,99.00,124,33,157,0.7898089171974523,0.21019108280254778,Yes,0.7898089171974523
34009,34009,99.00,2,1,3,0.6666666666666666,0.3333333333333333,Yes,0.6666666666666666
34010,34010,99.00,117,25,142,0.823943661971831,0.176056338028169,Yes,0.823943661971831
34011,34011,99.00,148,25,173,0.8554913294797688,0.14450867052023122,Yes,0.8554913294797688
34012,34012,99.00,5,2,7,0.7142857142857143,0.2857142857142857,Yes,0.7142857142857143
34013,34013,99.00,3,1,4,0.75,0.25,Yes,0.75
34014,34014,99.00,84,18,102,0.8235294117647058,0.17647058823529413,Yes,0.8235294117647058
34015,34015,99.00,124,39,163,0.7607361963190185,0.2392638036809816,Yes,0.7607361963190185
34016,34016,99.00,195,67,262,0.7442748091603053,0.25572519083969464,Yes,0.7442748091603053
34017,34017,99.00,15,2,17,0.8823529411764706,0.11764705882352941,Yes,0.8823529411764706
34018,34018,99.00,3,0,3,1.0,0.0,Yes,1.0
34019,34019,99.00,181,43,224,0.8080357142857143,0.19196428571428573,Yes,0.8080357142857143
34020,34020,99.00,164,31,195,0.841025641025641,0.15897435897435896,Yes,0.841025641025641
34021,34021,99.00,4,0,4,1.0,0.0,Yes,1.0
34022,34022,99.00,201,40,241,0.8340248962655602,0.16597510373443983,Yes,0.8340248962655602
34023,34023,99.00,121,19,140,0.8642857142857143,0.1357142857142857,Yes,0.8642857142857143
34024,34024,99.00,341,87,428,0.7967289719626168,0.20327102803738317,Yes,0.7967289719626168
34025,34025,83.33,220,86,306,0.7189542483660131,0.28104575163398693,Yes,0.7189542483660131
34026,34026,83.33,112,29,141,0.7943262411347518,0.20567375886524822,Yes,0.7943262411347518
34027,34027,83.33,7,4,11,0.6363636363636364,0.36363636363636365,Yes,0.6363636363636364
34028,34028,99.00,143,40,183,0.7814207650273224,0.2185792349726776,Yes,0.7814207650273224
34029,34029,99.00,4,0,4,1.0,0.0,Yes,1.0
34030,34030,99.00,0,0,0,0,0,n/a,0
34031,34031,99.00,1,0,1,1.0,0.0,Yes,1.0
34032,34032,99.00,0,0,0,0,0,n/a,0
34033,34033,99.00,0,0,0,0,0,n/a,0
34034,34034,99.00,1,0,1,1.0,0.0,Yes,1.0
34035,34035,83.33,74,18,92,0.8043478260869565,0.1956521739130435,Yes,0.8043478260869565
34036,34036,83.33,80,21,101,0.7920792079207921,0.2079207920792079,Yes,0.7920792079207921
34037,34037,83.33,58,11,69,0.8405797101449275,0.15942028985507245,Yes,0.8405797101449275
34038,34038,99.00,141,30,171,0.8245614035087719,0.17543859649122806,Yes,0.8245614035087719
34039,34039,99.00,114,30,144,0.7916666666666666,0.20833333333333334,Yes,0.7916666666666666
34040,34040,99.00,68,36,104,0.6538461538461539,0.34615384615384615,Yes,0.6538461538461539
34041,34041,99.00,64,34,98,0.6530612244897959,0.3469387755102041,Yes,0.6530612244897959
34042,34042,99.00,2,0,2,1.0,0.0,Yes,1.0
34043,34043,99.00,1,0,1,1.0,0.0,Yes,1.0
34044,34044,99.00,2,0,2,1.0,0.0,Yes,1.0
34045,34045,99.00,178,56,234,0.7606837606837606,0.23931623931623933,Yes,0.7606837606837606
34046,34046,99.00,76,12,88,0.8636363636363636,0.13636363636363635,Yes,0.8636363636363636
34047,34047,99.00,0,0,0,0,0,n/a,0
34048,34048,99.00,4,0,4,1.0,0.0,Yes,1.0
34049,34049,99.00,132,40,172,0.7674418604651163,0.23255813953488372,Yes,0.7674418604651163
34050,34050,99.00,2,1,3,0.6666666666666666,0.3333333333333333,Yes,0.6666666666666666
34051,34051,99.00,91,28,119,0.7647058823529411,0.23529411764705882,Yes,0.7647058823529411
34052,34052,99.00,163,15,178,0.9157303370786517,0.08426966292134831,Yes,0.9157303370786517
34053,34053,99.00,0,0,0,0,0,n/a,0
34054,34054,99.00,0,0,0,0,0,n/a,0
34055,34055,99.00,0,0,0,0,0,n/a,0
34056,34056,99.00,0,0,0,0,0,n/a,0
34057,34057,99.00,0,0,0,0,0,n/a,0
34058,34058,99.00,0,0,0,0,0,n/a,0
34059,34059,99.00,0,0,0,0,0,n/a,0
34060,34060,99.00,142,32,174,0.8160919540229885,0.1839080459770115,Yes,0.8160919540229885
34061,34061,99.00,93,20,113,0.8230088495575221,0.17699115044247787,Yes,0.8230088495575221
34062,34062,99.00,2,0,2,1.0,0.0,Yes,1.0
34063,34063,83.33,212,58,270,0.7851851851851852,0.21481481481481482,Yes,0.7851851851851852
34064,34064,99.00,0,0,0,0,0,n/a,0
34065,34065,99.00,149,24,173,0.861271676300578,0.13872832369942195,Yes,0.861271676300578
34066,34066,99.00,181,42,223,0.8116591928251121,0.18834080717488788,Yes,0.8116591928251121
34067,34067,99.00,68,23,91,0.7472527472527473,0.25274725274725274,Yes,0.7472527472527473
34068,34068,99.00,10,1,11,0.9090909090909091,0.09090909090909091,Yes,0.9090909090909091
34069,34069,99.00,140,47,187,0.7486631016042781,0.25133689839572193,Yes,0.7486631016042781
34070,34070,99.00,1,0,1,1.0,0.0,Yes,1.0
34071,34071,99.00,0,0,0,0,0,n/a,0
34072,34072,99.00,292,63,355,0.8225352112676056,0.17746478873239438,Yes,0.8225352112676056
34073,34073,99.00,3,0,3,1.0,0.0,Yes,1.0
35001,35001,99.00,0,0,0,0,0,n/a,0
35002,35002,99.00,71,21,92,0.7717391304347826,0.22826086956521738,Yes,0.7717391304347826
35003,35003,99.00,132,26,158,0.8354430379746836,0.16455696202531644,Yes,0.8354430379746836
35004,35004,99.00,88,17,105,0.8380952380952381,0.1619047619047619,Yes,0.8380952380952381
35005,35005,99.00,86,33,119,0.7226890756302521,0.2773109243697479,Yes,0.7226890756302521
35006,35006,0.00,2,3,5,0.4,0.6,No,0.6
35007,35007,99.00,118,25,143,0.8251748251748252,0.17482517482517482,Yes,0.8251748251748252
35008,35008,99.00,3,0,3,1.0,0.0,Yes,1.0
35009,35009,99.00,133,26,159,0.8364779874213837,0.16352201257861634,Yes,0.8364779874213837
35010,35010,99.00,1,0,1,1.0,0.0,Yes,1.0
35011,35011,99.00,64,6,70,0.9142857142857143,0.08571428571428572,Yes,0.9142857142857143
35012,35012,99.00,152,25,177,0.8587570621468926,0.14124293785310735,Yes,0.8587570621468926
35013,35013,99.00,57,17,74,0.7702702702702703,0.22972972972972974,Yes,0.7702702702702703
35014,35014,99.00,1,2,3,0.3333333333333333,0.6666666666666666,No,0.6666666666666666
35015,35015,99.00,96,21,117,0.8205128205128205,0.1794871794871795,Yes,0.8205128205128205
35016,35016,99.00,89,12,101,0.8811881188118812,0.1188118811881188,Yes,0.8811881188118812
35017,35017,99.00,96,18,114,0.8421052631578947,0.15789473684210525,Yes,0.8421052631578947
35018,35018,99.00,147,25,172,0.8546511627906976,0.14534883720930233,Yes,0.8546511627906976
35019,35019,99.00,3,0,3,1.0,0.0,Yes,1.0
35020,35020,55.56,157,30,187,0.839572192513369,0.16042780748663102,Yes,0.839572192513369
35021,35021,99.00,102,21,123,0.8292682926829268,0.17073170731707318,Yes,0.8292682926829268
35022,35022,99.00,101,12,113,0.8938053097345132,0.10619469026548672,Yes,0.8938053097345132
35023,35023,99.00,2,0,2,1.0,0.0,Yes,1.0
35024,35024,99.00,134,57,191,0.7015706806282722,0.29842931937172773,Yes,0.7015706806282722
35025,35025,99.00,114,15,129,0.8837209302325582,0.11627906976744186,Yes,0.8837209302325582
35026,35026,99.00,1,1,2,0.5,0.5,Tie,0.5
35027,35027,99.00,144,43,187,0.7700534759358288,0.22994652406417113,Yes,0.7700534759358288
35028,35028,99.00,40,8,48,0.8333333333333334,0.16666666666666666,Yes,0.8333333333333334
35029,35029,99.00,0,0,0,0,0,n/a,0
35030,35030,99.00,0,0,0,0,0,n/a,0
35031,35031,99.00,0,0,0,0,0,n/a,0
35032,35032,99.00,78,20,98,0.7959183673469388,0.20408163265306123,Yes,0.7959183673469388
35033,35033,0.00,2,2,4,0.5,0.5,Tie,0.5
35034,35034,99.00,0,0,0,0,0,n/a,0
35035,35035,99.00,2,0,2,1.0,0.0,Yes,1.0
35036,35036,99.00,0,0,0,0,0,n/a,0
35037,35037,99.00,60,14,74,0.8108108108108109,0.1891891891891892,Yes,0.8108108108108109
35038,35038,99.00,125,26,151,0.8278145695364238,0.17218543046357615,Yes,0.8278145695364238
35039,35039,99.00,48,14,62,0.7741935483870968,0.22580645161290322,Yes,0.7741935483870968
35040,35040,99.00,0,0,0,0,0,n/a,0
35041,35041,99.00,107,16,123,0.8699186991869918,0.13008130081300814,Yes,0.8699186991869918
35042,35042,99.00,74,11,85,0.8705882352941177,0.12941176470588237,Yes,0.8705882352941177
35043,35043,99.00,75,11,86,0.872093023255814,0.12790697674418605,Yes,0.872093023255814
35044,35044,99.00,71,13,84,0.8452380952380952,0.15476190476190477,Yes,0.8452380952380952
35045,35045,99.00,7,1,8,0.875,0.125,Yes,0.875
35046,35046,55.56,78,16,94,0.8297872340425532,0.1702127659574468,Yes,0.8297872340425532
35047,35047,55.56,111,16,127,0.8740157480314961,0.12598425196850394,Yes,0.8740157480314961
35048,35048,55.56,127,18,145,0.8758620689655172,0.12413793103448276,Yes,0.8758620689655172
35049,35049,99.00,1,1,2,0.5,0.5,Tie,0.5
35050,35050,99.00,102,29,131,0.7786259541984732,0.22137404580152673,Yes,0.7786259541984732
35051,35051,99.00,84,21,105,0.8,0.2,Yes,0.8
35052,35052,55.56,93,15,108,0.8611111111111112,0.1388888888888889,Yes,0.8611111111111112
35053,35053,55.56,108,21,129,0.8372093023255814,0.16279069767441862,Yes,0.8372093023255814
35054,35054,99.00,0,0,0,0,0,n/a,0
35055,35055,99.00,0,0,0,0,0,n/a,0
35056,35056,55.56,0,0,0,0,0,n/a,0
35057,35057,99.00,0,0,0,0,0,n/a,0
35058,35058,99.00,0,0,0,0,0,n/a,0
35059,35059,99.00,0,0,0,0,0,n/a,0
35060,35060,55.56,0,0,0,0,0,n/a,0
35061,35061,99.00,0,0,0,0,0,n/a,0
35062,35062,99.00,0,0,0,0,0,n/a,0
35063,35063,99.00,61,18,79,0.7721518987341772,0.22784810126582278,Yes,0.7721518987341772
35064,35064,99.00,4,0,4,1.0,0.0,Yes,1.0
35065,35065,99.00,60,18,78,0.7692307692307693,0.23076923076923078,Yes,0.7692307692307693
35066,35066,99.00,10,2,12,0.8333333333333334,0.16666666666666666,Yes,0.8333333333333334
36001,36001,99.00,302,93,395,0.7645569620253164,0.23544303797468355,Yes,0.7645569620253164
36002,36002,99.00,228,78,306,0.7450980392156863,0.2549019607843137,Yes,0.7450980392156863
36003,36003,99.00,18,8,26,0.6923076923076923,0.3076923076923077,Yes,0.6923076923076923
36004,36004,99.00,227,74,301,0.7541528239202658,0.24584717607973422,Yes,0.7541528239202658
36005,36005,99.00,46,19,65,0.7076923076923077,0.2923076923076923,Yes,0.7076923076923077
36006,36006,99.00,244,47,291,0.8384879725085911,0.16151202749140894,Yes,0.8384879725085911
36007,36007,99.00,15,7,22,0.6818181818181818,0.3181818181818182,Yes,0.6818181818181818
36008,36008,99.00,289,73,362,0.7983425414364641,0.20165745856353592,Yes,0.7983425414364641
36009,36009,99.00,177,48,225,0.7866666666666666,0.21333333333333335,Yes,0.7866666666666666
36010,36010,99.00,119,34,153,0.7777777777777778,0.2222222222222222,Yes,0.7777777777777778
36011,36011,80.00,90,31,121,0.743801652892562,0.256198347107438,Yes,0.743801652892562
36012,36012,80.00,139,28,167,0.8323353293413174,0.16766467065868262,Yes,0.8323353293413174
36013,36013,99.00,11,2,13,0.8461538461538461,0.15384615384615385,Yes,0.8461538461538461
36014,36014,80.00,111,43,154,0.7207792207792207,0.2792207792207792,Yes,0.7207792207792207
36015,36015,80.00,134,33,167,0.8023952095808383,0.19760479041916168,Yes,0.8023952095808383
36016,36016,99.00,251,59,310,0.8096774193548387,0.19032258064516128,Yes,0.8096774193548387
36017,36017,99.00,7,1,8,0.875,0.125,Yes,0.875
36018,36018,99.00,262,83,345,0.7594202898550725,0.24057971014492754,Yes,0.7594202898550725
36019,36019,99.00,166,26,192,0.8645833333333334,0.13541666666666666,Yes,0.8645833333333334
36020,36020,99.00,30,8,38,0.7894736842105263,0.21052631578947367,Yes,0.7894736842105263
36021,36021,99.00,171,26,197,0.868020304568528,0.1319796954314721,Yes,0.868020304568528
36022,36022,99.00,228,66,294,0.7755102040816326,0.22448979591836735,Yes,0.7755102040816326
36023,36023,99.00,17,3,20,0.85,0.15,Yes,0.85
36024,36024,99.00,14,3,17,0.8235294117647058,0.17647058823529413,Yes,0.8235294117647058
36025,36025,99.00,205,45,250,0.82,0.18,Yes,0.82
36026,36026,99.00,27,5,32,0.84375,0.15625,Yes,0.84375
36027,36027,99.00,135,44,179,0.7541899441340782,0.24581005586592178,Yes,0.7541899441340782
36028,36028,99.00,221,55,276,0.8007246376811594,0.19927536231884058,Yes,0.8007246376811594
36029,36029,99.00,5,3,8,0.625,0.375,Yes,0.625
36030,36030,99.00,197,54,251,0.7848605577689243,0.2151394422310757,Yes,0.7848605577689243
36031,36031,99.00,138,40,178,0.7752808988764045,0.2247191011235955,Yes,0.7752808988764045
36032,36032,99.00,185,73,258,0.7170542635658915,0.28294573643410853,Yes,0.7170542635658915
36033,36033,99.00,11,0,11,1.0,0.0,Yes,1.0
36034,36034,99.00,249,61,310,0.8032258064516129,0.1967741935483871,Yes,0.8032258064516129
36035,36035,99.00,9,0,9,1.0,0.0,Yes,1.0
36036,36036,99.00,308,77,385,0.8,0.2,Yes,0.8
36037,36037,99.00,236,70,306,0.7712418300653595,0.22875816993464052,Yes,0.7712418300653595
36038,36038,99.00,270,75,345,0.782608695652174,0.21739130434782608,Yes,0.782608695652174
36039,36039,99.00,17,1,18,0.9444444444444444,0.05555555555555555,Yes,0.9444444444444444
36040,36040,99.00,179,53,232,0.771551724137931,0.22844827586206898,Yes,0.771551724137931
36041,36041,99.00,180,57,237,0.759493670886076,0.24050632911392406,Yes,0.759493670886076
36042,36042,99.00,241,61,302,0.7980132450331126,0.20198675496688742,Yes,0.7980132450331126
36043,36043,99.00,4,0,4,1.0,0.0,Yes,1.0
36044,36044,99.00,0,0,0,0,0,n/a,0
36045,36045,80.00,127,30,157,0.8089171974522293,0.1910828025477707,Yes,0.8089171974522293
36046,36046,99.00,173,44,217,0.7972350230414746,0.20276497695852536,Yes,0.7972350230414746
36047,36047,99.00,3,5,8,0.375,0.625,No,0.625
36048,36048,99.00,160,63,223,0.7174887892376681,0.2825112107623318,Yes,0.7174887892376681
36049,36049,99.00,200,52,252,0.7936507936507936,0.20634920634920634,Yes,0.7936507936507936
36050,36050,99.00,1,0,1,1.0,0.0,Yes,1.0
36051,36051,99.00,1,0,1,1.0,0.0,Yes,1.0
36052,36052,99.00,173,43,216,0.8009259259259259,0.19907407407407407,Yes,0.8009259259259259
36053,36053,99.00,205,64,269,0.7620817843866171,0.2379182156133829,Yes,0.7620817843866171
36054,36054,99.00,122,53,175,0.6971428571428572,0.3028571428571429,Yes,0.6971428571428572
36055,36055,99.00,157,39,196,0.8010204081632653,0.1989795918367347,Yes,0.8010204081632653
36056,36056,99.00,197,34,231,0.8528138528138528,0.1471861471861472,Yes,0.8528138528138528
36057,36057,99.00,8,4,12,0.6666666666666666,0.3333333333333333,Yes,0.6666666666666666
36058,36058,99.00,5,6,11,0.45454545454545453,0.5454545454545454,No,0.5454545454545454
36059,36059,99.00,232,78,310,0.7483870967741936,0.25161290322580643,Yes,0.7483870967741936
36060,36060,99.00,7,0,7,1.0,0.0,Yes,1.0
36061,36061,99.00,124,38,162,0.7654320987654321,0.2345679012345679,Yes,0.7654320987654321
36062,36062,99.00,4,0,4,1.0,0.0,Yes,1.0
36063,36063,99.00,168,38,206,0.8155339805825242,0.18446601941747573,Yes,0.8155339805825242
36064,36064,99.00,215,41,256,0.83984375,0.16015625,Yes,0.83984375
36065,36065,99.00,7,1,8,0.875,0.125,Yes,0.875
36066,36066,99.00,192,42,234,0.8205128205128205,0.1794871794871795,Yes,0.8205128205128205
36067,36067,99.00,7,4,11,0.6363636363636364,0.36363636363636365,Yes,0.6363636363636364
36068,36068,99.00,0,0,0,0,0,n/a,0
36069,36069,99.00,0,0,0,0,0,n/a,0
36070,36070,99.00,0,0,0,0,0,n/a,0
36071,36071,99.00,0,0,0,0,0,n/a,0
36072,36072,99.00,163,43,206,0.7912621359223301,0.2087378640776699,Yes,0.7912621359223301
36073,36073,99.00,294,63,357,0.8235294117647058,0.17647058823529413,Yes,0.8235294117647058
36074,36074,99.00,4,3,7,0.5714285714285714,0.42857142857142855,Yes,0.5714285714285714
36075,36075,99.00,15,6,21,0.7142857142857143,0.2857142857142857,Yes,0.7142857142857143
36076,36076,99.00,148,34,182,0.8131868131868132,0.18681318681318682,Yes,0.8131868131868132
36077,36077,99.00,263,61,324,0.8117283950617284,0.1882716049382716,Yes,0.8117283950617284
36078,36078,99.00,8,1,9,0.8888888888888888,0.1111111111111111,Yes,0.8888888888888888
36079,36079,99.00,5,3,8,0.625,0.375,Yes,0.625
36080,36080,99.00,5,1,6,0.8333333333333334,0.16666666666666666,Yes,0.8333333333333334
36081,36081,99.00,250,64,314,0.7961783439490446,0.20382165605095542,Yes,0.7961783439490446
36082,36082,99.00,16,5,21,0.7619047619047619,0.23809523809523808,Yes,0.7619047619047619
36083,36083,99.00,1,0,1,1.0,0.0,Yes,1.0
37001,37001,99.00,112,32,144,0.7777777777777778,0.2222222222222222,Yes,0.7777777777777778
37002,37002,99.00,85,23,108,0.7870370370370371,0.21296296296296297,Yes,0.7870370370370371
37003,37003,99.00,100,14,114,0.8771929824561403,0.12280701754385964,Yes,0.8771929824561403
37004,37004,99.00,110,23,133,0.8270676691729323,0.17293233082706766,Yes,0.8270676691729323
37005,37005,80.00,122,20,142,0.8591549295774648,0.14084507042253522,Yes,0.8591549295774648
37006,37006,99.00,81,17,98,0.826530612244898,0.17346938775510204,Yes,0.826530612244898
37007,37007,50.00,43,12,55,0.7818181818181819,0.21818181818181817,Yes,0.7818181818181819
37008,37008,50.00,6,2,8,0.75,0.25,Yes,0.75
37009,37009,50.00,24,3,27,0.8888888888888888,0.1111111111111111,Yes,0.8888888888888888
37010,37010,99.00,9,2,11,0.8181818181818182,0.18181818181818182,Yes,0.8181818181818182
37011,37011,99.00,158,41,199,0.7939698492462312,0.20603015075376885,Yes,0.7939698492462312
37012,37012,99.00,116,21,137,0.8467153284671532,0.15328467153284672,Yes,0.8467153284671532
37013,37013,99.00,1,0,1,1.0,0.0,Yes,1.0
37014,37014,99.00,141,24,165,0.8545454545454545,0.14545454545454545,Yes,0.8545454545454545
37015,37015,99.00,3,0,3,1.0,0.0,Yes,1.0
37016,37016,99.00,131,28,159,0.8238993710691824,0.1761006289308176,Yes,0.8238993710691824
37017,37017,99.00,1,0,1,1.0,0.0,Yes,1.0
37018,37018,99.00,141,35,176,0.8011363636363636,0.19886363636363635,Yes,0.8011363636363636
37019,37019,99.00,113,44,157,0.7197452229299363,0.2802547770700637,Yes,0.7197452229299363
37020,37020,99.00,6,6,12,0.5,0.5,Tie,0.5
37021,37021,99.00,308,92,400,0.77,0.23,Yes,0.77
37022,37022,99.00,225,52,277,0.8122743682310469,0.18772563176895307,Yes,0.8122743682310469
37023,37023,99.00,187,67,254,0.7362204724409449,0.2637795275590551,Yes,0.7362204724409449
37024,37024,99.00,261,104,365,0.7150684931506849,0.28493150684931506,Yes,0.7150684931506849
37025,37025,99.00,3,0,3,1.0,0.0,Yes,1.0
37026,37026,99.00,0,0,0,0,0,n/a,0
37027,37027,80.00,220,53,273,0.8058608058608059,0.19413919413919414,Yes,0.8058608058608059
37028,37028,80.00,179,33,212,0.8443396226415094,0.15566037735849056,Yes,0.8443396226415094
37029,37029,80.00,141,32,173,0.815028901734104,0.18497109826589594,Yes,0.815028901734104
37030,37030,80.00,119,19,138,0.8623188405797102,0.13768115942028986,Yes,0.8623188405797102
37031,37031,99.00,8,1,9,0.8888888888888888,0.1111111111111111,Yes,0.8888888888888888
37032,37032,99.00,253,56,309,0.8187702265372169,0.18122977346278318,Yes,0.8187702265372169
37033,37033,99.00,13,1,14,0.9285714285714286,0.07142857142857142,Yes,0.9285714285714286
37034,37034,99.00,78,19,97,0.8041237113402062,0.1958762886597938,Yes,0.8041237113402062
37035,37035,99.00,95,21,116,0.8189655172413793,0.1810344827586207,Yes,0.8189655172413793
37036,37036,99.00,163,40,203,0.8029556650246306,0.19704433497536947,Yes,0.8029556650246306
37037,37037,99.00,165,38,203,0.812807881773399,0.18719211822660098,Yes,0.812807881773399
37038,37038,99.00,145,30,175,0.8285714285714286,0.17142857142857143,Yes,0.8285714285714286
37039,37039,99.00,278,53,331,0.8398791540785498,0.16012084592145015,Yes,0.8398791540785498
37040,37040,99.00,0,0,0,0,0,n/a,0
37041,37041,99.00,1,0,1,1.0,0.0,Yes,1.0
37042,37042,99.00,116,31,147,0.7891156462585034,0.2108843537414966,Yes,0.7891156462585034
37043,37043,99.00,1,0,1,1.0,0.0,Yes,1.0
37044,37044,99.00,7,1,8,0.875,0.125,Yes,0.875
37045,37045,99.00,98,37,135,0.725925925925926,0.2740740740740741,Yes,0.725925925925926
37046,37046,99.00,88,15,103,0.8543689320388349,0.14563106796116504,Yes,0.8543689320388349
37047,37047,99.00,94,19,113,0.831858407079646,0.168141592920354,Yes,0.831858407079646
37048,37048,99.00,187,49,236,0.7923728813559322,0.2076271186440678,Yes,0.7923728813559322
37049,37049,99.00,126,30,156,0.8076923076923077,0.19230769230769232,Yes,0.8076923076923077
37050,37050,99.00,99,20,119,0.8319327731092437,0.16806722689075632,Yes,0.8319327731092437
37051,37051,99.00,0,0,0,0,0,n/a,0
37052,37052,99.00,117,29,146,0.8013698630136986,0.19863013698630136,Yes,0.8013698630136986
37053,37053,99.00,0,0,0,0,0,n/a,0
37054,37054,99.00,126,44,170,0.7411764705882353,0.25882352941176473,Yes,0.7411764705882353
37055,37055,99.00,0,1,1,0.0,1.0,No,1.0
37056,37056,99.00,188,31,219,0.8584474885844748,0.1415525114155251,Yes,0.8584474885844748
37057,37057,99.00,4,1,5,0.8,0.2,Yes,0.8
37058,37058,99.00,142,15,157,0.9044585987261147,0.09554140127388536,Yes,0.9044585987261147
37059,37059,99.00,127,21,148,0.8581081081081081,0.14189189189189189,Yes,0.8581081081081081
37060,37060,99.00,0,0,0,0,0,n/a,0
37061,37061,99.00,5,1,6,0.8333333333333334,0.16666666666666666,Yes,0.8333333333333334
37062,37062,99.00,81,27,108,0.75,0.25,Yes,0.75
37063,37063,99.00,7,2,9,0.7777777777777778,0.2222222222222222,Yes,0.7777777777777778
37064,37064,99.00,16,5,21,0.7619047619047619,0.23809523809523808,Yes,0.7619047619047619
37065,37065,99.00,331,70,401,0.8254364089775561,0.1745635910224439,Yes,0.8254364089775561
37066,37066,99.00,0,0,0,0,0,n/a,0
37067,37067,99.00,1,0,1,1.0,0.0,Yes,1.0
37068,37068,99.00,145,40,185,0.7837837837837838,0.21621621621621623,Yes,0.7837837837837838
37069,37069,99.00,0,0,0,0,0,n/a,0
37070,37070,99.00,0,0,0,0,0,n/a,0
37071,37071,99.00,0,0,0,0,0,n/a,0
37072,37072,99.00,0,0,0,0,0,n/a,0
37073,37073,99.00,0,0,0,0,0,n/a,0
37074,37074,99.00,0,0,0,0,0,n/a,0
37075,37075,99.00,143,52,195,0.7333333333333333,0.26666666666666666,Yes,0.7333333333333333
37076,37076,99.00,7,3,10,0.7,0.3,Yes,0.7
37077,37077,99.00,138,26,164,0.8414634146341463,0.15853658536585366,Yes,0.8414634146341463
37078,37078,99.00,195,48,243,0.8024691358024691,0.19753086419753085,Yes,0.8024691358024691
37079,37079,99.00,161,47,208,0.7740384615384616,0.22596153846153846,Yes,0.7740384615384616
37080,37080,99.00,142,42,184,0.7717391304347826,0.22826086956521738,Yes,0.7717391304347826
37081,37081,99.00,185,50,235,0.7872340425531915,0.2127659574468085,Yes,0.7872340425531915
37082,37082,80.00,139,28,167,0.8323353293413174,0.16766467065868262,Yes,0.8323353293413174
37083,37083,99.00,184,41,225,0.8177777777777778,0.18222222222222223,Yes,0.8177777777777778
37084,37084,99.00,87,16,103,0.8446601941747572,0.1553398058252427,Yes,0.8446601941747572
37085,37085,99.00,9,2,11,0.8181818181818182,0.18181818181818182,Yes,0.8181818181818182
37086,37086,99.00,3,0,3,1.0,0.0,Yes,1.0
37087,37087,99.00,213,49,262,0.8129770992366412,0.18702290076335878,Yes,0.8129770992366412
37088,37088,99.00,6,5,11,0.5454545454545454,0.45454545454545453,Yes,0.5454545454545454
38001,38001,99.00,62,21,83,0.7469879518072289,0.25301204819277107,Yes,0.7469879518072289
38002,38002,99.00,4,2,6,0.6666666666666666,0.3333333333333333,Yes,0.6666666666666666
38003,38003,99.00,84,11,95,0.8842105263157894,0.11578947368421053,Yes,0.8842105263157894
38004,38004,99.00,142,21,163,0.8711656441717791,0.12883435582822086,Yes,0.8711656441717791
38005,38005,99.00,100,14,114,0.8771929824561403,0.12280701754385964,Yes,0.8771929824561403
38006,38006,99.00,115,17,132,0.8712121212121212,0.12878787878787878,Yes,0.8712121212121212
38007,38007,99.00,77,10,87,0.8850574712643678,0.11494252873563218,Yes,0.8850574712643678
38008,38008,99.00,172,54,226,0.7610619469026548,0.23893805309734514,Yes,0.7610619469026548
38009,38009,99.00,85,28,113,0.7522123893805309,0.24778761061946902,Yes,0.7522123893805309
38010,38010,99.00,6,2,8,0.75,0.25,Yes,0.75
38011,38011,99.00,154,55,209,0.7368421052631579,0.2631578947368421,Yes,0.7368421052631579
38012,38012,99.00,1,1,2,0.5,0.5,Tie,0.5
38013,38013,99.00,6,0,6,1.0,0.0,Yes,1.0
38014,38014,99.00,179,52,231,0.7748917748917749,0.22510822510822512,Yes,0.7748917748917749
38015,38015,99.00,5,1,6,0.8333333333333334,0.16666666666666666,Yes,0.8333333333333334
38016,38016,99.00,112,49,161,0.6956521739130435,0.30434782608695654,Yes,0.6956521739130435
38017,38017,99.00,109,45,154,0.7077922077922078,0.2922077922077922,Yes,0.7077922077922078
38018,38018,99.00,88,44,132,0.6666666666666666,0.3333333333333333,Yes,0.6666666666666666
38019,38019,99.00,7,2,9,0.7777777777777778,0.2222222222222222,Yes,0.7777777777777778
38020,38020,99.00,1,3,4,0.25,0.75,No,0.75
38021,38021,60.00,0,0,0,0,0,n/a,0
38022,38022,99.00,167,58,225,0.7422222222222222,0.2577777777777778,Yes,0.7422222222222222
38023,38023,60.00,147,26,173,0.8497109826589595,0.15028901734104047,Yes,0.8497109826589595
38024,38024,60.00,89,13,102,0.8725490196078431,0.12745098039215685,Yes,0.8725490196078431
38025,38025,60.00,1,0,1,1.0,0.0,Yes,1.0
38026,38026,99.00,84,24,108,0.7777777777777778,0.2222222222222222,Yes,0.7777777777777778
38027,38027,99.00,104,23,127,0.8188976377952756,0.18110236220472442,Yes,0.8188976377952756
38028,38028,99.00,135,58,193,0.6994818652849741,0.3005181347150259,Yes,0.6994818652849741
38029,38029,99.00,0,1,1,0.0,1.0,No,1.0
38030,38030,99.00,56,12,68,0.8235294117647058,0.17647058823529413,Yes,0.8235294117647058
38031,38031,99.00,96,26,122,0.7868852459016393,0.21311475409836064,Yes,0.7868852459016393
38032,38032,99.00,126,22,148,0.8513513513513513,0.14864864864864866,Yes,0.8513513513513513
38033,38033,99.00,84,28,112,0.75,0.25,Yes,0.75
38034,38034,0.00,1,0,1,1.0,0.0,Yes,1.0
38035,38035,99.00,0,0,0,0,0,n/a,0
38036,38036,99.00,2,0,2,1.0,0.0,Yes,1.0
38037,38037,99.00,82,24,106,0.7735849056603774,0.22641509433962265,Yes,0.7735849056603774
38038,38038,99.00,54,17,71,0.7605633802816901,0.23943661971830985,Yes,0.7605633802816901
38039,38039,99.00,6,0,6,1.0,0.0,Yes,1.0
38040,38040,99.00,53,10,63,0.8412698412698413,0.15873015873015872,Yes,0.8412698412698413
38041,38041,99.00,88,13,101,0.8712871287128713,0.12871287128712872,Yes,0.8712871287128713
38042,38042,99.00,62,17,79,0.7848101265822784,0.21518987341772153,Yes,0.7848101265822784
38043,38043,99.00,79,12,91,0.8681318681318682,0.13186813186813187,Yes,0.8681318681318682
38044,38044,99.00,5,0,5,1.0,0.0,Yes,1.0
38045,38045,99.00,2,0,2,1.0,0.0,Yes,1.0
38046,38046,99.00,5,1,6,0.8333333333333334,0.16666666666666666,Yes,0.8333333333333334
38047,38047,99.00,120,41,161,0.7453416149068323,0.2546583850931677,Yes,0.7453416149068323
38048,38048,0.00,1,0,1,1.0,0.0,Yes,1.0
38049,38049,0.00,4,0,4,1.0,0.0,Yes,1.0
38050,38050,99.00,4,0,4,1.0,0.0,Yes,1.0
38051,38051,60.00,137,33,170,0.8058823529411765,0.19411764705882353,Yes,0.8058823529411765
38052,38052,60.00,1,0,1,1.0,0.0,Yes,1.0
38053,38053,60.00,0,0,0,0,0,n/a,0
38054,38054,60.00,78,38,116,0.6724137931034483,0.3275862068965517,Yes,0.6724137931034483
38055,38055,99.00,75,29,104,0.7211538461538461,0.27884615384615385,Yes,0.7211538461538461
38056,38056,99.00,101,20,121,0.8347107438016529,0.1652892561983471,Yes,0.8347107438016529
38057,38057,99.00,102,20,122,0.8360655737704918,0.16393442622950818,Yes,0.8360655737704918
38058,38058,99.00,104,15,119,0.8739495798319328,0.12605042016806722,Yes,0.8739495798319328
38059,38059,0.00,5,1,6,0.8333333333333334,0.16666666666666666,Yes,0.8333333333333334
38060,38060,60.00,0,0,0,0,0,n/a,0
38061,38061,99.00,0,0,0,0,0,n/a,0
38062,38062,99.00,120,13,133,0.9022556390977443,0.09774436090225563,Yes,0.9022556390977443
38063,38063,99.00,59,16,75,0.7866666666666666,0.21333333333333335,Yes,0.7866666666666666
38064,38064,99.00,81,18,99,0.8181818181818182,0.18181818181818182,Yes,0.8181818181818182
38065,38065,99.00,2,0,2,1.0,0.0,Yes,1.0
38066,38066,99.00,1,3,4,0.25,0.75,No,0.75
38067,38067,99.00,2,1,3,0.6666666666666666,0.3333333333333333,Yes,0.6666666666666666
38068,38068,99.00,1,0,1,1.0,0.0,Yes,1.0
38069,38069,99.00,6,0,6,1.0,0.0,Yes,1.0
38070,38070,99.00,48,18,66,0.7272727272727273,0.2727272727272727,Yes,0.7272727272727273
38071,38071,0.00,1,1,2,0.5,0.5,Tie,0.5
39001,39001,99.00,107,31,138,0.7753623188405797,0.2246376811594203,Yes,0.7753623188405797
39002,39002,99.00,95,12,107,0.8878504672897196,0.11214953271028037,Yes,0.8878504672897196
39003,39003,99.00,123,21,144,0.8541666666666666,0.14583333333333334,Yes,0.8541666666666666
39004,39004,99.00,80,10,90,0.8888888888888888,0.1111111111111111,Yes,0.8888888888888888
39005,39005,99.00,88,19,107,0.822429906542056,0.17757009345794392,Yes,0.822429906542056
39006,39006,99.00,2,0,2,1.0,0.0,Yes,1.0
39007,39007,99.00,137,23,160,0.85625,0.14375,Yes,0.85625
39008,39008,99.00,0,0,0,0,0,n/a,0
39009,39009,99.00,78,13,91,0.8571428571428571,0.14285714285714285,Yes,0.8571428571428571
39010,39010,99.00,109,21,130,0.8384615384615385,0.16153846153846155,Yes,0.8384615384615385
39011,39011,99.00,60,8,68,0.8823529411764706,0.11764705882352941,Yes,0.8823529411764706
39012,39012,99.00,52,14,66,0.7878787878787878,0.21212121212121213,Yes,0.7878787878787878
39013,39013,99.00,77,12,89,0.8651685393258427,0.1348314606741573,Yes,0.8651685393258427
39014,39014,99.00,47,14,61,0.7704918032786885,0.22950819672131148,Yes,0.7704918032786885
39015,39015,20.00,24,5,29,0.8275862068965517,0.1724137931034483,Yes,0.8275862068965517
39016,39016,20.00,19,1,20,0.95,0.05,Yes,0.95
39017,39017,20.00,21,1,22,0.9545454545454546,0.045454545454545456,Yes,0.9545454545454546
39018,39018,99.00,128,37,165,0.7757575757575758,0.22424242424242424,Yes,0.7757575757575758
39019,39019,99.00,247,56,303,0.8151815181518152,0.1848184818481848,Yes,0.8151815181518152
39020,39020,99.00,0,0,0,0,0,n/a,0
39021,39021,99.00,0,0,0,0,0,n/a,0
39022,39022,99.00,1,1,2,0.5,0.5,Tie,0.5
39023,39023,20.00,22,4,26,0.8461538461538461,0.15384615384615385,Yes,0.8461538461538461
39024,39024,99.00,59,15,74,0.7972972972972973,0.20270270270270271,Yes,0.7972972972972973
39025,39025,99.00,65,13,78,0.8333333333333334,0.16666666666666666,Yes,0.8333333333333334
39026,39026,20.00,2,0,2,1.0,0.0,Yes,1.0
39027,39027,20.00,3,0,3,1.0,0.0,Yes,1.0
39028,39028,20.00,0,0,0,0,0,n/a,0
39029,39029,99.00,57,9,66,0.8636363636363636,0.13636363636363635,Yes,0.8636363636363636
39030,39030,99.00,118,12,130,0.9076923076923077,0.09230769230769231,Yes,0.9076923076923077
39031,39031,99.00,90,23,113,0.7964601769911505,0.20353982300884957,Yes,0.7964601769911505
39032,39032,99.00,0,0,0,0,0,n/a,0
39033,39033,99.00,5,0,5,1.0,0.0,Yes,1.0
39034,39034,99.00,65,12,77,0.8441558441558441,0.15584415584415584,Yes,0.8441558441558441
39035,39035,99.00,1,0,1,1.0,0.0,Yes,1.0
39036,39036,99.00,0,0,0,0,0,n/a,0
39037,39037,99.00,90,10,100,0.9,0.1,Yes,0.9
39038,39038,99.00,2,0,2,1.0,0.0,Yes,1.0
39039,39039,99.00,0,0,0,0,0,n/a,0
39040,39040,99.00,0,0,0,0,0,n/a,0
39041,39041,99.00,3,0,3,1.0,0.0,Yes,1.0
39042,39042,99.00,0,0,0,0,0,n/a,0
39043,39043,99.00,139,28,167,0.8323353293413174,0.16766467065868262,Yes,0.8323353293413174
39044,39044,99.00,6,1,7,0.8571428571428571,0.14285714285714285,Yes,0.8571428571428571
39045,39045,99.00,371,101,472,0.7860169491525424,0.21398305084745764,Yes,0.7860169491525424
39046,39046,99.00,6,1,7,0.8571428571428571,0.14285714285714285,Yes,0.8571428571428571
39047,39047,99.00,185,47,232,0.7974137931034483,0.2025862068965517,Yes,0.7974137931034483
39048,39048,99.00,109,18,127,0.8582677165354331,0.14173228346456693,Yes,0.8582677165354331
39049,39049,99.00,73,20,93,0.7849462365591398,0.21505376344086022,Yes,0.7849462365591398
39050,39050,99.00,1,0,1,1.0,0.0,Yes,1.0
39051,39051,99.00,190,40,230,0.8260869565217391,0.17391304347826086,Yes,0.8260869565217391
39052,39052,99.00,0,0,0,0,0,n/a,0
39053,39053,99.00,1,0,1,1.0,0.0,Yes,1.0
39054,39054,99.00,2,0,2,1.0,0.0,Yes,1.0
39055,39055,99.00,2,0,2,1.0,0.0,Yes,1.0
39056,39056,99.00,175,45,220,0.7954545454545454,0.20454545454545456,Yes,0.7954545454545454
40001,40001,99.00,7,1,8,0.875,0.125,Yes,0.875
40002,40002,99.00,152,65,217,0.7004608294930875,0.2995391705069124,Yes,0.7004608294930875
40003,40003,99.00,6,0,6,1.0,0.0,Yes,1.0
40004,40004,99.00,195,92,287,0.6794425087108014,0.3205574912891986,Yes,0.6794425087108014
40005,40005,99.00,141,96,237,0.5949367088607594,0.4050632911392405,Yes,0.5949367088607594
40006,40006,99.00,115,63,178,0.6460674157303371,0.3539325842696629,Yes,0.6460674157303371
40007,40007,99.00,5,5,10,0.5,0.5,Tie,0.5
40008,40008,99.00,6,2,8,0.75,0.25,Yes,0.75
40009,40009,99.00,181,61,242,0.7479338842975206,0.25206611570247933,Yes,0.7479338842975206
40010,40010,99.00,0,0,0,0,0,n/a,0
40011,40011,99.00,2,0,2,1.0,0.0,Yes,1.0
40012,40012,99.00,2,0,2,1.0,0.0,Yes,1.0
40013,40013,99.00,160,70,230,0.6956521739130435,0.30434782608695654,Yes,0.6956521739130435
40014,40014,99.00,3,0,3,1.0,0.0,Yes,1.0
40015,40015,99.00,157,39,196,0.8010204081632653,0.1989795918367347,Yes,0.8010204081632653
40016,40016,99.00,169,49,218,0.7752293577981652,0.22477064220183487,Yes,0.7752293577981652
40017,40017,99.00,5,0,5,1.0,0.0,Yes,1.0
40018,40018,99.00,1,0,1,1.0,0.0,Yes,1.0
40019,40019,99.00,77,16,93,0.8279569892473119,0.17204301075268819,Yes,0.8279569892473119
40020,40020,99.00,122,17,139,0.8776978417266187,0.1223021582733813,Yes,0.8776978417266187
40021,40021,99.00,80,21,101,0.7920792079207921,0.2079207920792079,Yes,0.7920792079207921
40022,40022,99.00,115,33,148,0.777027027027027,0.22297297297297297,Yes,0.777027027027027
40023,40023,99.00,116,31,147,0.7891156462585034,0.2108843537414966,Yes,0.7891156462585034
40024,40024,99.00,4,0,4,1.0,0.0,Yes,1.0
40025,40025,99.00,77,11,88,0.875,0.125,Yes,0.875
40026,40026,99.00,121,31,152,0.7960526315789473,0.20394736842105263,Yes,0.7960526315789473
40027,40027,99.00,122,23,145,0.8413793103448276,0.15862068965517243,Yes,0.8413793103448276
40028,40028,99.00,4,0,4,1.0,0.0,Yes,1.0
40029,40029,99.00,4,1,5,0.8,0.2,Yes,0.8
40030,40030,99.00,115,46,161,0.7142857142857143,0.2857142857142857,Yes,0.7142857142857143
40031,40031,99.00,112,25,137,0.8175182481751825,0.18248175182481752,Yes,0.8175182481751825
40032,40032,99.00,99,32,131,0.7557251908396947,0.24427480916030533,Yes,0.7557251908396947
40033,40033,99.00,10,4,14,0.7142857142857143,0.2857142857142857,Yes,0.7142857142857143
40034,40034,99.00,112,36,148,0.7567567567567568,0.24324324324324326,Yes,0.7567567567567568
40035,40035,99.00,76,12,88,0.8636363636363636,0.13636363636363635,Yes,0.8636363636363636
40036,40036,99.00,117,29,146,0.8013698630136986,0.19863013698630136,Yes,0.8013698630136986
40037,40037,99.00,90,19,109,0.8256880733944955,0.1743119266055046,Yes,0.8256880733944955
40038,40038,99.00,4,1,5,0.8,0.2,Yes,0.8
40039,40039,99.00,97,21,118,0.8220338983050848,0.17796610169491525,Yes,0.8220338983050848
40040,40040,99.00,104,15,119,0.8739495798319328,0.12605042016806722,Yes,0.8739495798319328
40041,40041,99.00,0,2,2,0.0,1.0,No,1.0
40042,40042,99.00,5,0,5,1.0,0.0,Yes,1.0
40043,40043,99.00,52,16,68,0.7647058823529411,0.23529411764705882,Yes,0.7647058823529411
40044,40044,99.00,3,2,5,0.6,0.4,Yes,0.6
40045,40045,99.00,50,9,59,0.847457627118644,0.15254237288135594,Yes,0.847457627118644
40046,40046,99.00,47,12,59,0.7966101694915254,0.2033898305084746,Yes,0.7966101694915254
40047,40047,99.00,6,1,7,0.8571428571428571,0.14285714285714285,Yes,0.8571428571428571
40048,40048,99.00,176,43,219,0.8036529680365296,0.1963470319634703,Yes,0.8036529680365296
40049,40049,99.00,2,0,2,1.0,0.0,Yes,1.0
40050,40050,99.00,110,19,129,0.8527131782945736,0.14728682170542637,Yes,0.8527131782945736
40051,40051,99.00,81,28,109,0.7431192660550459,0.25688073394495414,Yes,0.7431192660550459
40052,40052,99.00,1,0,1,1.0,0.0,Yes,1.0
40053,40053,99.00,3,0,3,1.0,0.0,Yes,1.0
40054,40054,99.00,0,0,0,0,0,n/a,0
40055,40055,99.00,0,0,0,0,0,n/a,0
40056,40056,99.00,8,0,8,1.0,0.0,Yes,1.0
40057,40057,99.00,94,19,113,0.831858407079646,0.168141592920354,Yes,0.831858407079646
40058,40058,99.00,7,0,7,1.0,0.0,Yes,1.0
40059,40059,99.00,0,0,0,0,0,n/a,0
40060,40060,99.00,54,19,73,0.7397260273972602,0.2602739726027397,Yes,0.7397260273972602
61001,61001,99.00,158,47,205,0.7707317073170732,0.22926829268292684,Yes,0.7707317073170732
61002,61002,99.00,192,41,233,0.8240343347639485,0.1759656652360515,Yes,0.8240343347639485
61003,61003,99.00,237,56,293,0.8088737201365188,0.19112627986348124,Yes,0.8088737201365188
61004,61004,99.00,226,53,279,0.8100358422939068,0.18996415770609318,Yes,0.8100358422939068
61005,61005,99.00,7,3,10,0.7,0.3,Yes,0.7
61006,61006,99.00,111,33,144,0.7708333333333334,0.22916666666666666,Yes,0.7708333333333334
61007,61007,99.00,81,21,102,0.7941176470588235,0.20588235294117646,Yes,0.7941176470588235
61008,61008,99.00,160,25,185,0.8648648648648649,0.13513513513513514,Yes,0.8648648648648649
61009,61009,99.00,355,95,450,0.7888888888888889,0.2111111111111111,Yes,0.7888888888888889
61010,61010,99.00,133,32,165,0.806060606060606,0.19393939393939394,Yes,0.806060606060606
61011,61011,99.00,11,2,13,0.8461538461538461,0.15384615384615385,Yes,0.8461538461538461
61012,61012,99.00,257,127,384,0.6692708333333334,0.3307291666666667,Yes,0.6692708333333334
61013,61013,99.00,143,35,178,0.8033707865168539,0.19662921348314608,Yes,0.8033707865168539
61014,61014,99.00,145,74,219,0.6621004566210046,0.3378995433789954,Yes,0.6621004566210046
61015,61015,99.00,115,42,157,0.732484076433121,0.267515923566879,Yes,0.732484076433121
61016,61016,99.00,93,27,120,0.775,0.225,Yes,0.775
61017,61017,75.00,103,29,132,0.7803030303030303,0.2196969696969697,Yes,0.7803030303030303
61018,61018,99.00,246,130,376,0.6542553191489362,0.34574468085106386,Yes,0.6542553191489362
61019,61019,75.00,152,42,194,0.7835051546391752,0.21649484536082475,Yes,0.7835051546391752
61020,61020,75.00,127,51,178,0.7134831460674157,0.28651685393258425,Yes,0.7134831460674157
61021,61021,99.00,128,25,153,0.8366013071895425,0.16339869281045752,Yes,0.8366013071895425
61022,61022,99.00,127,31,158,0.8037974683544303,0.1962025316455696,Yes,0.8037974683544303
61023,61023,99.00,111,26,137,0.8102189781021898,0.1897810218978102,Yes,0.8102189781021898
61024,61024,99.00,116,56,172,0.6744186046511628,0.32558139534883723,Yes,0.6744186046511628
61025,61025,99.00,109,42,151,0.7218543046357616,0.2781456953642384,Yes,0.7218543046357616
61026,61026,50.00,111,23,134,0.8283582089552238,0.17164179104477612,Yes,0.8283582089552238
61027,61027,50.00,106,30,136,0.7794117647058824,0.22058823529411764,Yes,0.7794117647058824
61028,61028,99.00,170,57,227,0.748898678414097,0.2511013215859031,Yes,0.748898678414097
61029,61029,99.00,16,2,18,0.8888888888888888,0.1111111111111111,Yes,0.8888888888888888
61030,61030,99.00,106,50,156,0.6794871794871795,0.32051282051282054,Yes,0.6794871794871795
61031,61031,50.00,96,23,119,0.8067226890756303,0.19327731092436976,Yes,0.8067226890756303
61032,61032,50.00,82,19,101,0.8118811881188119,0.18811881188118812,Yes,0.8118811881188119
61033,61033,62.50,107,25,132,0.8106060606060606,0.1893939393939394,Yes,0.8106060606060606
61034,61034,99.00,273,170,443,0.6162528216704289,0.3837471783295711,Yes,0.6162528216704289
61035,61035,99.00,178,117,295,0.6033898305084746,0.39661016949152544,Yes,0.6033898305084746
61036,61036,99.00,12,1,13,0.9230769230769231,0.07692307692307693,Yes,0.9230769230769231
61037,61037,57.14,299,123,422,0.7085308056872038,0.2914691943127962,Yes,0.7085308056872038
61038,61038,57.14,207,105,312,0.6634615384615384,0.33653846153846156,Yes,0.6634615384615384
61039,61039,57.14,31,16,47,0.6595744680851063,0.3404255319148936,Yes,0.6595744680851063
61040,61040,57.14,275,144,419,0.6563245823389021,0.3436754176610978,Yes,0.6563245823389021
61041,61041,99.00,7,2,9,0.7777777777777778,0.2222222222222222,Yes,0.7777777777777778
61042,61042,99.00,214,110,324,0.6604938271604939,0.3395061728395062,Yes,0.6604938271604939
61043,61043,99.00,261,167,428,0.6098130841121495,0.3901869158878505,Yes,0.6098130841121495
61044,61044,99.00,242,167,409,0.5916870415647921,0.4083129584352078,Yes,0.5916870415647921
61045,61045,99.00,3,2,5,0.6,0.4,Yes,0.6
61046,61046,99.00,3,0,3,1.0,0.0,Yes,1.0
61047,61047,99.00,2,0,2,1.0,0.0,Yes,1.0
61048,61048,99.00,238,176,414,0.5748792270531401,0.4251207729468599,Yes,0.5748792270531401
61049,61049,99.00,175,32,207,0.8454106280193237,0.15458937198067632,Yes,0.8454106280193237
61050,61050,99.00,147,46,193,0.7616580310880829,0.23834196891191708,Yes,0.7616580310880829
61051,61051,99.00,26,1,27,0.9629629629629629,0.037037037037037035,Yes,0.9629629629629629
61052,61052,99.00,145,50,195,0.7435897435897436,0.2564102564102564,Yes,0.7435897435897436
61053,61053,99.00,92,22,114,0.8070175438596491,0.19298245614035087,Yes,0.8070175438596491
61054,61054,99.00,72,11,83,0.8674698795180723,0.13253012048192772,Yes,0.8674698795180723
61055,61055,99.00,111,13,124,0.8951612903225806,0.10483870967741936,Yes,0.8951612903225806
61056,61056,99.00,91,22,113,0.8053097345132744,0.19469026548672566,Yes,0.8053097345132744
61057,61057,99.00,138,38,176,0.7840909090909091,0.2159090909090909,Yes,0.7840909090909091
61058,61058,62.50,149,24,173,0.861271676300578,0.13872832369942195,Yes,0.861271676300578
61059,61059,62.50,8,2,10,0.8,0.2,Yes,0.8
61060,61060,62.50,93,35,128,0.7265625,0.2734375,Yes,0.7265625
61061,61061,62.50,79,13,92,0.8586956521739131,0.14130434782608695,Yes,0.8586956521739131
61062,61062,99.00,107,55,162,0.6604938271604939,0.3395061728395062,Yes,0.6604938271604939
61063,61063,99.00,27,16,43,0.627906976744186,0.37209302325581395,Yes,0.627906976744186
61064,61064,99.00,7,2,9,0.7777777777777778,0.2222222222222222,Yes,0.7777777777777778
61065,61065,99.00,117,36,153,0.7647058823529411,0.23529411764705882,Yes,0.7647058823529411
61066,61066,99.00,145,48,193,0.7512953367875648,0.24870466321243523,Yes,0.7512953367875648
61067,61067,99.00,107,35,142,0.7535211267605634,0.24647887323943662,Yes,0.7535211267605634
61068,61068,99.00,99,34,133,0.7443609022556391,0.2556390977443609,Yes,0.7443609022556391
61069,61069,99.00,91,13,104,0.875,0.125,Yes,0.875
61070,61070,99.00,85,11,96,0.8854166666666666,0.11458333333333333,Yes,0.8854166666666666
61071,61071,99.00,9,0,9,1.0,0.0,Yes,1.0
61072,61072,57.14,27,7,34,0.7941176470588235,0.20588235294117646,Yes,0.7941176470588235
61073,61073,62.50,84,11,95,0.8842105263157894,0.11578947368421053,Yes,0.8842105263157894
61074,61074,99.00,7,1,8,0.875,0.125,Yes,0.875
61075,61075,99.00,85,24,109,0.7798165137614679,0.22018348623853212,Yes,0.7798165137614679
61076,61076,99.00,123,57,180,0.6833333333333333,0.31666666666666665,Yes,0.6833333333333333
61077,61077,99.00,11,0,11,1.0,0.0,Yes,1.0
61078,61078,99.00,5,2,7,0.7142857142857143,0.2857142857142857,Yes,0.7142857142857143
61079,61079,99.00,0,0,0,0,0,n/a,0
62001,62001,99.00,117,77,194,0.6030927835051546,0.39690721649484534,Yes,0.6030927835051546
62002,62002,99.00,171,106,277,0.6173285198555957,0.38267148014440433,Yes,0.6173285198555957
62003,62003,57.14,145,115,260,0.5576923076923077,0.4423076923076923,Yes,0.5576923076923077
62004,62004,99.00,125,86,211,0.5924170616113744,0.4075829383886256,Yes,0.5924170616113744
62005,62005,57.14,108,65,173,0.6242774566473989,0.37572254335260113,Yes,0.6242774566473989
62006,62006,99.00,124,73,197,0.6294416243654822,0.37055837563451777,Yes,0.6294416243654822
62007,62007,57.14,113,105,218,0.518348623853211,0.481651376146789,Yes,0.518348623853211
62008,62008,0.00,10,5,15,0.6666666666666666,0.3333333333333333,Yes,0.6666666666666666
62009,62009,50.00,30,12,42,0.7142857142857143,0.2857142857142857,Yes,0.7142857142857143
62010,62010,57.14,13,13,26,0.5,0.5,Tie,0.5
62011,62011,0.00,13,3,16,0.8125,0.1875,Yes,0.8125
62012,62012,99.00,136,105,241,0.5643153526970954,0.43568464730290457,Yes,0.5643153526970954
62013,62013,99.00,161,109,270,0.5962962962962963,0.40370370370370373,Yes,0.5962962962962963
62014,62014,99.00,1,3,4,0.25,0.75,No,0.75
62015,62015,99.00,157,125,282,0.5567375886524822,0.4432624113475177,Yes,0.5567375886524822
62016,62016,99.00,151,128,279,0.5412186379928315,0.45878136200716846,Yes,0.5412186379928315
62017,62017,99.00,2,4,6,0.3333333333333333,0.6666666666666666,No,0.6666666666666666
62018,62018,99.00,4,0,4,1.0,0.0,Yes,1.0
62019,62019,99.00,1,6,7,0.14285714285714285,0.8571428571428571,No,0.8571428571428571
62020,62020,66.67,174,137,311,0.5594855305466238,0.4405144694533762,Yes,0.5594855305466238
62021,62021,66.67,166,105,271,0.6125461254612546,0.3874538745387454,Yes,0.6125461254612546
62022,62022,66.67,177,161,338,0.5236686390532544,0.47633136094674555,Yes,0.5236686390532544
62023,62023,66.67,11,12,23,0.4782608695652174,0.5217391304347826,No,0.5217391304347826
62024,62024,66.67,16,5,21,0.7619047619047619,0.23809523809523808,Yes,0.7619047619047619
62025,62025,66.67,20,7,27,0.7407407407407407,0.25925925925925924,Yes,0.7407407407407407
62026,62026,99.00,115,56,171,0.672514619883041,0.32748538011695905,Yes,0.672514619883041
62027,62027,99.00,129,87,216,0.5972222222222222,0.4027777777777778,Yes,0.5972222222222222
62028,62028,99.00,99,67,166,0.5963855421686747,0.4036144578313253,Yes,0.5963855421686747
62029,62029,0.00,6,0,6,1.0,0.0,Yes,1.0
62030,62030,0.00,12,3,15,0.8,0.2,Yes,0.8
62031,62031,0.00,13,12,25,0.52,0.48,Yes,0.52
62032,62032,99.00,103,69,172,0.5988372093023255,0.4011627906976744,Yes,0.5988372093023255
62033,62033,99.00,103,67,170,0.6058823529411764,0.3941176470588235,Yes,0.6058823529411764
62034,62034,99.00,104,82,186,0.5591397849462365,0.44086021505376344,Yes,0.5591397849462365
62035,62035,99.00,209,144,353,0.5920679886685553,0.40793201133144474,Yes,0.5920679886685553
62036,62036,99.00,10,7,17,0.5882352941176471,0.4117647058823529,Yes,0.5882352941176471
62037,62037,99.00,135,106,241,0.5601659751037344,0.43983402489626555,Yes,0.5601659751037344
62038,62038,99.00,165,98,263,0.6273764258555133,0.3726235741444867,Yes,0.6273764258555133
62039,62039,99.00,113,120,233,0.48497854077253216,0.5150214592274678,No,0.5150214592274678
62040,62040,99.00,119,74,193,0.616580310880829,0.38341968911917096,Yes,0.616580310880829
62041,62041,99.00,129,78,207,0.6231884057971014,0.37681159420289856,Yes,0.6231884057971014
62042,62042,99.00,124,94,218,0.5688073394495413,0.43119266055045874,Yes,0.5688073394495413
62043,62043,99.00,122,87,209,0.583732057416268,0.41626794258373206,Yes,0.583732057416268
62044,62044,99.00,156,141,297,0.5252525252525253,0.47474747474747475,Yes,0.5252525252525253
62045,62045,99.00,6,3,9,0.6666666666666666,0.3333333333333333,Yes,0.6666666666666666
62046,62046,99.00,102,90,192,0.53125,0.46875,Yes,0.53125
62047,62047,99.00,165,155,320,0.515625,0.484375,Yes,0.515625
62048,62048,99.00,92,62,154,0.5974025974025974,0.4025974025974026,Yes,0.5974025974025974
62049,62049,99.00,134,91,225,0.5955555555555555,0.40444444444444444,Yes,0.5955555555555555
62050,62050,99.00,129,100,229,0.5633187772925764,0.4366812227074236,Yes,0.5633187772925764
62051,62051,99.00,102,74,176,0.5795454545454546,0.42045454545454547,Yes,0.5795454545454546
62052,62052,99.00,124,90,214,0.5794392523364486,0.4205607476635514,Yes,0.5794392523364486
62053,62053,99.00,127,86,213,0.596244131455399,0.40375586854460094,Yes,0.596244131455399
62054,62054,99.00,102,61,163,0.6257668711656442,0.37423312883435583,Yes,0.6257668711656442
62055,62055,99.00,122,87,209,0.583732057416268,0.41626794258373206,Yes,0.583732057416268
62056,62056,99.00,110,66,176,0.625,0.375,Yes,0.625
62057,62057,99.00,101,78,179,0.5642458100558659,0.43575418994413406,Yes,0.5642458100558659
62058,62058,99.00,116,74,190,0.6105263157894737,0.3894736842105263,Yes,0.6105263157894737
62059,62059,99.00,77,78,155,0.4967741935483871,0.5032258064516129,No,0.5032258064516129
62060,62060,99.00,126,88,214,0.5887850467289719,0.411214953271028,Yes,0.5887850467289719
62061,62061,99.00,136,91,227,0.5991189427312775,0.4008810572687225,Yes,0.5991189427312775
62062,62062,99.00,114,83,197,0.5786802030456852,0.4213197969543147,Yes,0.5786802030456852
62063,62063,99.00,183,138,321,0.5700934579439252,0.42990654205607476,Yes,0.5700934579439252
62064,62064,99.00,78,31,109,0.7155963302752294,0.28440366972477066,Yes,0.7155963302752294
62065,62065,99.00,150,92,242,0.6198347107438017,0.38016528925619836,Yes,0.6198347107438017
62066,62066,99.00,239,133,372,0.6424731182795699,0.3575268817204301,Yes,0.6424731182795699
62067,62067,99.00,207,158,365,0.5671232876712329,0.4328767123287671,Yes,0.5671232876712329
62068,62068,99.00,215,135,350,0.6142857142857143,0.38571428571428573,Yes,0.6142857142857143
62069,62069,99.00,19,6,25,0.76,0.24,Yes,0.76
62070,62070,99.00,65,31,96,0.6770833333333334,0.3229166666666667,Yes,0.6770833333333334
62071,62071,99.00,16,3,19,0.8421052631578947,0.15789473684210525,Yes,0.8421052631578947
62072,62072,99.00,102,43,145,0.7034482758620689,0.296551724137931,Yes,0.7034482758620689
62073,62073,99.00,13,3,16,0.8125,0.1875,Yes,0.8125
62074,62074,99.00,141,102,243,0.5802469135802469,0.41975308641975306,Yes,0.5802469135802469
62075,62075,66.67,105,51,156,0.6730769230769231,0.3269230769230769,Yes,0.6730769230769231
62076,62076,57.14,108,79,187,0.5775401069518716,0.42245989304812837,Yes,0.5775401069518716
62077,62077,99.00,102,90,192,0.53125,0.46875,Yes,0.53125
62078,62078,0.00,3,4,7,0.42857142857142855,0.5714285714285714,No,0.5714285714285714
62079,62079,99.00,144,116,260,0.5538461538461539,0.4461538461538462,Yes,0.5538461538461539
62080,62080,99.00,87,47,134,0.6492537313432836,0.35074626865671643,Yes,0.6492537313432836
62081,62081,99.00,88,66,154,0.5714285714285714,0.42857142857142855,Yes,0.5714285714285714
62082,62082,99.00,15,5,20,0.75,0.25,Yes,0.75
62083,62083,66.67,73,87,160,0.45625,0.54375,No,0.54375
62084,62084,99.00,120,87,207,0.5797101449275363,0.42028985507246375,Yes,0.5797101449275363
62085,62085,99.00,6,1,7,0.8571428571428571,0.14285714285714285,Yes,0.8571428571428571
62086,62086,99.00,0,2,2,0.0,1.0,No,1.0
62087,62087,99.00,0,0,0,0,0,n/a,0
62088,62088,99.00,0,0,0,0,0,n/a,0
63001,63001,99.00,200,116,316,0.6329113924050633,0.3670886075949367,Yes,0.6329113924050633
63002,63002,99.00,102,54,156,0.6538461538461539,0.34615384615384615,Yes,0.6538461538461539
63003,63003,99.00,11,1,12,0.9166666666666666,0.08333333333333333,Yes,0.9166666666666666
63004,63004,99.00,81,65,146,0.5547945205479452,0.4452054794520548,Yes,0.5547945205479452
63005,63005,99.00,159,110,269,0.5910780669144982,0.40892193308550184,Yes,0.5910780669144982
63006,63006,99.00,7,6,13,0.5384615384615384,0.46153846153846156,Yes,0.5384615384615384
63007,63007,0.00,1,2,3,0.3333333333333333,0.6666666666666666,No,0.6666666666666666
63008,63008,99.00,91,50,141,0.6453900709219859,0.3546099290780142,Yes,0.6453900709219859
63009,63009,99.00,10,3,13,0.7692307692307693,0.23076923076923078,Yes,0.7692307692307693
63010,63010,99.00,135,41,176,0.7670454545454546,0.23295454545454544,Yes,0.7670454545454546
63011,63011,99.00,164,80,244,0.6721311475409836,0.32786885245901637,Yes,0.6721311475409836
63012,63012,99.00,3,1,4,0.75,0.25,Yes,0.75
63013,63013,99.00,103,64,167,0.6167664670658682,0.38323353293413176,Yes,0.6167664670658682
63014,63014,99.00,85,28,113,0.7522123893805309,0.24778761061946902,Yes,0.7522123893805309
63015,63015,99.00,90,60,150,0.6,0.4,Yes,0.6
63016,63016,99.00,137,80,217,0.631336405529954,0.3686635944700461,Yes,0.631336405529954
63017,63017,99.00,1,0,1,1.0,0.0,Yes,1.0
63018,63018,99.00,204,128,332,0.6144578313253012,0.3855421686746988,Yes,0.6144578313253012
63019,63019,99.00,5,0,5,1.0,0.0,Yes,1.0
63020,63020,99.00,70,63,133,0.5263157894736842,0.47368421052631576,Yes,0.5263157894736842
63021,63021,99.00,62,41,103,0.6019417475728155,0.39805825242718446,Yes,0.6019417475728155
63022,63022,99.00,104,39,143,0.7272727272727273,0.2727272727272727,Yes,0.7272727272727273
63023,63023,99.00,74,43,117,0.6324786324786325,0.36752136752136755,Yes,0.6324786324786325
63024,63024,99.00,146,112,258,0.5658914728682171,0.43410852713178294,Yes,0.5658914728682171
63025,63025,99.00,5,2,7,0.7142857142857143,0.2857142857142857,Yes,0.7142857142857143
63026,63026,99.00,99,86,185,0.5351351351351351,0.4648648648648649,Yes,0.5351351351351351
63027,63027,99.00,133,104,237,0.5611814345991561,0.4388185654008439,Yes,0.5611814345991561
63028,63028,99.00,4,0,4,1.0,0.0,Yes,1.0
63029,63029,99.00,189,125,314,0.6019108280254777,0.3980891719745223,Yes,0.6019108280254777
63030,63030,99.00,89,46,135,0.6592592592592592,0.34074074074074073,Yes,0.6592592592592592
63031,63031,99.00,142,50,192,0.7395833333333334,0.2604166666666667,Yes,0.7395833333333334
63032,63032,99.00,94,52,146,0.6438356164383562,0.3561643835616438,Yes,0.6438356164383562
63033,63033,99.00,139,83,222,0.6261261261261262,0.3738738738738739,Yes,0.6261261261261262
63034,63034,99.00,90,81,171,0.5263157894736842,0.47368421052631576,Yes,0.5263157894736842
63035,63035,99.00,133,104,237,0.5611814345991561,0.4388185654008439,Yes,0.5611814345991561
63036,63036,99.00,157,93,250,0.628,0.372,Yes,0.628
63037,63037,99.00,147,40,187,0.786096256684492,0.21390374331550802,Yes,0.786096256684492
63038,63038,99.00,122,36,158,0.7721518987341772,0.22784810126582278,Yes,0.7721518987341772
63039,63039,99.00,78,15,93,0.8387096774193549,0.16129032258064516,Yes,0.8387096774193549
63040,63040,99.00,3,1,4,0.75,0.25,Yes,0.75
63041,63041,50.00,66,5,71,0.9295774647887324,0.07042253521126761,Yes,0.9295774647887324
63042,63042,99.00,66,13,79,0.8354430379746836,0.16455696202531644,Yes,0.8354430379746836
63043,63043,99.00,106,24,130,0.8153846153846154,0.18461538461538463,Yes,0.8153846153846154
63044,63044,99.00,105,23,128,0.8203125,0.1796875,Yes,0.8203125
63045,63045,99.00,80,13,93,0.8602150537634409,0.13978494623655913,Yes,0.8602150537634409
63046,63046,99.00,209,122,331,0.6314199395770392,0.3685800604229607,Yes,0.6314199395770392
63047,63047,99.00,7,1,8,0.875,0.125,Yes,0.875
63048,63048,99.00,103,56,159,0.6477987421383647,0.3522012578616352,Yes,0.6477987421383647
63049,63049,99.00,191,148,339,0.5634218289085545,0.4365781710914454,Yes,0.5634218289085545
63050,63050,99.00,105,48,153,0.6862745098039216,0.3137254901960784,Yes,0.6862745098039216
63051,63051,99.00,5,5,10,0.5,0.5,Tie,0.5
63052,63052,99.00,138,74,212,0.6509433962264151,0.3490566037735849,Yes,0.6509433962264151
63053,63053,99.00,111,54,165,0.6727272727272727,0.32727272727272727,Yes,0.6727272727272727
63054,63054,99.00,107,61,168,0.6369047619047619,0.3630952380952381,Yes,0.6369047619047619
63055,63055,99.00,94,48,142,0.6619718309859155,0.3380281690140845,Yes,0.6619718309859155
63056,63056,99.00,0,2,2,0.0,1.0,No,1.0
63057,63057,99.00,180,155,335,0.5373134328358209,0.4626865671641791,Yes,0.5373134328358209
63058,63058,99.00,82,82,164,0.5,0.5,Tie,0.5
63059,63059,99.00,192,131,323,0.5944272445820433,0.4055727554179567,Yes,0.5944272445820433
63060,63060,99.00,5,1,6,0.8333333333333334,0.16666666666666666,Yes,0.8333333333333334
63061,63061,57.14,157,63,220,0.7136363636363636,0.2863636363636364,Yes,0.7136363636363636
63062,63062,99.00,196,99,295,0.6644067796610169,0.33559322033898303,Yes,0.6644067796610169
63063,63063,99.00,177,96,273,0.6483516483516484,0.3516483516483517,Yes,0.6483516483516484
63064,63064,99.00,308,184,492,0.6260162601626016,0.37398373983739835,Yes,0.6260162601626016
63065,63065,99.00,141,87,228,0.618421052631579,0.3815789473684211,Yes,0.618421052631579
63066,63066,99.00,6,2,8,0.75,0.25,Yes,0.75
63067,63067,99.00,149,106,255,0.5843137254901961,0.41568627450980394,Yes,0.5843137254901961
63068,63068,99.00,2,0,2,1.0,0.0,Yes,1.0
63069,63069,99.00,6,4,10,0.6,0.4,Yes,0.6
63070,63070,99.00,1,3,4,0.25,0.75,No,0.75
63071,63071,99.00,69,18,87,0.7931034482758621,0.20689655172413793,Yes,0.7931034482758621
63072,63072,99.00,151,65,216,0.6990740740740741,0.30092592592592593,Yes,0.6990740740740741
63073,63073,99.00,101,54,155,0.6516129032258065,0.34838709677419355,Yes,0.6516129032258065
63074,63074,99.00,6,3,9,0.6666666666666666,0.3333333333333333,Yes,0.6666666666666666
63075,63075,99.00,37,15,52,0.7115384615384616,0.28846153846153844,Yes,0.7115384615384616
63076,63076,99.00,106,58,164,0.6463414634146342,0.35365853658536583,Yes,0.6463414634146342
63077,63077,99.00,72,41,113,0.6371681415929203,0.36283185840707965,Yes,0.6371681415929203
63078,63078,99.00,4,0,4,1.0,0.0,Yes,1.0
63079,63079,99.00,7,3,10,0.7,0.3,Yes,0.7
63080,63080,99.00,97,28,125,0.776,0.224,Yes,0.776
63081,63081,99.00,2,0,2,1.0,0.0,Yes,1.0
63082,63082,99.00,145,76,221,0.6561085972850679,0.3438914027149321,Yes,0.6561085972850679
63083,63083,99.00,143,83,226,0.6327433628318584,0.3672566371681416,Yes,0.6327433628318584
63084,63084,99.00,95,42,137,0.6934306569343066,0.30656934306569344,Yes,0.6934306569343066
63085,63085,0.00,5,0,5,1.0,0.0,Yes,1.0
63086,63086,99.00,0,0,0,0,0,n/a,0
63087,63087,99.00,0,0,0,0,0,n/a,0
63088,63088,99.00,0,0,0,0,0,n/a,0
63089,63089,99.00,0,0,0,0,0,n/a,0
63090,63090,99.00,0,0,0,0,0,n/a,0
