ED,Reported As,Reporting,Yes,No,Total Votes,p_Yes,p_No,winner,winner_p
65001,65001,99.00,129,38,167,0.7724550898203593,0.2275449101796407,Yes,0.7724550898203593
65002,65002,99.00,110,41,151,0.7284768211920529,0.271523178807947,Yes,0.7284768211920529
65003,65003,75.00,174,53,227,0.7665198237885462,0.23348017621145375,Yes,0.7665198237885462
65004,65004,99.00,63,34,97,0.6494845360824743,0.35051546391752575,Yes,0.6494845360824743
65005,65005,75.00,0,0,0,0,0,n/a,0
65006,65006,99.00,233,128,361,0.6454293628808865,0.3545706371191136,Yes,0.6454293628808865
65007,65007,99.00,4,1,5,0.8,0.2,Yes,0.8
65008,65008,99.00,167,75,242,0.6900826446280992,0.30991735537190085,Yes,0.6900826446280992
65009,65009,99.00,124,35,159,0.779874213836478,0.22012578616352202,Yes,0.779874213836478
65010,65010,99.00,124,37,161,0.7701863354037267,0.22981366459627328,Yes,0.7701863354037267
65011,65011,99.00,3,0,3,1.0,0.0,Yes,1.0
65012,65012,99.00,85,42,127,0.6692913385826772,0.33070866141732286,Yes,0.6692913385826772
65013,65013,99.00,5,0,5,1.0,0.0,Yes,1.0
65014,65014,99.00,210,108,318,0.660377358490566,0.33962264150943394,Yes,0.660377358490566
65015,65015,99.00,188,66,254,0.7401574803149606,0.25984251968503935,Yes,0.7401574803149606
65016,65016,99.00,126,51,177,0.711864406779661,0.288135593220339,Yes,0.711864406779661
65017,65017,99.00,7,3,10,0.7,0.3,Yes,0.7
65018,65018,99.00,95,36,131,0.7251908396946565,0.2748091603053435,Yes,0.7251908396946565
65019,65019,99.00,80,26,106,0.7547169811320755,0.24528301886792453,Yes,0.7547169811320755
65020,65020,99.00,1,3,4,0.25,0.75,No,0.75
65021,65021,99.00,119,33,152,0.7828947368421053,0.21710526315789475,Yes,0.7828947368421053
65022,65022,99.00,124,53,177,0.7005649717514124,0.2994350282485876,Yes,0.7005649717514124
65023,65023,99.00,104,43,147,0.7074829931972789,0.2925170068027211,Yes,0.7074829931972789
65024,65024,99.00,79,25,104,0.7596153846153846,0.2403846153846154,Yes,0.7596153846153846
65025,65025,99.00,2,3,5,0.4,0.6,No,0.6
65026,65026,99.00,5,0,5,1.0,0.0,Yes,1.0
65027,65027,99.00,127,64,191,0.6649214659685864,0.33507853403141363,Yes,0.6649214659685864
65028,65028,99.00,7,2,9,0.7777777777777778,0.2222222222222222,Yes,0.7777777777777778
65029,65029,99.00,5,4,9,0.5555555555555556,0.4444444444444444,Yes,0.5555555555555556
65030,65030,99.00,227,64,291,0.7800687285223368,0.21993127147766323,Yes,0.7800687285223368
65031,65031,99.00,2,3,5,0.4,0.6,No,0.6
65032,65032,99.00,82,19,101,0.8118811881188119,0.18811881188118812,Yes,0.8118811881188119
65033,65033,99.00,75,26,101,0.7425742574257426,0.25742574257425743,Yes,0.7425742574257426
65034,65034,99.00,6,3,9,0.6666666666666666,0.3333333333333333,Yes,0.6666666666666666
65035,65035,99.00,46,19,65,0.7076923076923077,0.2923076923076923,Yes,0.7076923076923077
65036,65036,99.00,103,35,138,0.7463768115942029,0.2536231884057971,Yes,0.7463768115942029
65037,65037,99.00,40,11,51,0.7843137254901961,0.21568627450980393,Yes,0.7843137254901961
65038,65038,99.00,7,3,10,0.7,0.3,Yes,0.7
65039,65039,99.00,141,47,188,0.75,0.25,Yes,0.75
65040,65040,33.33,104,35,139,0.7482014388489209,0.2517985611510791,Yes,0.7482014388489209
65041,65041,33.33,24,3,27,0.8888888888888888,0.1111111111111111,Yes,0.8888888888888888
65042,65042,99.00,20,1,21,0.9523809523809523,0.047619047619047616,Yes,0.9523809523809523
65043,65043,33.33,97,35,132,0.7348484848484849,0.26515151515151514,Yes,0.7348484848484849
65044,65044,0.00,21,4,25,0.84,0.16,Yes,0.84
65045,65045,99.00,172,74,246,0.6991869918699187,0.3008130081300813,Yes,0.6991869918699187
65046,65046,99.00,149,63,212,0.7028301886792453,0.2971698113207547,Yes,0.7028301886792453
65047,65047,99.00,132,59,191,0.6910994764397905,0.3089005235602094,Yes,0.6910994764397905
65048,65048,0.00,14,4,18,0.7777777777777778,0.2222222222222222,Yes,0.7777777777777778
65049,65049,99.00,217,59,276,0.7862318840579711,0.213768115942029,Yes,0.7862318840579711
65050,65050,99.00,7,1,8,0.875,0.125,Yes,0.875
65051,65051,0.00,8,4,12,0.6666666666666666,0.3333333333333333,Yes,0.6666666666666666
65052,65052,99.00,142,50,192,0.7395833333333334,0.2604166666666667,Yes,0.7395833333333334
65053,65053,50.00,72,21,93,0.7741935483870968,0.22580645161290322,Yes,0.7741935483870968
65054,65054,99.00,126,57,183,0.6885245901639344,0.3114754098360656,Yes,0.6885245901639344
65055,65055,50.00,7,1,8,0.875,0.125,Yes,0.875
65056,65056,99.00,71,22,93,0.7634408602150538,0.23655913978494625,Yes,0.7634408602150538
65057,65057,50.00,124,45,169,0.7337278106508875,0.26627218934911245,Yes,0.7337278106508875
65058,65058,99.00,183,36,219,0.8356164383561644,0.1643835616438356,Yes,0.8356164383561644
65059,65059,99.00,165,43,208,0.7932692307692307,0.20673076923076922,Yes,0.7932692307692307
65060,65060,99.00,2,0,2,1.0,0.0,Yes,1.0
65061,65061,99.00,153,42,195,0.7846153846153846,0.2153846153846154,Yes,0.7846153846153846
65062,65062,99.00,4,0,4,1.0,0.0,Yes,1.0
65063,65063,99.00,132,40,172,0.7674418604651163,0.23255813953488372,Yes,0.7674418604651163
65064,65064,99.00,110,43,153,0.7189542483660131,0.28104575163398693,Yes,0.7189542483660131
65065,65065,99.00,6,2,8,0.75,0.25,Yes,0.75
65066,65066,99.00,2,0,2,1.0,0.0,Yes,1.0
65067,65067,99.00,3,0,3,1.0,0.0,Yes,1.0
65068,65068,99.00,256,45,301,0.8504983388704319,0.14950166112956811,Yes,0.8504983388704319
65069,65069,99.00,12,0,12,1.0,0.0,Yes,1.0
65070,65070,99.00,0,0,0,0,0,n/a,0
65071,65071,99.00,155,34,189,0.8201058201058201,0.17989417989417988,Yes,0.8201058201058201
65072,65072,99.00,144,46,190,0.7578947368421053,0.24210526315789474,Yes,0.7578947368421053
65073,65073,66.67,78,20,98,0.7959183673469388,0.20408163265306123,Yes,0.7959183673469388
65074,65074,99.00,4,1,5,0.8,0.2,Yes,0.8
65075,65075,66.67,4,0,4,1.0,0.0,Yes,1.0
65076,65076,66.67,69,15,84,0.8214285714285714,0.17857142857142858,Yes,0.8214285714285714
65077,65077,99.00,155,43,198,0.7828282828282829,0.21717171717171718,Yes,0.7828282828282829
65078,65078,99.00,171,32,203,0.8423645320197044,0.15763546798029557,Yes,0.8423645320197044
65079,65079,99.00,287,68,355,0.8084507042253521,0.19154929577464788,Yes,0.8084507042253521
65080,65080,99.00,145,44,189,0.7671957671957672,0.2328042328042328,Yes,0.7671957671957672
65081,65081,99.00,112,31,143,0.7832167832167832,0.21678321678321677,Yes,0.7832167832167832
65082,65082,99.00,0,0,0,0,0,n/a,0
65083,65083,33.33,4,4,8,0.5,0.5,Tie,0.5
65084,65084,99.00,0,0,0,0,0,n/a,0
65085,65085,75.00,150,63,213,0.704225352112676,0.29577464788732394,Yes,0.704225352112676
65086,65086,75.00,3,1,4,0.75,0.25,Yes,0.75
65087,65087,99.00,95,25,120,0.7916666666666666,0.20833333333333334,Yes,0.7916666666666666
65088,65088,99.00,117,38,155,0.7548387096774194,0.24516129032258063,Yes,0.7548387096774194
65089,65089,99.00,1,2,3,0.3333333333333333,0.6666666666666666,No,0.6666666666666666
65090,65090,99.00,9,0,9,1.0,0.0,Yes,1.0
65091,65091,99.00,132,43,175,0.7542857142857143,0.24571428571428572,Yes,0.7542857142857143
65092,65092,99.00,2,0,2,1.0,0.0,Yes,1.0
65093,65093,99.00,4,0,4,1.0,0.0,Yes,1.0
65094,65094,99.00,0,0,0,0,0,n/a,0
65095,65095,99.00,0,0,0,0,0,n/a,0
65096,65096,99.00,0,0,0,0,0,n/a,0
65097,65097,99.00,0,0,0,0,0,n/a,0
65098,65098,99.00,0,0,0,0,0,n/a,0
65099,65099,66.67,3,0,3,1.0,0.0,Yes,1.0
66001,66001,99.00,117,57,174,0.6724137931034483,0.3275862068965517,Yes,0.6724137931034483
66002,66002,99.00,4,0,4,1.0,0.0,Yes,1.0
66003,66003,99.00,187,63,250,0.748,0.252,Yes,0.748
66004,66004,99.00,73,19,92,0.7934782608695652,0.20652173913043478,Yes,0.7934782608695652
66005,66005,99.00,185,76,261,0.7088122605363985,0.29118773946360155,Yes,0.7088122605363985
66006,66006,99.00,6,3,9,0.6666666666666666,0.3333333333333333,Yes,0.6666666666666666
66007,66007,99.00,6,2,8,0.75,0.25,Yes,0.75
66008,66008,99.00,180,39,219,0.821917808219178,0.1780821917808219,Yes,0.821917808219178
66009,66009,99.00,153,34,187,0.8181818181818182,0.18181818181818182,Yes,0.8181818181818182
66010,66010,99.00,134,17,151,0.8874172185430463,0.11258278145695365,Yes,0.8874172185430463
66011,66011,99.00,168,33,201,0.835820895522388,0.16417910447761194,Yes,0.835820895522388
66012,66012,99.00,99,39,138,0.717391304347826,0.2826086956521739,Yes,0.717391304347826
66013,66013,99.00,185,45,230,0.8043478260869565,0.1956521739130435,Yes,0.8043478260869565
66014,66014,99.00,138,25,163,0.8466257668711656,0.15337423312883436,Yes,0.8466257668711656
66015,66015,99.00,10,3,13,0.7692307692307693,0.23076923076923078,Yes,0.7692307692307693
66016,66016,99.00,2,0,2,1.0,0.0,Yes,1.0
66017,66017,99.00,0,0,0,0,0,n/a,0
66018,66018,99.00,9,0,9,1.0,0.0,Yes,1.0
66019,66019,99.00,12,1,13,0.9230769230769231,0.07692307692307693,Yes,0.9230769230769231
66020,66020,99.00,149,24,173,0.861271676300578,0.13872832369942195,Yes,0.861271676300578
66021,66021,99.00,251,57,308,0.814935064935065,0.18506493506493507,Yes,0.814935064935065
66022,66022,99.00,233,50,283,0.823321554770318,0.17667844522968199,Yes,0.823321554770318
66023,66023,99.00,307,39,346,0.8872832369942196,0.11271676300578035,Yes,0.8872832369942196
66024,66024,99.00,10,5,15,0.6666666666666666,0.3333333333333333,Yes,0.6666666666666666
66025,66025,99.00,7,0,7,1.0,0.0,Yes,1.0
66026,66026,99.00,194,32,226,0.8584070796460177,0.1415929203539823,Yes,0.8584070796460177
66027,66027,99.00,5,0,5,1.0,0.0,Yes,1.0
66028,66028,99.00,137,19,156,0.8782051282051282,0.12179487179487179,Yes,0.8782051282051282
66029,66029,99.00,12,1,13,0.9230769230769231,0.07692307692307693,Yes,0.9230769230769231
66030,66030,99.00,146,39,185,0.7891891891891892,0.21081081081081082,Yes,0.7891891891891892
66031,66031,99.00,9,1,10,0.9,0.1,Yes,0.9
66032,66032,99.00,232,36,268,0.8656716417910447,0.13432835820895522,Yes,0.8656716417910447
66033,66033,99.00,7,2,9,0.7777777777777778,0.2222222222222222,Yes,0.7777777777777778
66034,66034,99.00,13,0,13,1.0,0.0,Yes,1.0
66035,66035,99.00,253,66,319,0.7931034482758621,0.20689655172413793,Yes,0.7931034482758621
66036,66036,99.00,185,32,217,0.8525345622119815,0.14746543778801843,Yes,0.8525345622119815
66037,66037,99.00,131,33,164,0.7987804878048781,0.20121951219512196,Yes,0.7987804878048781
66038,66038,99.00,208,52,260,0.8,0.2,Yes,0.8
66039,66039,33.33,55,15,70,0.7857142857142857,0.21428571428571427,Yes,0.7857142857142857
66040,66040,99.00,0,0,0,0,0,n/a,0
66041,66041,99.00,6,4,10,0.6,0.4,Yes,0.6
66042,66042,99.00,4,0,4,1.0,0.0,Yes,1.0
66043,66043,99.00,83,19,102,0.8137254901960784,0.18627450980392157,Yes,0.8137254901960784
66044,66044,99.00,208,65,273,0.7619047619047619,0.23809523809523808,Yes,0.7619047619047619
66045,66045,99.00,246,52,298,0.825503355704698,0.174496644295302,Yes,0.825503355704698
66046,66046,99.00,13,1,14,0.9285714285714286,0.07142857142857142,Yes,0.9285714285714286
66047,66047,87.50,232,44,276,0.8405797101449275,0.15942028985507245,Yes,0.8405797101449275
66048,66048,99.00,157,50,207,0.7584541062801933,0.24154589371980675,Yes,0.7584541062801933
66049,66049,99.00,142,18,160,0.8875,0.1125,Yes,0.8875
66050,66050,99.00,348,68,416,0.8365384615384616,0.16346153846153846,Yes,0.8365384615384616
66051,66051,99.00,46,11,57,0.8070175438596491,0.19298245614035087,Yes,0.8070175438596491
66052,66052,99.00,32,3,35,0.9142857142857143,0.08571428571428572,Yes,0.9142857142857143
66053,66053,99.00,37,3,40,0.925,0.075,Yes,0.925
66054,66054,99.00,281,80,361,0.778393351800554,0.22160664819944598,Yes,0.778393351800554
66055,66055,99.00,212,49,261,0.8122605363984674,0.18773946360153257,Yes,0.8122605363984674
66056,66056,99.00,38,7,45,0.8444444444444444,0.15555555555555556,Yes,0.8444444444444444
66057,66057,33.33,151,46,197,0.766497461928934,0.233502538071066,Yes,0.766497461928934
66058,66058,87.50,12,3,15,0.8,0.2,Yes,0.8
66059,66059,87.50,35,11,46,0.7608695652173914,0.2391304347826087,Yes,0.7608695652173914
66060,66060,87.50,24,6,30,0.8,0.2,Yes,0.8
66061,66061,87.50,272,46,318,0.8553459119496856,0.14465408805031446,Yes,0.8553459119496856
66062,66062,87.50,16,2,18,0.8888888888888888,0.1111111111111111,Yes,0.8888888888888888
66063,66063,87.50,216,46,262,0.8244274809160306,0.17557251908396945,Yes,0.8244274809160306
66064,66064,87.50,16,1,17,0.9411764705882353,0.058823529411764705,Yes,0.9411764705882353
66065,66065,99.00,107,30,137,0.781021897810219,0.21897810218978103,Yes,0.781021897810219
66066,66066,99.00,18,2,20,0.9,0.1,Yes,0.9
66067,66067,99.00,210,74,284,0.7394366197183099,0.2605633802816901,Yes,0.7394366197183099
66068,66068,99.00,139,33,172,0.8081395348837209,0.19186046511627908,Yes,0.8081395348837209
66069,66069,99.00,9,5,14,0.6428571428571429,0.35714285714285715,Yes,0.6428571428571429
66070,66070,99.00,4,0,4,1.0,0.0,Yes,1.0
66071,66071,99.00,273,67,340,0.8029411764705883,0.19705882352941176,Yes,0.8029411764705883
66072,66072,99.00,9,1,10,0.9,0.1,Yes,0.9
66073,66073,99.00,173,32,205,0.8439024390243902,0.15609756097560976,Yes,0.8439024390243902
66074,66074,99.00,15,1,16,0.9375,0.0625,Yes,0.9375
66075,66075,99.00,249,39,288,0.8645833333333334,0.13541666666666666,Yes,0.8645833333333334
66076,66076,87.50,218,40,258,0.8449612403100775,0.15503875968992248,Yes,0.8449612403100775
66077,66077,99.00,319,51,370,0.8621621621621621,0.13783783783783785,Yes,0.8621621621621621
66078,66078,99.00,320,79,399,0.8020050125313283,0.19799498746867167,Yes,0.8020050125313283
66079,66079,99.00,310,55,365,0.8493150684931506,0.1506849315068493,Yes,0.8493150684931506
66080,66080,99.00,27,2,29,0.9310344827586207,0.06896551724137931,Yes,0.9310344827586207
66081,66081,99.00,373,51,424,0.8797169811320755,0.12028301886792453,Yes,0.8797169811320755
66082,66082,99.00,15,0,15,1.0,0.0,Yes,1.0
66083,66083,99.00,21,2,23,0.9130434782608695,0.08695652173913043,Yes,0.9130434782608695
66084,66084,99.00,334,68,402,0.8308457711442786,0.1691542288557214,Yes,0.8308457711442786
66085,66085,87.50,272,56,328,0.8292682926829268,0.17073170731707318,Yes,0.8292682926829268
66086,66086,87.50,161,31,192,0.8385416666666666,0.16145833333333334,Yes,0.8385416666666666
66087,66087,87.50,187,42,229,0.8165938864628821,0.18340611353711792,Yes,0.8165938864628821
66088,66088,99.00,280,64,344,0.813953488372093,0.18604651162790697,Yes,0.813953488372093
66089,66089,99.00,16,2,18,0.8888888888888888,0.1111111111111111,Yes,0.8888888888888888
66090,66090,99.00,209,49,258,0.810077519379845,0.18992248062015504,Yes,0.810077519379845
66091,66091,99.00,139,59,198,0.702020202020202,0.29797979797979796,Yes,0.702020202020202
66092,66092,99.00,0,0,0,0,0,n/a,0
66093,66093,87.50,0,0,0,0,0,n/a,0
66094,66094,99.00,0,0,0,0,0,n/a,0
66095,66095,87.50,0,0,0,0,0,n/a,0
66096,66096,99.00,12,1,13,0.9230769230769231,0.07692307692307693,Yes,0.9230769230769231
66097,66097,99.00,18,1,19,0.9473684210526315,0.05263157894736842,Yes,0.9473684210526315
66098,66098,99.00,230,60,290,0.7931034482758621,0.20689655172413793,Yes,0.7931034482758621
66099,66099,99.00,112,21,133,0.8421052631578947,0.15789473684210525,Yes,0.8421052631578947
66100,66100,99.00,5,1,6,0.8333333333333334,0.16666666666666666,Yes,0.8333333333333334
66101,66101,99.00,16,4,20,0.8,0.2,Yes,0.8
66102,66102,99.00,7,3,10,0.7,0.3,Yes,0.7
66103,66103,99.00,11,1,12,0.9166666666666666,0.08333333333333333,Yes,0.9166666666666666
66104,66104,99.00,2,1,3,0.6666666666666666,0.3333333333333333,Yes,0.6666666666666666
66105,66105,99.00,11,3,14,0.7857142857142857,0.21428571428571427,Yes,0.7857142857142857
66106,66106,99.00,155,34,189,0.8201058201058201,0.17989417989417988,Yes,0.8201058201058201
67001,67001,80.00,197,63,260,0.7576923076923077,0.2423076923076923,Yes,0.7576923076923077
67002,67002,99.00,228,52,280,0.8142857142857143,0.18571428571428572,Yes,0.8142857142857143
67003,67003,80.00,3,0,3,1.0,0.0,Yes,1.0
67004,67004,99.00,18,1,19,0.9473684210526315,0.05263157894736842,Yes,0.9473684210526315
67005,67005,99.00,254,57,311,0.8167202572347267,0.1832797427652733,Yes,0.8167202572347267
67006,67006,99.00,195,65,260,0.75,0.25,Yes,0.75
67007,67007,99.00,8,1,9,0.8888888888888888,0.1111111111111111,Yes,0.8888888888888888
67008,67008,99.00,223,70,293,0.7610921501706485,0.23890784982935154,Yes,0.7610921501706485
67009,67009,99.00,6,6,12,0.5,0.5,Tie,0.5
67010,67010,99.00,202,60,262,0.7709923664122137,0.22900763358778625,Yes,0.7709923664122137
67011,67011,99.00,164,50,214,0.7663551401869159,0.2336448598130841,Yes,0.7663551401869159
67012,67012,99.00,9,4,13,0.6923076923076923,0.3076923076923077,Yes,0.6923076923076923
67013,67013,99.00,236,72,308,0.7662337662337663,0.23376623376623376,Yes,0.7662337662337663
67014,67014,99.00,208,67,275,0.7563636363636363,0.24363636363636362,Yes,0.7563636363636363
67015,67015,99.00,34,8,42,0.8095238095238095,0.19047619047619047,Yes,0.8095238095238095
67016,67016,99.00,35,7,42,0.8333333333333334,0.16666666666666666,Yes,0.8333333333333334
67017,67017,99.00,23,8,31,0.7419354838709677,0.25806451612903225,Yes,0.7419354838709677
67018,67018,99.00,194,52,246,0.7886178861788617,0.21138211382113822,Yes,0.7886178861788617
67019,67019,99.00,97,41,138,0.7028985507246377,0.2971014492753623,Yes,0.7028985507246377
67020,67020,99.00,143,32,175,0.8171428571428572,0.18285714285714286,Yes,0.8171428571428572
67021,67021,99.00,11,2,13,0.8461538461538461,0.15384615384615385,Yes,0.8461538461538461
67022,67022,99.00,15,3,18,0.8333333333333334,0.16666666666666666,Yes,0.8333333333333334
67023,67023,99.00,184,55,239,0.7698744769874477,0.2301255230125523,Yes,0.7698744769874477
67024,67024,80.00,95,33,128,0.7421875,0.2578125,Yes,0.7421875
67025,67025,99.00,125,35,160,0.78125,0.21875,Yes,0.78125
67026,67026,99.00,6,4,10,0.6,0.4,Yes,0.6
67027,67027,99.00,191,49,240,0.7958333333333333,0.20416666666666666,Yes,0.7958333333333333
67028,67028,80.00,122,24,146,0.8356164383561644,0.1643835616438356,Yes,0.8356164383561644
67029,67029,80.00,85,28,113,0.7522123893805309,0.24778761061946902,Yes,0.7522123893805309
67030,67030,99.00,89,26,115,0.7739130434782608,0.22608695652173913,Yes,0.7739130434782608
67031,67031,99.00,268,70,338,0.7928994082840237,0.20710059171597633,Yes,0.7928994082840237
67032,67032,80.00,163,61,224,0.7276785714285714,0.27232142857142855,Yes,0.7276785714285714
67033,67033,99.00,191,53,244,0.7827868852459017,0.21721311475409835,Yes,0.7827868852459017
67034,67034,80.00,125,45,170,0.7352941176470589,0.2647058823529412,Yes,0.7352941176470589
67035,67035,80.00,23,2,25,0.92,0.08,Yes,0.92
67036,67036,99.00,6,2,8,0.75,0.25,Yes,0.75
67037,67037,99.00,145,40,185,0.7837837837837838,0.21621621621621623,Yes,0.7837837837837838
67038,67038,99.00,175,73,248,0.7056451612903226,0.29435483870967744,Yes,0.7056451612903226
67039,67039,99.00,7,1,8,0.875,0.125,Yes,0.875
67040,67040,99.00,13,1,14,0.9285714285714286,0.07142857142857142,Yes,0.9285714285714286
67041,67041,99.00,268,70,338,0.7928994082840237,0.20710059171597633,Yes,0.7928994082840237
67042,67042,99.00,318,84,402,0.7910447761194029,0.208955223880597,Yes,0.7910447761194029
67043,67043,99.00,556,148,704,0.7897727272727273,0.21022727272727273,Yes,0.7897727272727273
67044,67044,99.00,171,56,227,0.7533039647577092,0.24669603524229075,Yes,0.7533039647577092
67045,67045,99.00,7,3,10,0.7,0.3,Yes,0.7
67046,67046,99.00,27,3,30,0.9,0.1,Yes,0.9
67047,67047,99.00,169,56,225,0.7511111111111111,0.24888888888888888,Yes,0.7511111111111111
67048,67048,99.00,10,1,11,0.9090909090909091,0.09090909090909091,Yes,0.9090909090909091
67049,67049,99.00,301,74,375,0.8026666666666666,0.19733333333333333,Yes,0.8026666666666666
67050,67050,99.00,208,60,268,0.7761194029850746,0.22388059701492538,Yes,0.7761194029850746
67051,67051,80.00,117,27,144,0.8125,0.1875,Yes,0.8125
67052,67052,99.00,22,3,25,0.88,0.12,Yes,0.88
67053,67053,99.00,200,61,261,0.7662835249042146,0.23371647509578544,Yes,0.7662835249042146
67054,67054,99.00,179,66,245,0.7306122448979592,0.2693877551020408,Yes,0.7306122448979592
67055,67055,99.00,6,0,6,1.0,0.0,Yes,1.0
67056,67056,99.00,149,47,196,0.7602040816326531,0.23979591836734693,Yes,0.7602040816326531
67057,67057,99.00,144,52,196,0.7346938775510204,0.2653061224489796,Yes,0.7346938775510204
67058,67058,99.00,14,4,18,0.7777777777777778,0.2222222222222222,Yes,0.7777777777777778
67059,67059,99.00,226,47,273,0.8278388278388278,0.17216117216117216,Yes,0.8278388278388278
67060,67060,99.00,253,96,349,0.7249283667621776,0.27507163323782235,Yes,0.7249283667621776
67061,67061,99.00,296,73,369,0.8021680216802168,0.1978319783197832,Yes,0.8021680216802168
67062,67062,99.00,10,1,11,0.9090909090909091,0.09090909090909091,Yes,0.9090909090909091
67063,67063,99.00,6,1,7,0.8571428571428571,0.14285714285714285,Yes,0.8571428571428571
67064,67064,99.00,336,77,413,0.8135593220338984,0.1864406779661017,Yes,0.8135593220338984
67065,67065,99.00,13,0,13,1.0,0.0,Yes,1.0
67066,67066,99.00,281,71,352,0.7982954545454546,0.20170454545454544,Yes,0.7982954545454546
67067,67067,99.00,299,63,362,0.8259668508287292,0.17403314917127072,Yes,0.8259668508287292
67068,67068,99.00,267,84,351,0.7606837606837606,0.23931623931623933,Yes,0.7606837606837606
67069,67069,99.00,11,4,15,0.7333333333333333,0.26666666666666666,Yes,0.7333333333333333
67070,67070,99.00,12,1,13,0.9230769230769231,0.07692307692307693,Yes,0.9230769230769231
67071,67071,99.00,275,84,359,0.766016713091922,0.233983286908078,Yes,0.766016713091922
67072,67072,99.00,273,61,334,0.8173652694610778,0.18263473053892215,Yes,0.8173652694610778
67073,67073,99.00,11,3,14,0.7857142857142857,0.21428571428571427,Yes,0.7857142857142857
67074,67074,99.00,177,50,227,0.7797356828193832,0.22026431718061673,Yes,0.7797356828193832
67075,67075,99.00,298,66,364,0.8186813186813187,0.1813186813186813,Yes,0.8186813186813187
67076,67076,99.00,19,9,28,0.6785714285714286,0.32142857142857145,Yes,0.6785714285714286
67077,67077,99.00,310,85,395,0.7848101265822784,0.21518987341772153,Yes,0.7848101265822784
67078,67078,99.00,10,0,10,1.0,0.0,Yes,1.0
67079,67079,99.00,13,3,16,0.8125,0.1875,Yes,0.8125
67080,67080,99.00,191,39,230,0.8304347826086956,0.16956521739130434,Yes,0.8304347826086956
67081,67081,99.00,268,92,360,0.7444444444444445,0.25555555555555554,Yes,0.7444444444444445
67082,67082,99.00,14,5,19,0.7368421052631579,0.2631578947368421,Yes,0.7368421052631579
67083,67083,99.00,25,3,28,0.8928571428571429,0.10714285714285714,Yes,0.8928571428571429
67084,67084,99.00,213,55,268,0.7947761194029851,0.20522388059701493,Yes,0.7947761194029851
67085,67085,99.00,300,57,357,0.8403361344537815,0.15966386554621848,Yes,0.8403361344537815
67086,67086,99.00,17,8,25,0.68,0.32,Yes,0.68
67087,67087,99.00,164,38,202,0.8118811881188119,0.18811881188118812,Yes,0.8118811881188119
67088,67088,99.00,262,75,337,0.7774480712166172,0.22255192878338279,Yes,0.7774480712166172
67089,67089,99.00,15,4,19,0.7894736842105263,0.21052631578947367,Yes,0.7894736842105263
67090,67090,99.00,163,37,200,0.815,0.185,Yes,0.815
67091,67091,99.00,385,95,480,0.8020833333333334,0.19791666666666666,Yes,0.8020833333333334
67092,67092,99.00,11,0,11,1.0,0.0,Yes,1.0
67093,67093,99.00,319,78,397,0.8035264483627204,0.1964735516372796,Yes,0.8035264483627204
67094,67094,99.00,19,2,21,0.9047619047619048,0.09523809523809523,Yes,0.9047619047619048
67095,67095,99.00,10,1,11,0.9090909090909091,0.09090909090909091,Yes,0.9090909090909091
67096,67096,99.00,274,46,320,0.85625,0.14375,Yes,0.85625
67097,67097,99.00,6,1,7,0.8571428571428571,0.14285714285714285,Yes,0.8571428571428571
67098,67098,99.00,291,78,369,0.7886178861788617,0.21138211382113822,Yes,0.7886178861788617
67099,67099,99.00,361,84,445,0.8112359550561797,0.18876404494382024,Yes,0.8112359550561797
67100,67100,80.00,1,0,1,1.0,0.0,Yes,1.0
67101,67101,80.00,90,32,122,0.7377049180327869,0.26229508196721313,Yes,0.7377049180327869
67102,67102,99.00,0,0,0,0,0,n/a,0
67103,67103,80.00,0,0,0,0,0,n/a,0
67104,67104,99.00,0,0,0,0,0,n/a,0
67105,67105,99.00,6,1,7,0.8571428571428571,0.14285714285714285,Yes,0.8571428571428571
67106,67106,99.00,212,45,257,0.8249027237354085,0.17509727626459143,Yes,0.8249027237354085
67107,67107,99.00,7,0,7,1.0,0.0,Yes,1.0
67108,67108,99.00,134,45,179,0.7486033519553073,0.25139664804469275,Yes,0.7486033519553073
67109,67109,99.00,166,38,204,0.8137254901960784,0.18627450980392157,Yes,0.8137254901960784
67110,67110,99.00,89,24,113,0.7876106194690266,0.21238938053097345,Yes,0.7876106194690266
67111,67111,80.00,1,0,1,1.0,0.0,Yes,1.0
67112,67112,99.00,23,5,28,0.8214285714285714,0.17857142857142858,Yes,0.8214285714285714
67113,67113,99.00,54,15,69,0.782608695652174,0.21739130434782608,Yes,0.782608695652174
67114,67114,99.00,15,5,20,0.75,0.25,Yes,0.75
68001,68001,99.00,154,48,202,0.7623762376237624,0.2376237623762376,Yes,0.7623762376237624
68002,68002,99.00,2,0,2,1.0,0.0,Yes,1.0
68003,68003,99.00,188,56,244,0.7704918032786885,0.22950819672131148,Yes,0.7704918032786885
68004,68004,99.00,129,52,181,0.712707182320442,0.287292817679558,Yes,0.712707182320442
68005,68005,99.00,159,35,194,0.8195876288659794,0.18041237113402062,Yes,0.8195876288659794
68006,68006,99.00,3,0,3,1.0,0.0,Yes,1.0
68007,68007,99.00,234,100,334,0.7005988023952096,0.2994011976047904,Yes,0.7005988023952096
68008,68008,99.00,183,95,278,0.658273381294964,0.34172661870503596,Yes,0.658273381294964
68009,68009,99.00,5,1,6,0.8333333333333334,0.16666666666666666,Yes,0.8333333333333334
68010,68010,99.00,18,0,18,1.0,0.0,Yes,1.0
68011,68011,99.00,127,48,175,0.7257142857142858,0.2742857142857143,Yes,0.7257142857142858
68012,68012,99.00,4,0,4,1.0,0.0,Yes,1.0
68013,68013,99.00,1,1,2,0.5,0.5,Tie,0.5
68014,68014,99.00,6,1,7,0.8571428571428571,0.14285714285714285,Yes,0.8571428571428571
68015,68015,99.00,155,56,211,0.7345971563981043,0.26540284360189575,Yes,0.7345971563981043
68016,68016,99.00,97,34,131,0.7404580152671756,0.2595419847328244,Yes,0.7404580152671756
68017,68017,99.00,75,26,101,0.7425742574257426,0.25742574257425743,Yes,0.7425742574257426
68018,68018,99.00,2,0,2,1.0,0.0,Yes,1.0
68019,68019,99.00,5,0,5,1.0,0.0,Yes,1.0
68020,68020,99.00,4,1,5,0.8,0.2,Yes,0.8
68021,68021,99.00,52,9,61,0.8524590163934426,0.14754098360655737,Yes,0.8524590163934426
68022,68022,99.00,93,26,119,0.7815126050420168,0.2184873949579832,Yes,0.7815126050420168
68023,68023,99.00,126,32,158,0.7974683544303798,0.20253164556962025,Yes,0.7974683544303798
68024,68024,99.00,5,2,7,0.7142857142857143,0.2857142857142857,Yes,0.7142857142857143
68025,68025,99.00,126,39,165,0.7636363636363637,0.23636363636363636,Yes,0.7636363636363637
68026,68026,99.00,128,30,158,0.810126582278481,0.189873417721519,Yes,0.810126582278481
68027,68027,99.00,4,1,5,0.8,0.2,Yes,0.8
68028,68028,36.36,98,20,118,0.8305084745762712,0.1694915254237288,Yes,0.8305084745762712
68029,68029,99.00,3,0,3,1.0,0.0,Yes,1.0
68030,68030,36.36,14,3,17,0.8235294117647058,0.17647058823529413,Yes,0.8235294117647058
68031,68031,36.36,134,34,168,0.7976190476190477,0.20238095238095238,Yes,0.7976190476190477
68032,68032,36.36,11,3,14,0.7857142857142857,0.21428571428571427,Yes,0.7857142857142857
68033,68033,36.36,141,36,177,0.7966101694915254,0.2033898305084746,Yes,0.7966101694915254
68034,68034,99.00,178,55,233,0.7639484978540773,0.23605150214592274,Yes,0.7639484978540773
68035,68035,99.00,171,34,205,0.8341463414634146,0.16585365853658537,Yes,0.8341463414634146
68036,68036,99.00,91,17,108,0.8425925925925926,0.1574074074074074,Yes,0.8425925925925926
68037,68037,99.00,126,40,166,0.7590361445783133,0.24096385542168675,Yes,0.7590361445783133
68038,68038,99.00,91,18,109,0.8348623853211009,0.1651376146788991,Yes,0.8348623853211009
68039,68039,99.00,152,32,184,0.8260869565217391,0.17391304347826086,Yes,0.8260869565217391
68040,68040,99.00,9,1,10,0.9,0.1,Yes,0.9
68041,68041,99.00,147,37,184,0.7989130434782609,0.20108695652173914,Yes,0.7989130434782609
68042,68042,99.00,216,48,264,0.8181818181818182,0.18181818181818182,Yes,0.8181818181818182
68043,68043,99.00,9,2,11,0.8181818181818182,0.18181818181818182,Yes,0.8181818181818182
68044,68044,99.00,4,1,5,0.8,0.2,Yes,0.8
68045,68045,99.00,2,0,2,1.0,0.0,Yes,1.0
68046,68046,99.00,121,32,153,0.7908496732026143,0.20915032679738563,Yes,0.7908496732026143
68047,68047,99.00,77,33,110,0.7,0.3,Yes,0.7
68048,68048,99.00,0,0,0,0,0,n/a,0
68049,68049,99.00,47,11,58,0.8103448275862069,0.1896551724137931,Yes,0.8103448275862069
68050,68050,99.00,155,40,195,0.7948717948717948,0.20512820512820512,Yes,0.7948717948717948
68051,68051,99.00,3,0,3,1.0,0.0,Yes,1.0
68052,68052,66.67,179,53,232,0.771551724137931,0.22844827586206898,Yes,0.771551724137931
68053,68053,66.67,4,0,4,1.0,0.0,Yes,1.0
68054,68054,99.00,112,31,143,0.7832167832167832,0.21678321678321677,Yes,0.7832167832167832
68055,68055,99.00,136,25,161,0.84472049689441,0.15527950310559005,Yes,0.84472049689441
68056,68056,99.00,89,25,114,0.7807017543859649,0.21929824561403508,Yes,0.7807017543859649
68057,68057,99.00,5,0,5,1.0,0.0,Yes,1.0
68058,68058,66.67,111,39,150,0.74,0.26,Yes,0.74
68059,68059,99.00,1,0,1,1.0,0.0,Yes,1.0
68060,68060,66.67,67,25,92,0.7282608695652174,0.2717391304347826,Yes,0.7282608695652174
68061,68061,99.00,120,32,152,0.7894736842105263,0.21052631578947367,Yes,0.7894736842105263
68062,68062,66.67,3,0,3,1.0,0.0,Yes,1.0
68063,68063,99.00,152,46,198,0.7676767676767676,0.23232323232323232,Yes,0.7676767676767676
68064,68064,99.00,2,2,4,0.5,0.5,Tie,0.5
68065,68065,99.00,75,30,105,0.7142857142857143,0.2857142857142857,Yes,0.7142857142857143
68066,68066,99.00,62,15,77,0.8051948051948052,0.19480519480519481,Yes,0.8051948051948052
68067,68067,99.00,0,0,0,0,0,n/a,0
68068,68068,99.00,83,25,108,0.7685185185185185,0.23148148148148148,Yes,0.7685185185185185
68069,68069,99.00,4,1,5,0.8,0.2,Yes,0.8
68070,68070,99.00,0,0,0,0,0,n/a,0
68071,68071,99.00,122,42,164,0.7439024390243902,0.25609756097560976,Yes,0.7439024390243902
68072,68072,99.00,160,40,200,0.8,0.2,Yes,0.8
68073,68073,99.00,3,2,5,0.6,0.4,Yes,0.6
68074,68074,99.00,8,0,8,1.0,0.0,Yes,1.0
68075,68075,99.00,125,42,167,0.7485029940119761,0.25149700598802394,Yes,0.7485029940119761
68076,68076,99.00,4,0,4,1.0,0.0,Yes,1.0
68077,68077,99.00,4,0,4,1.0,0.0,Yes,1.0
68078,68078,99.00,13,1,14,0.9285714285714286,0.07142857142857142,Yes,0.9285714285714286
68079,68079,99.00,104,32,136,0.7647058823529411,0.23529411764705882,Yes,0.7647058823529411
68080,68080,99.00,199,49,248,0.8024193548387096,0.1975806451612903,Yes,0.8024193548387096
68081,68081,99.00,40,6,46,0.8695652173913043,0.13043478260869565,Yes,0.8695652173913043
68082,68082,99.00,181,54,235,0.7702127659574468,0.2297872340425532,Yes,0.7702127659574468
68083,68083,99.00,114,31,145,0.7862068965517242,0.21379310344827587,Yes,0.7862068965517242
68084,68084,99.00,112,24,136,0.8235294117647058,0.17647058823529413,Yes,0.8235294117647058
68085,68085,99.00,69,18,87,0.7931034482758621,0.20689655172413793,Yes,0.7931034482758621
68086,68086,99.00,63,10,73,0.863013698630137,0.136986301369863,Yes,0.863013698630137
68087,68087,99.00,3,1,4,0.75,0.25,Yes,0.75
68088,68088,99.00,1,0,1,1.0,0.0,Yes,1.0
68089,68089,99.00,101,31,132,0.7651515151515151,0.23484848484848486,Yes,0.7651515151515151
68090,68090,99.00,83,30,113,0.7345132743362832,0.26548672566371684,Yes,0.7345132743362832
68091,68091,99.00,0,0,0,0,0,n/a,0
68092,68092,99.00,103,25,128,0.8046875,0.1953125,Yes,0.8046875
68093,68093,99.00,164,41,205,0.8,0.2,Yes,0.8
68094,68094,99.00,12,4,16,0.75,0.25,Yes,0.75
68095,68095,36.36,0,0,0,0,0,n/a,0
68096,68096,99.00,166,45,211,0.7867298578199052,0.2132701421800948,Yes,0.7867298578199052
68097,68097,99.00,102,36,138,0.7391304347826086,0.2608695652173913,Yes,0.7391304347826086
68098,68098,36.36,54,12,66,0.8181818181818182,0.18181818181818182,Yes,0.8181818181818182
68099,68099,99.00,0,0,0,0,0,n/a,0
68100,68100,99.00,0,0,0,0,0,n/a,0
68101,68101,36.36,0,0,0,0,0,n/a,0
68102,68102,99.00,0,0,0,0,0,n/a,0
68103,68103,36.36,0,0,0,0,0,n/a,0
68104,68104,36.36,0,0,0,0,0,n/a,0
68105,68105,99.00,0,0,0,0,0,n/a,0
68106,68106,99.00,0,0,0,0,0,n/a,0
68107,68107,99.00,0,0,0,0,0,n/a,0
68108,68108,99.00,1,0,1,1.0,0.0,Yes,1.0
68109,68109,99.00,1,0,1,1.0,0.0,Yes,1.0
68110,68110,99.00,4,2,6,0.6666666666666666,0.3333333333333333,Yes,0.6666666666666666
68111,68111,99.00,5,1,6,0.8333333333333334,0.16666666666666666,Yes,0.8333333333333334
68112,68112,99.00,169,47,216,0.7824074074074074,0.2175925925925926,Yes,0.7824074074074074
68113,68113,99.00,0,0,0,0,0,n/a,0
68114,68114,36.36,5,1,6,0.8333333333333334,0.16666666666666666,Yes,0.8333333333333334
68115,68115,99.00,1,1,2,0.5,0.5,Tie,0.5
69001,69001,99.00,7,2,9,0.7777777777777778,0.2222222222222222,Yes,0.7777777777777778
69002,69002,99.00,7,1,8,0.875,0.125,Yes,0.875
69003,69003,99.00,253,57,310,0.8161290322580645,0.18387096774193548,Yes,0.8161290322580645
69004,69004,99.00,22,6,28,0.7857142857142857,0.21428571428571427,Yes,0.7857142857142857
69005,69005,99.00,12,0,12,1.0,0.0,Yes,1.0
69006,69006,99.00,181,45,226,0.8008849557522124,0.19911504424778761,Yes,0.8008849557522124
69007,69007,99.00,244,65,309,0.7896440129449838,0.21035598705501618,Yes,0.7896440129449838
69008,69008,99.00,11,4,15,0.7333333333333333,0.26666666666666666,Yes,0.7333333333333333
69009,69009,99.00,245,66,311,0.7877813504823151,0.21221864951768488,Yes,0.7877813504823151
69010,69010,99.00,266,54,320,0.83125,0.16875,Yes,0.83125
69011,69011,99.00,19,12,31,0.6129032258064516,0.3870967741935484,Yes,0.6129032258064516
69012,69012,99.00,69,22,91,0.7582417582417582,0.24175824175824176,Yes,0.7582417582417582
69013,69013,99.00,183,58,241,0.7593360995850622,0.24066390041493776,Yes,0.7593360995850622
69014,69014,99.00,11,2,13,0.8461538461538461,0.15384615384615385,Yes,0.8461538461538461
69015,69015,99.00,174,32,206,0.8446601941747572,0.1553398058252427,Yes,0.8446601941747572
69016,69016,99.00,124,25,149,0.8322147651006712,0.16778523489932887,Yes,0.8322147651006712
69017,69017,99.00,142,28,170,0.8352941176470589,0.16470588235294117,Yes,0.8352941176470589
69018,69018,99.00,202,40,242,0.8347107438016529,0.1652892561983471,Yes,0.8347107438016529
69019,69019,99.00,11,4,15,0.7333333333333333,0.26666666666666666,Yes,0.7333333333333333
69020,69020,99.00,269,77,346,0.7774566473988439,0.22254335260115607,Yes,0.7774566473988439
69021,69021,99.00,281,78,359,0.7827298050139275,0.21727019498607242,Yes,0.7827298050139275
69022,69022,99.00,327,74,401,0.8154613466334164,0.18453865336658354,Yes,0.8154613466334164
69023,69023,99.00,272,46,318,0.8553459119496856,0.14465408805031446,Yes,0.8553459119496856
69024,69024,99.00,180,32,212,0.8490566037735849,0.1509433962264151,Yes,0.8490566037735849
69025,69025,99.00,17,7,24,0.7083333333333334,0.2916666666666667,Yes,0.7083333333333334
69026,69026,99.00,48,8,56,0.8571428571428571,0.14285714285714285,Yes,0.8571428571428571
69027,69027,99.00,23,5,28,0.8214285714285714,0.17857142857142858,Yes,0.8214285714285714
69028,69028,99.00,9,1,10,0.9,0.1,Yes,0.9
69029,69029,99.00,364,77,441,0.8253968253968254,0.1746031746031746,Yes,0.8253968253968254
69030,69030,99.00,38,11,49,0.7755102040816326,0.22448979591836735,Yes,0.7755102040816326
69031,69031,99.00,26,3,29,0.896551724137931,0.10344827586206896,Yes,0.896551724137931
69032,69032,99.00,353,71,424,0.8325471698113207,0.16745283018867924,Yes,0.8325471698113207
69033,69033,99.00,215,60,275,0.7818181818181819,0.21818181818181817,Yes,0.7818181818181819
69034,69034,99.00,201,49,250,0.804,0.196,Yes,0.804
69035,69035,99.00,14,5,19,0.7368421052631579,0.2631578947368421,Yes,0.7368421052631579
69036,69036,99.00,2,0,2,1.0,0.0,Yes,1.0
69037,69037,99.00,184,53,237,0.7763713080168776,0.22362869198312235,Yes,0.7763713080168776
69038,69038,99.00,21,3,24,0.875,0.125,Yes,0.875
69039,69039,99.00,305,72,377,0.8090185676392573,0.1909814323607427,Yes,0.8090185676392573
69040,69040,99.00,337,61,398,0.8467336683417085,0.15326633165829145,Yes,0.8467336683417085
69041,69041,99.00,34,1,35,0.9714285714285714,0.02857142857142857,Yes,0.9714285714285714
69042,69042,99.00,251,63,314,0.7993630573248408,0.20063694267515925,Yes,0.7993630573248408
69043,69043,99.00,188,38,226,0.831858407079646,0.168141592920354,Yes,0.831858407079646
69044,69044,99.00,292,35,327,0.8929663608562691,0.10703363914373089,Yes,0.8929663608562691
69045,69045,99.00,371,73,444,0.8355855855855856,0.16441441441441443,Yes,0.8355855855855856
69046,69046,99.00,298,82,380,0.7842105263157895,0.21578947368421053,Yes,0.7842105263157895
69047,69047,99.00,27,2,29,0.9310344827586207,0.06896551724137931,Yes,0.9310344827586207
69048,69048,99.00,46,0,46,1.0,0.0,Yes,1.0
69049,69049,47.06,204,33,237,0.8607594936708861,0.13924050632911392,Yes,0.8607594936708861
69050,69050,47.06,286,70,356,0.8033707865168539,0.19662921348314608,Yes,0.8033707865168539
69051,69051,47.06,24,4,28,0.8571428571428571,0.14285714285714285,Yes,0.8571428571428571
69052,69052,47.06,171,29,200,0.855,0.145,Yes,0.855
69053,69053,47.06,10,4,14,0.7142857142857143,0.2857142857142857,Yes,0.7142857142857143
69054,69054,47.06,186,48,234,0.7948717948717948,0.20512820512820512,Yes,0.7948717948717948
69055,69055,99.00,223,46,269,0.828996282527881,0.17100371747211895,Yes,0.828996282527881
69056,69056,47.06,5,2,7,0.7142857142857143,0.2857142857142857,Yes,0.7142857142857143
69057,69057,47.06,88,36,124,0.7096774193548387,0.2903225806451613,Yes,0.7096774193548387
69058,69058,47.06,23,2,25,0.92,0.08,Yes,0.92
69059,69059,47.06,15,1,16,0.9375,0.0625,Yes,0.9375
69060,69060,47.06,256,47,303,0.8448844884488449,0.1551155115511551,Yes,0.8448844884488449
69061,69061,47.06,310,42,352,0.8806818181818182,0.11931818181818182,Yes,0.8806818181818182
69062,69062,99.00,311,63,374,0.8315508021390374,0.16844919786096257,Yes,0.8315508021390374
69063,69063,99.00,302,49,351,0.8603988603988604,0.1396011396011396,Yes,0.8603988603988604
69064,69064,99.00,225,30,255,0.8823529411764706,0.11764705882352941,Yes,0.8823529411764706
69065,69065,99.00,52,3,55,0.9454545454545454,0.05454545454545454,Yes,0.9454545454545454
69066,69066,99.00,3,1,4,0.75,0.25,Yes,0.75
69067,69067,99.00,199,42,241,0.8257261410788381,0.17427385892116182,Yes,0.8257261410788381
69068,69068,99.00,14,1,15,0.9333333333333333,0.06666666666666667,Yes,0.9333333333333333
69069,69069,99.00,259,54,313,0.8274760383386581,0.17252396166134185,Yes,0.8274760383386581
69070,69070,99.00,133,23,156,0.8525641025641025,0.14743589743589744,Yes,0.8525641025641025
69071,69071,99.00,9,2,11,0.8181818181818182,0.18181818181818182,Yes,0.8181818181818182
69072,69072,75.00,179,34,213,0.8403755868544601,0.1596244131455399,Yes,0.8403755868544601
69073,69073,75.00,166,29,195,0.8512820512820513,0.14871794871794872,Yes,0.8512820512820513
69074,69074,99.00,11,0,11,1.0,0.0,Yes,1.0
69075,69075,99.00,165,41,206,0.8009708737864077,0.19902912621359223,Yes,0.8009708737864077
69076,69076,99.00,6,1,7,0.8571428571428571,0.14285714285714285,Yes,0.8571428571428571
69077,69077,75.00,35,0,35,1.0,0.0,Yes,1.0
69078,69078,75.00,107,23,130,0.823076923076923,0.17692307692307693,Yes,0.823076923076923
69079,69079,75.00,22,4,26,0.8461538461538461,0.15384615384615385,Yes,0.8461538461538461
69080,69080,99.00,173,48,221,0.7828054298642534,0.2171945701357466,Yes,0.7828054298642534
69081,69081,99.00,289,60,349,0.828080229226361,0.17191977077363896,Yes,0.828080229226361
69082,69082,99.00,134,33,167,0.8023952095808383,0.19760479041916168,Yes,0.8023952095808383
69083,69083,99.00,5,0,5,1.0,0.0,Yes,1.0
69084,69084,75.00,171,27,198,0.8636363636363636,0.13636363636363635,Yes,0.8636363636363636
69085,69085,75.00,26,4,30,0.8666666666666667,0.13333333333333333,Yes,0.8666666666666667
69086,69086,75.00,58,2,60,0.9666666666666667,0.03333333333333333,Yes,0.9666666666666667
69087,69087,75.00,29,3,32,0.90625,0.09375,Yes,0.90625
69088,69088,75.00,13,1,14,0.9285714285714286,0.07142857142857142,Yes,0.9285714285714286
69089,69089,50.00,107,15,122,0.8770491803278688,0.12295081967213115,Yes,0.8770491803278688
69090,69090,75.00,233,43,276,0.8442028985507246,0.15579710144927536,Yes,0.8442028985507246
69091,69091,75.00,24,5,29,0.8275862068965517,0.1724137931034483,Yes,0.8275862068965517
69092,69092,75.00,271,44,315,0.8603174603174604,0.13968253968253969,Yes,0.8603174603174604
69093,69093,99.00,300,33,333,0.9009009009009009,0.0990990990990991,Yes,0.9009009009009009
69094,69094,99.00,225,33,258,0.872093023255814,0.12790697674418605,Yes,0.872093023255814
69095,69095,99.00,207,27,234,0.8846153846153846,0.11538461538461539,Yes,0.8846153846153846
69096,69096,99.00,160,34,194,0.8247422680412371,0.17525773195876287,Yes,0.8247422680412371
69097,69097,99.00,10,1,11,0.9090909090909091,0.09090909090909091,Yes,0.9090909090909091
69098,69098,99.00,11,1,12,0.9166666666666666,0.08333333333333333,Yes,0.9166666666666666
69099,69099,99.00,313,52,365,0.8575342465753425,0.14246575342465753,Yes,0.8575342465753425
69100,69100,99.00,232,41,273,0.8498168498168498,0.15018315018315018,Yes,0.8498168498168498
69101,69101,99.00,72,24,96,0.75,0.25,Yes,0.75
69102,69102,99.00,141,35,176,0.8011363636363636,0.19886363636363635,Yes,0.8011363636363636
69103,69103,47.06,0,0,0,0,0,n/a,0
69104,69104,99.00,0,0,0,0,0,n/a,0
69105,69105,99.00,0,0,0,0,0,n/a,0
69106,69106,47.06,0,0,0,0,0,n/a,0
69107,69107,99.00,0,0,0,0,0,n/a,0
69108,69108,99.00,3,0,3,1.0,0.0,Yes,1.0
69109,69109,99.00,9,2,11,0.8181818181818182,0.18181818181818182,Yes,0.8181818181818182
69110,69110,75.00,18,5,23,0.782608695652174,0.21739130434782608,Yes,0.782608695652174
69111,69111,99.00,23,2,25,0.92,0.08,Yes,0.92
69112,69112,47.06,26,4,30,0.8666666666666667,0.13333333333333333,Yes,0.8666666666666667
69113,69113,99.00,11,1,12,0.9166666666666666,0.08333333333333333,Yes,0.9166666666666666
69114,69114,47.06,10,3,13,0.7692307692307693,0.23076923076923078,Yes,0.7692307692307693
69115,69115,99.00,263,52,315,0.834920634920635,0.16507936507936508,Yes,0.834920634920635
70001,70001,99.00,8,2,10,0.8,0.2,Yes,0.8
70002,70002,99.00,192,39,231,0.8311688311688312,0.16883116883116883,Yes,0.8311688311688312
70003,70003,99.00,4,0,4,1.0,0.0,Yes,1.0
70004,70004,99.00,174,48,222,0.7837837837837838,0.21621621621621623,Yes,0.7837837837837838
70005,70005,99.00,8,1,9,0.8888888888888888,0.1111111111111111,Yes,0.8888888888888888
70006,70006,99.00,10,2,12,0.8333333333333334,0.16666666666666666,Yes,0.8333333333333334
70007,70007,99.00,284,57,341,0.8328445747800587,0.16715542521994134,Yes,0.8328445747800587
70008,70008,99.00,215,52,267,0.8052434456928839,0.1947565543071161,Yes,0.8052434456928839
70009,70009,99.00,297,70,367,0.8092643051771117,0.1907356948228883,Yes,0.8092643051771117
70010,70010,99.00,7,0,7,1.0,0.0,Yes,1.0
70011,70011,99.00,145,49,194,0.7474226804123711,0.25257731958762886,Yes,0.7474226804123711
70012,70012,99.00,135,36,171,0.7894736842105263,0.21052631578947367,Yes,0.7894736842105263
70013,70013,99.00,1,1,2,0.5,0.5,Tie,0.5
70014,70014,99.00,133,28,161,0.8260869565217391,0.17391304347826086,Yes,0.8260869565217391
70015,70015,99.00,5,0,5,1.0,0.0,Yes,1.0
70016,70016,99.00,14,2,16,0.875,0.125,Yes,0.875
70017,70017,99.00,199,40,239,0.8326359832635983,0.16736401673640167,Yes,0.8326359832635983
70018,70018,99.00,6,3,9,0.6666666666666666,0.3333333333333333,Yes,0.6666666666666666
70019,70019,99.00,326,72,398,0.8190954773869347,0.18090452261306533,Yes,0.8190954773869347
70020,70020,99.00,234,46,280,0.8357142857142857,0.16428571428571428,Yes,0.8357142857142857
70021,70021,99.00,176,39,215,0.8186046511627907,0.1813953488372093,Yes,0.8186046511627907
70022,70022,99.00,272,56,328,0.8292682926829268,0.17073170731707318,Yes,0.8292682926829268
70023,70023,99.00,260,66,326,0.7975460122699386,0.20245398773006135,Yes,0.7975460122699386
70024,70024,99.00,187,46,233,0.8025751072961373,0.19742489270386265,Yes,0.8025751072961373
70025,70025,99.00,72,34,106,0.6792452830188679,0.32075471698113206,Yes,0.6792452830188679
70026,70026,99.00,179,36,215,0.8325581395348837,0.16744186046511628,Yes,0.8325581395348837
70027,70027,99.00,114,39,153,0.7450980392156863,0.2549019607843137,Yes,0.7450980392156863
70028,70028,99.00,205,61,266,0.7706766917293233,0.22932330827067668,Yes,0.7706766917293233
70029,70029,99.00,11,3,14,0.7857142857142857,0.21428571428571427,Yes,0.7857142857142857
70030,70030,99.00,0,0,0,0,0,n/a,0
70031,70031,99.00,122,47,169,0.7218934911242604,0.2781065088757396,Yes,0.7218934911242604
70032,70032,99.00,7,0,7,1.0,0.0,Yes,1.0
70033,70033,99.00,107,25,132,0.8106060606060606,0.1893939393939394,Yes,0.8106060606060606
70034,70034,50.00,128,35,163,0.7852760736196319,0.2147239263803681,Yes,0.7852760736196319
70035,70035,50.00,163,44,207,0.7874396135265701,0.21256038647342995,Yes,0.7874396135265701
70036,70036,99.00,146,29,175,0.8342857142857143,0.1657142857142857,Yes,0.8342857142857143
70037,70037,99.00,130,23,153,0.8496732026143791,0.1503267973856209,Yes,0.8496732026143791
70038,70038,99.00,114,32,146,0.7808219178082192,0.2191780821917808,Yes,0.7808219178082192
70039,70039,99.00,1,3,4,0.25,0.75,No,0.75
70040,70040,50.00,185,58,243,0.7613168724279835,0.23868312757201646,Yes,0.7613168724279835
70041,70041,50.00,188,71,259,0.7258687258687259,0.27413127413127414,Yes,0.7258687258687259
70042,70042,50.00,179,53,232,0.771551724137931,0.22844827586206898,Yes,0.771551724137931
70043,70043,50.00,145,46,191,0.7591623036649214,0.24083769633507854,Yes,0.7591623036649214
70044,70044,50.00,170,51,221,0.7692307692307693,0.23076923076923078,Yes,0.7692307692307693
70045,70045,50.00,125,36,161,0.7763975155279503,0.2236024844720497,Yes,0.7763975155279503
70046,70046,99.00,329,102,431,0.7633410672853829,0.23665893271461716,Yes,0.7633410672853829
70047,70047,99.00,5,0,5,1.0,0.0,Yes,1.0
70048,70048,99.00,166,44,210,0.7904761904761904,0.20952380952380953,Yes,0.7904761904761904
70049,70049,99.00,5,0,5,1.0,0.0,Yes,1.0
70050,70050,99.00,281,51,332,0.8463855421686747,0.1536144578313253,Yes,0.8463855421686747
70051,70051,99.00,9,2,11,0.8181818181818182,0.18181818181818182,Yes,0.8181818181818182
70052,70052,99.00,191,38,229,0.834061135371179,0.16593886462882096,Yes,0.834061135371179
70053,70053,99.00,322,100,422,0.7630331753554502,0.23696682464454977,Yes,0.7630331753554502
70054,70054,99.00,18,8,26,0.6923076923076923,0.3076923076923077,Yes,0.6923076923076923
70055,70055,99.00,229,68,297,0.7710437710437711,0.22895622895622897,Yes,0.7710437710437711
70056,70056,99.00,10,2,12,0.8333333333333334,0.16666666666666666,Yes,0.8333333333333334
70057,70057,99.00,13,0,13,1.0,0.0,Yes,1.0
70058,70058,99.00,173,41,214,0.8084112149532711,0.19158878504672897,Yes,0.8084112149532711
70059,70059,99.00,8,0,8,1.0,0.0,Yes,1.0
70060,70060,99.00,108,31,139,0.7769784172661871,0.22302158273381295,Yes,0.7769784172661871
70061,70061,99.00,1,1,2,0.5,0.5,Tie,0.5
70062,70062,99.00,206,37,243,0.8477366255144033,0.1522633744855967,Yes,0.8477366255144033
70063,70063,99.00,126,21,147,0.8571428571428571,0.14285714285714285,Yes,0.8571428571428571
70064,70064,99.00,2,0,2,1.0,0.0,Yes,1.0
70065,70065,99.00,196,27,223,0.8789237668161435,0.1210762331838565,Yes,0.8789237668161435
70066,70066,99.00,126,27,153,0.8235294117647058,0.17647058823529413,Yes,0.8235294117647058
70067,70067,50.00,6,1,7,0.8571428571428571,0.14285714285714285,Yes,0.8571428571428571
70068,70068,99.00,144,26,170,0.8470588235294118,0.15294117647058825,Yes,0.8470588235294118
70069,70069,85.71,92,27,119,0.773109243697479,0.226890756302521,Yes,0.773109243697479
70070,70070,99.00,2,0,2,1.0,0.0,Yes,1.0
70071,70071,99.00,207,48,255,0.8117647058823529,0.18823529411764706,Yes,0.8117647058823529
70072,70072,99.00,0,0,0,0,0,n/a,0
70073,70073,99.00,140,33,173,0.8092485549132948,0.1907514450867052,Yes,0.8092485549132948
70074,70074,99.00,303,75,378,0.8015873015873016,0.1984126984126984,Yes,0.8015873015873016
70075,70075,99.00,8,1,9,0.8888888888888888,0.1111111111111111,Yes,0.8888888888888888
70076,70076,99.00,220,65,285,0.7719298245614035,0.22807017543859648,Yes,0.7719298245614035
70077,70077,99.00,137,32,169,0.8106508875739645,0.1893491124260355,Yes,0.8106508875739645
70078,70078,99.00,1,0,1,1.0,0.0,Yes,1.0
70079,70079,99.00,3,0,3,1.0,0.0,Yes,1.0
70080,70080,85.71,67,12,79,0.8481012658227848,0.1518987341772152,Yes,0.8481012658227848
70081,70081,99.00,107,28,135,0.7925925925925926,0.2074074074074074,Yes,0.7925925925925926
70082,70082,85.71,3,0,3,1.0,0.0,Yes,1.0
70083,70083,85.71,162,47,209,0.7751196172248804,0.22488038277511962,Yes,0.7751196172248804
70084,70084,99.00,1,1,2,0.5,0.5,Tie,0.5
70085,70085,99.00,259,72,331,0.7824773413897281,0.2175226586102719,Yes,0.7824773413897281
70086,70086,85.71,1,0,1,1.0,0.0,Yes,1.0
70087,70087,85.71,2,0,2,1.0,0.0,Yes,1.0
70088,70088,85.71,156,42,198,0.7878787878787878,0.21212121212121213,Yes,0.7878787878787878
70089,70089,99.00,13,1,14,0.9285714285714286,0.07142857142857142,Yes,0.9285714285714286
70090,70090,85.71,14,0,14,1.0,0.0,Yes,1.0
70091,70091,99.00,243,72,315,0.7714285714285715,0.22857142857142856,Yes,0.7714285714285715
70092,70092,99.00,264,53,317,0.832807570977918,0.167192429022082,Yes,0.832807570977918
70093,70093,99.00,9,0,9,1.0,0.0,Yes,1.0
70094,70094,85.71,0,0,0,0,0,n/a,0
70095,70095,85.71,0,0,0,0,0,n/a,0
70096,70096,85.71,0,0,0,0,0,n/a,0
70097,70097,85.71,0,0,0,0,0,n/a,0
70098,70098,99.00,144,26,170,0.8470588235294118,0.15294117647058825,Yes,0.8470588235294118
70099,70099,85.71,163,30,193,0.844559585492228,0.15544041450777202,Yes,0.844559585492228
70100,70100,99.00,220,44,264,0.8333333333333334,0.16666666666666666,Yes,0.8333333333333334
70101,70101,99.00,12,1,13,0.9230769230769231,0.07692307692307693,Yes,0.9230769230769231
70102,70102,99.00,11,2,13,0.8461538461538461,0.15384615384615385,Yes,0.8461538461538461
70103,70103,99.00,5,1,6,0.8333333333333334,0.16666666666666666,Yes,0.8333333333333334
70104,70104,99.00,3,0,3,1.0,0.0,Yes,1.0
70105,70105,99.00,10,3,13,0.7692307692307693,0.23076923076923078,Yes,0.7692307692307693
70106,70106,99.00,4,3,7,0.5714285714285714,0.42857142857142855,Yes,0.5714285714285714
70107,70107,99.00,9,0,9,1.0,0.0,Yes,1.0
70108,70108,99.00,187,47,234,0.7991452991452992,0.20085470085470086,Yes,0.7991452991452992
70109,70109,85.71,1,1,2,0.5,0.5,Tie,0.5
70110,70110,99.00,3,3,6,0.5,0.5,Tie,0.5
70111,70111,99.00,3,1,4,0.75,0.25,Yes,0.75
71001,71001,99.00,113,30,143,0.7902097902097902,0.2097902097902098,Yes,0.7902097902097902
71002,71002,99.00,87,18,105,0.8285714285714286,0.17142857142857143,Yes,0.8285714285714286
71003,71003,99.00,5,0,5,1.0,0.0,Yes,1.0
71004,71004,99.00,128,34,162,0.7901234567901234,0.20987654320987653,Yes,0.7901234567901234
71005,71005,99.00,166,24,190,0.8736842105263158,0.12631578947368421,Yes,0.8736842105263158
71006,71006,99.00,120,21,141,0.851063829787234,0.14893617021276595,Yes,0.851063829787234
71007,71007,99.00,4,0,4,1.0,0.0,Yes,1.0
71008,71008,99.00,226,46,272,0.8308823529411765,0.16911764705882354,Yes,0.8308823529411765
71009,71009,99.00,14,2,16,0.875,0.125,Yes,0.875
71010,71010,99.00,171,52,223,0.7668161434977578,0.23318385650224216,Yes,0.7668161434977578
71011,71011,99.00,89,23,112,0.7946428571428571,0.20535714285714285,Yes,0.7946428571428571
71012,71012,99.00,187,59,246,0.7601626016260162,0.23983739837398374,Yes,0.7601626016260162
71013,71013,99.00,168,37,205,0.8195121951219512,0.18048780487804877,Yes,0.8195121951219512
71014,71014,99.00,12,3,15,0.8,0.2,Yes,0.8
71015,71015,99.00,4,1,5,0.8,0.2,Yes,0.8
71016,71016,99.00,86,22,108,0.7962962962962963,0.2037037037037037,Yes,0.7962962962962963
71017,71017,99.00,5,3,8,0.625,0.375,Yes,0.625
71018,71018,99.00,198,46,244,0.8114754098360656,0.1885245901639344,Yes,0.8114754098360656
71019,71019,99.00,220,69,289,0.7612456747404844,0.23875432525951557,Yes,0.7612456747404844
71020,71020,99.00,195,61,256,0.76171875,0.23828125,Yes,0.76171875
71021,71021,99.00,11,2,13,0.8461538461538461,0.15384615384615385,Yes,0.8461538461538461
71022,71022,99.00,200,53,253,0.7905138339920948,0.20948616600790515,Yes,0.7905138339920948
71023,71023,99.00,127,21,148,0.8581081081081081,0.14189189189189189,Yes,0.8581081081081081
71024,71024,99.00,260,48,308,0.8441558441558441,0.15584415584415584,Yes,0.8441558441558441
71025,71025,99.00,88,24,112,0.7857142857142857,0.21428571428571427,Yes,0.7857142857142857
71026,71026,99.00,221,44,265,0.8339622641509434,0.1660377358490566,Yes,0.8339622641509434
71027,71027,99.00,12,1,13,0.9230769230769231,0.07692307692307693,Yes,0.9230769230769231
71028,71028,99.00,89,20,109,0.8165137614678899,0.1834862385321101,Yes,0.8165137614678899
71029,71029,99.00,9,2,11,0.8181818181818182,0.18181818181818182,Yes,0.8181818181818182
71030,71030,99.00,222,36,258,0.8604651162790697,0.13953488372093023,Yes,0.8604651162790697
71031,71031,99.00,261,61,322,0.8105590062111802,0.18944099378881987,Yes,0.8105590062111802
71032,71032,99.00,252,72,324,0.7777777777777778,0.2222222222222222,Yes,0.7777777777777778
71033,71033,99.00,146,27,173,0.8439306358381503,0.15606936416184972,Yes,0.8439306358381503
71034,71034,99.00,4,3,7,0.5714285714285714,0.42857142857142855,Yes,0.5714285714285714
71035,71035,99.00,3,0,3,1.0,0.0,Yes,1.0
71036,71036,99.00,206,56,262,0.7862595419847328,0.21374045801526717,Yes,0.7862595419847328
71037,71037,99.00,2,1,3,0.6666666666666666,0.3333333333333333,Yes,0.6666666666666666
71038,71038,99.00,80,12,92,0.8695652173913043,0.13043478260869565,Yes,0.8695652173913043
71039,71039,99.00,2,1,3,0.6666666666666666,0.3333333333333333,Yes,0.6666666666666666
71040,71040,99.00,1,3,4,0.25,0.75,No,0.75
71041,71041,99.00,334,64,398,0.8391959798994975,0.16080402010050251,Yes,0.8391959798994975
71042,71042,99.00,234,50,284,0.823943661971831,0.176056338028169,Yes,0.823943661971831
71043,71043,99.00,125,38,163,0.7668711656441718,0.2331288343558282,Yes,0.7668711656441718
71044,71044,99.00,9,0,9,1.0,0.0,Yes,1.0
71045,71045,99.00,176,39,215,0.8186046511627907,0.1813953488372093,Yes,0.8186046511627907
71046,71046,99.00,96,21,117,0.8205128205128205,0.1794871794871795,Yes,0.8205128205128205
71047,71047,99.00,280,62,342,0.8187134502923976,0.18128654970760233,Yes,0.8187134502923976
71048,71048,99.00,128,25,153,0.8366013071895425,0.16339869281045752,Yes,0.8366013071895425
71049,71049,99.00,64,12,76,0.8421052631578947,0.15789473684210525,Yes,0.8421052631578947
71050,71050,99.00,1,0,1,1.0,0.0,Yes,1.0
71051,71051,99.00,0,0,0,0,0,n/a,0
71052,71052,99.00,93,22,115,0.808695652173913,0.19130434782608696,Yes,0.808695652173913
71053,71053,99.00,5,0,5,1.0,0.0,Yes,1.0
71054,71054,99.00,1,0,1,1.0,0.0,Yes,1.0
71055,71055,99.00,107,13,120,0.8916666666666667,0.10833333333333334,Yes,0.8916666666666667
71056,71056,99.00,0,1,1,0.0,1.0,No,1.0
71057,71057,99.00,174,38,212,0.8207547169811321,0.1792452830188679,Yes,0.8207547169811321
71058,71058,99.00,43,15,58,0.7413793103448276,0.25862068965517243,Yes,0.7413793103448276
71059,71059,99.00,112,24,136,0.8235294117647058,0.17647058823529413,Yes,0.8235294117647058
71060,71060,99.00,115,24,139,0.8273381294964028,0.17266187050359713,Yes,0.8273381294964028
71061,71061,99.00,3,1,4,0.75,0.25,Yes,0.75
71062,71062,99.00,96,20,116,0.8275862068965517,0.1724137931034483,Yes,0.8275862068965517
71063,71063,99.00,162,30,192,0.84375,0.15625,Yes,0.84375
71064,71064,99.00,5,0,5,1.0,0.0,Yes,1.0
71065,71065,99.00,131,29,160,0.81875,0.18125,Yes,0.81875
71066,71066,99.00,155,31,186,0.8333333333333334,0.16666666666666666,Yes,0.8333333333333334
71067,71067,99.00,115,38,153,0.7516339869281046,0.24836601307189543,Yes,0.7516339869281046
71068,71068,99.00,102,33,135,0.7555555555555555,0.24444444444444444,Yes,0.7555555555555555
71069,71069,99.00,3,0,3,1.0,0.0,Yes,1.0
71070,71070,99.00,176,40,216,0.8148148148148148,0.18518518518518517,Yes,0.8148148148148148
71071,71071,99.00,11,2,13,0.8461538461538461,0.15384615384615385,Yes,0.8461538461538461
71072,71072,99.00,224,44,268,0.835820895522388,0.16417910447761194,Yes,0.835820895522388
71073,71073,99.00,11,2,13,0.8461538461538461,0.15384615384615385,Yes,0.8461538461538461
71074,71074,99.00,256,46,302,0.847682119205298,0.152317880794702,Yes,0.847682119205298
71075,71075,99.00,263,55,318,0.8270440251572327,0.17295597484276728,Yes,0.8270440251572327
71076,71076,99.00,3,0,3,1.0,0.0,Yes,1.0
71077,71077,99.00,478,64,542,0.8819188191881919,0.11808118081180811,Yes,0.8819188191881919
71078,71078,99.00,9,3,12,0.75,0.25,Yes,0.75
71079,71079,99.00,390,89,479,0.81419624217119,0.18580375782881003,Yes,0.81419624217119
71080,71080,99.00,4,0,4,1.0,0.0,Yes,1.0
71081,71081,99.00,312,86,398,0.7839195979899497,0.21608040201005024,Yes,0.7839195979899497
71082,71082,99.00,9,1,10,0.9,0.1,Yes,0.9
71083,71083,99.00,325,56,381,0.8530183727034121,0.14698162729658792,Yes,0.8530183727034121
71084,71084,99.00,7,1,8,0.875,0.125,Yes,0.875
71085,71085,99.00,360,64,424,0.8490566037735849,0.1509433962264151,Yes,0.8490566037735849
71086,71086,99.00,0,0,0,0,0,n/a,0
71087,71087,99.00,120,31,151,0.7947019867549668,0.2052980132450331,Yes,0.7947019867549668
71088,71088,99.00,0,0,0,0,0,n/a,0
71089,71089,99.00,138,19,157,0.8789808917197452,0.12101910828025478,Yes,0.8789808917197452
71090,71090,99.00,75,15,90,0.8333333333333334,0.16666666666666666,Yes,0.8333333333333334
71091,71091,99.00,0,0,0,0,0,n/a,0
71092,71092,99.00,3,0,3,1.0,0.0,Yes,1.0
71093,71093,99.00,5,1,6,0.8333333333333334,0.16666666666666666,Yes,0.8333333333333334
71094,71094,99.00,0,0,0,0,0,n/a,0
71095,71095,99.00,0,0,0,0,0,n/a,0
71096,71096,99.00,0,0,0,0,0,n/a,0
71097,71097,99.00,11,0,11,1.0,0.0,Yes,1.0
71098,71098,99.00,5,2,7,0.7142857142857143,0.2857142857142857,Yes,0.7142857142857143
71099,71099,99.00,3,1,4,0.75,0.25,Yes,0.75
71100,71100,99.00,2,0,2,1.0,0.0,Yes,1.0
71101,71101,99.00,0,0,0,0,0,n/a,0
71102,71102,99.00,7,2,9,0.7777777777777778,0.2222222222222222,Yes,0.7777777777777778
71103,71103,99.00,157,51,208,0.7548076923076923,0.24519230769230768,Yes,0.7548076923076923
71104,71104,99.00,2,0,2,1.0,0.0,Yes,1.0
71105,71105,99.00,166,45,211,0.7867298578199052,0.2132701421800948,Yes,0.7867298578199052
71106,71106,99.00,4,1,5,0.8,0.2,Yes,0.8
71107,71107,99.00,219,60,279,0.7849462365591398,0.21505376344086022,Yes,0.7849462365591398
71108,71108,99.00,0,0,0,0,0,n/a,0
71109,71109,99.00,148,36,184,0.8043478260869565,0.1956521739130435,Yes,0.8043478260869565
72001,72001,99.00,86,21,107,0.8037383177570093,0.19626168224299065,Yes,0.8037383177570093
72002,72002,99.00,124,32,156,0.7948717948717948,0.20512820512820512,Yes,0.7948717948717948
72003,72003,99.00,50,16,66,0.7575757575757576,0.24242424242424243,Yes,0.7575757575757576
72004,72004,99.00,87,27,114,0.7631578947368421,0.23684210526315788,Yes,0.7631578947368421
72005,72005,99.00,4,0,4,1.0,0.0,Yes,1.0
72006,72006,99.00,0,0,0,0,0,n/a,0
72007,72007,99.00,49,17,66,0.7424242424242424,0.25757575757575757,Yes,0.7424242424242424
72008,72008,99.00,4,1,5,0.8,0.2,Yes,0.8
72009,72009,99.00,46,19,65,0.7076923076923077,0.2923076923076923,Yes,0.7076923076923077
72010,72010,99.00,114,21,135,0.8444444444444444,0.15555555555555556,Yes,0.8444444444444444
72011,72011,99.00,2,2,4,0.5,0.5,Tie,0.5
72012,72012,99.00,42,10,52,0.8076923076923077,0.19230769230769232,Yes,0.8076923076923077
72013,72013,99.00,93,14,107,0.8691588785046729,0.1308411214953271,Yes,0.8691588785046729
72014,72014,99.00,7,0,7,1.0,0.0,Yes,1.0
72015,72015,99.00,121,26,147,0.8231292517006803,0.17687074829931973,Yes,0.8231292517006803
72016,72016,99.00,0,0,0,0,0,n/a,0
72017,72017,99.00,180,55,235,0.7659574468085106,0.23404255319148937,Yes,0.7659574468085106
72018,72018,99.00,10,1,11,0.9090909090909091,0.09090909090909091,Yes,0.9090909090909091
72019,72019,99.00,247,55,302,0.8178807947019867,0.18211920529801323,Yes,0.8178807947019867
72020,72020,99.00,117,32,149,0.785234899328859,0.21476510067114093,Yes,0.785234899328859
72021,72021,99.00,103,19,122,0.8442622950819673,0.1557377049180328,Yes,0.8442622950819673
72022,72022,99.00,63,15,78,0.8076923076923077,0.19230769230769232,Yes,0.8076923076923077
72023,72023,99.00,121,24,145,0.8344827586206897,0.16551724137931034,Yes,0.8344827586206897
72024,72024,33.33,62,16,78,0.7948717948717948,0.20512820512820512,Yes,0.7948717948717948
72025,72025,33.33,1,0,1,1.0,0.0,Yes,1.0
72026,72026,99.00,103,25,128,0.8046875,0.1953125,Yes,0.8046875
72027,72027,33.33,8,1,9,0.8888888888888888,0.1111111111111111,Yes,0.8888888888888888
72028,72028,99.00,6,1,7,0.8571428571428571,0.14285714285714285,Yes,0.8571428571428571
72029,72029,99.00,155,25,180,0.8611111111111112,0.1388888888888889,Yes,0.8611111111111112
72030,72030,33.33,100,12,112,0.8928571428571429,0.10714285714285714,Yes,0.8928571428571429
72031,72031,99.00,68,17,85,0.8,0.2,Yes,0.8
72032,72032,0.00,12,1,13,0.9230769230769231,0.07692307692307693,Yes,0.9230769230769231
72033,72033,99.00,4,0,4,1.0,0.0,Yes,1.0
72034,72034,33.33,4,0,4,1.0,0.0,Yes,1.0
72035,72035,33.33,72,18,90,0.8,0.2,Yes,0.8
72036,72036,0.00,13,0,13,1.0,0.0,Yes,1.0
72037,72037,99.00,7,1,8,0.875,0.125,Yes,0.875
72038,72038,99.00,148,44,192,0.7708333333333334,0.22916666666666666,Yes,0.7708333333333334
72039,72039,80.00,6,1,7,0.8571428571428571,0.14285714285714285,Yes,0.8571428571428571
72040,72040,80.00,171,28,199,0.8592964824120602,0.1407035175879397,Yes,0.8592964824120602
72041,72041,99.00,253,60,313,0.8083067092651757,0.19169329073482427,Yes,0.8083067092651757
72042,72042,99.00,132,25,157,0.8407643312101911,0.1592356687898089,Yes,0.8407643312101911
72043,72043,80.00,85,26,111,0.7657657657657657,0.23423423423423423,Yes,0.7657657657657657
72044,72044,80.00,93,33,126,0.7380952380952381,0.2619047619047619,Yes,0.7380952380952381
72045,72045,80.00,4,2,6,0.6666666666666666,0.3333333333333333,Yes,0.6666666666666666
72046,72046,80.00,153,34,187,0.8181818181818182,0.18181818181818182,Yes,0.8181818181818182
72047,72047,99.00,225,49,274,0.8211678832116789,0.17883211678832117,Yes,0.8211678832116789
72048,72048,99.00,60,13,73,0.821917808219178,0.1780821917808219,Yes,0.821917808219178
72049,72049,99.00,129,23,152,0.8486842105263158,0.1513157894736842,Yes,0.8486842105263158
72050,72050,99.00,68,24,92,0.7391304347826086,0.2608695652173913,Yes,0.7391304347826086
72051,72051,99.00,3,0,3,1.0,0.0,Yes,1.0
72052,72052,99.00,52,24,76,0.6842105263157895,0.3157894736842105,Yes,0.6842105263157895
72053,72053,99.00,100,40,140,0.7142857142857143,0.2857142857142857,Yes,0.7142857142857143
72054,72054,99.00,3,0,3,1.0,0.0,Yes,1.0
72055,72055,99.00,82,24,106,0.7735849056603774,0.22641509433962265,Yes,0.7735849056603774
72056,72056,99.00,121,19,140,0.8642857142857143,0.1357142857142857,Yes,0.8642857142857143
72057,72057,99.00,7,3,10,0.7,0.3,Yes,0.7
72058,72058,99.00,369,67,436,0.8463302752293578,0.1536697247706422,Yes,0.8463302752293578
72059,72059,99.00,3,1,4,0.75,0.25,Yes,0.75
72060,72060,99.00,206,39,245,0.8408163265306122,0.15918367346938775,Yes,0.8408163265306122
72061,72061,99.00,3,1,4,0.75,0.25,Yes,0.75
72062,72062,99.00,6,0,6,1.0,0.0,Yes,1.0
72063,72063,99.00,128,27,155,0.8258064516129032,0.17419354838709677,Yes,0.8258064516129032
72064,72064,99.00,264,58,322,0.8198757763975155,0.18012422360248448,Yes,0.8198757763975155
72065,72065,99.00,95,23,118,0.8050847457627118,0.19491525423728814,Yes,0.8050847457627118
72066,72066,99.00,376,79,455,0.8263736263736263,0.17362637362637362,Yes,0.8263736263736263
72067,72067,99.00,8,1,9,0.8888888888888888,0.1111111111111111,Yes,0.8888888888888888
72068,72068,99.00,286,61,347,0.8242074927953891,0.17579250720461095,Yes,0.8242074927953891
72069,72069,99.00,196,36,232,0.8448275862068966,0.15517241379310345,Yes,0.8448275862068966
72070,72070,99.00,154,30,184,0.8369565217391305,0.16304347826086957,Yes,0.8369565217391305
72071,72071,99.00,76,24,100,0.76,0.24,Yes,0.76
72072,72072,99.00,0,0,0,0,0,n/a,0
72073,72073,99.00,7,1,8,0.875,0.125,Yes,0.875
72074,72074,0.00,1,0,1,1.0,0.0,Yes,1.0
72075,72075,0.00,5,1,6,0.8333333333333334,0.16666666666666666,Yes,0.8333333333333334
72076,72076,80.00,4,0,4,1.0,0.0,Yes,1.0
72077,72077,99.00,75,10,85,0.8823529411764706,0.11764705882352941,Yes,0.8823529411764706
72078,72078,99.00,2,0,2,1.0,0.0,Yes,1.0
72079,72079,99.00,2,0,2,1.0,0.0,Yes,1.0
72080,72080,99.00,0,0,0,0,0,n/a,0
72081,72081,99.00,0,0,0,0,0,n/a,0
72082,72082,99.00,0,0,0,0,0,n/a,0
72083,72083,99.00,0,0,0,0,0,n/a,0
72084,72084,99.00,0,0,0,0,0,n/a,0
72085,72085,99.00,0,0,0,0,0,n/a,0
72086,72086,99.00,51,13,64,0.796875,0.203125,Yes,0.796875
72087,72087,33.33,63,9,72,0.875,0.125,Yes,0.875
72088,72088,33.33,2,1,3,0.6666666666666666,0.3333333333333333,Yes,0.6666666666666666
72089,72089,99.00,3,0,3,1.0,0.0,Yes,1.0
72090,72090,99.00,7,0,7,1.0,0.0,Yes,1.0
72091,72091,99.00,8,0,8,1.0,0.0,Yes,1.0
72092,72092,99.00,2,0,2,1.0,0.0,Yes,1.0
72093,72093,99.00,158,17,175,0.9028571428571428,0.09714285714285714,Yes,0.9028571428571428
72094,72094,99.00,119,23,142,0.8380281690140845,0.1619718309859155,Yes,0.8380281690140845
72095,72095,99.00,2,0,2,1.0,0.0,Yes,1.0
72096,72096,99.00,0,0,0,0,0,n/a,0
72097,72097,99.00,21,8,29,0.7241379310344828,0.27586206896551724,Yes,0.7241379310344828
73001,73001,53.85,130,45,175,0.7428571428571429,0.2571428571428571,Yes,0.7428571428571429
73002,73002,53.85,16,9,25,0.64,0.36,Yes,0.64
73003,73003,53.85,149,41,190,0.7842105263157895,0.21578947368421053,Yes,0.7842105263157895
73004,73004,99.00,150,71,221,0.6787330316742082,0.3212669683257919,Yes,0.6787330316742082
73005,73005,99.00,24,10,34,0.7058823529411765,0.29411764705882354,Yes,0.7058823529411765
73006,73006,99.00,98,25,123,0.7967479674796748,0.2032520325203252,Yes,0.7967479674796748
73007,73007,99.00,155,69,224,0.6919642857142857,0.3080357142857143,Yes,0.6919642857142857
73008,73008,99.00,2,0,2,1.0,0.0,Yes,1.0
73009,73009,53.85,126,50,176,0.7159090909090909,0.2840909090909091,Yes,0.7159090909090909
73010,73010,53.85,161,45,206,0.7815533980582524,0.21844660194174756,Yes,0.7815533980582524
73011,73011,53.85,164,53,217,0.7557603686635944,0.24423963133640553,Yes,0.7557603686635944
73012,73012,99.00,140,46,186,0.7526881720430108,0.24731182795698925,Yes,0.7526881720430108
73013,73013,50.00,100,32,132,0.7575757575757576,0.24242424242424243,Yes,0.7575757575757576
73014,73014,91.67,150,41,191,0.7853403141361257,0.21465968586387435,Yes,0.7853403141361257
73015,73015,91.67,9,0,9,1.0,0.0,Yes,1.0
73016,73016,99.00,134,47,181,0.7403314917127072,0.2596685082872928,Yes,0.7403314917127072
73017,73017,99.00,3,1,4,0.75,0.25,Yes,0.75
73018,73018,99.00,14,7,21,0.6666666666666666,0.3333333333333333,Yes,0.6666666666666666
73019,73019,99.00,75,27,102,0.7352941176470589,0.2647058823529412,Yes,0.7352941176470589
73020,73020,99.00,0,0,0,0,0,n/a,0
73021,73021,99.00,162,49,211,0.7677725118483413,0.23222748815165878,Yes,0.7677725118483413
73022,73022,99.00,24,2,26,0.9230769230769231,0.07692307692307693,Yes,0.9230769230769231
73023,73023,99.00,205,60,265,0.7735849056603774,0.22641509433962265,Yes,0.7735849056603774
73024,73024,0.00,7,2,9,0.7777777777777778,0.2222222222222222,Yes,0.7777777777777778
73025,73025,99.00,15,6,21,0.7142857142857143,0.2857142857142857,Yes,0.7142857142857143
73026,73026,99.00,177,81,258,0.686046511627907,0.313953488372093,Yes,0.686046511627907
73027,73027,91.67,15,2,17,0.8823529411764706,0.11764705882352941,Yes,0.8823529411764706
73028,73028,91.67,131,74,205,0.6390243902439025,0.36097560975609755,Yes,0.6390243902439025
73029,73029,91.67,178,77,255,0.6980392156862745,0.30196078431372547,Yes,0.6980392156862745
73030,73030,99.00,180,64,244,0.7377049180327869,0.26229508196721313,Yes,0.7377049180327869
73031,73031,99.00,17,8,25,0.68,0.32,Yes,0.68
73032,73032,91.67,7,4,11,0.6363636363636364,0.36363636363636365,Yes,0.6363636363636364
73033,73033,91.67,124,38,162,0.7654320987654321,0.2345679012345679,Yes,0.7654320987654321
73034,73034,91.67,6,4,10,0.6,0.4,Yes,0.6
73035,73035,91.67,191,98,289,0.6608996539792388,0.3391003460207612,Yes,0.6608996539792388
73036,73036,91.67,199,68,267,0.7453183520599251,0.2546816479400749,Yes,0.7453183520599251
73037,73037,91.67,7,3,10,0.7,0.3,Yes,0.7
73038,73038,91.67,91,41,132,0.6893939393939394,0.3106060606060606,Yes,0.6893939393939394
73039,73039,91.67,102,40,142,0.7183098591549296,0.28169014084507044,Yes,0.7183098591549296
73040,73040,91.67,3,2,5,0.6,0.4,Yes,0.6
73041,73041,91.67,198,99,297,0.6666666666666666,0.3333333333333333,Yes,0.6666666666666666
73042,73042,99.00,6,1,7,0.8571428571428571,0.14285714285714285,Yes,0.8571428571428571
73043,73043,99.00,122,27,149,0.8187919463087249,0.18120805369127516,Yes,0.8187919463087249
73044,73044,99.00,13,3,16,0.8125,0.1875,Yes,0.8125
73045,73045,99.00,55,19,74,0.7432432432432432,0.25675675675675674,Yes,0.7432432432432432
73046,73046,99.00,27,19,46,0.5869565217391305,0.41304347826086957,Yes,0.5869565217391305
73047,73047,91.67,107,33,140,0.7642857142857142,0.2357142857142857,Yes,0.7642857142857142
73048,73048,91.67,8,2,10,0.8,0.2,Yes,0.8
73049,73049,50.00,71,23,94,0.7553191489361702,0.24468085106382978,Yes,0.7553191489361702
73050,73050,99.00,126,58,184,0.6847826086956522,0.31521739130434784,Yes,0.6847826086956522
73051,73051,99.00,59,51,110,0.5363636363636364,0.4636363636363636,Yes,0.5363636363636364
73052,73052,99.00,6,8,14,0.42857142857142855,0.5714285714285714,No,0.5714285714285714
73053,73053,99.00,129,61,190,0.6789473684210526,0.32105263157894737,Yes,0.6789473684210526
73054,73054,99.00,156,70,226,0.6902654867256637,0.30973451327433627,Yes,0.6902654867256637
73055,73055,99.00,21,5,26,0.8076923076923077,0.19230769230769232,Yes,0.8076923076923077
73056,73056,99.00,81,49,130,0.6230769230769231,0.3769230769230769,Yes,0.6230769230769231
73057,73057,99.00,156,59,215,0.7255813953488373,0.2744186046511628,Yes,0.7255813953488373
73058,73058,99.00,10,7,17,0.5882352941176471,0.4117647058823529,Yes,0.5882352941176471
73059,73059,99.00,29,7,36,0.8055555555555556,0.19444444444444445,Yes,0.8055555555555556
73060,73060,99.00,19,9,28,0.6785714285714286,0.32142857142857145,Yes,0.6785714285714286
73061,73061,99.00,117,59,176,0.6647727272727273,0.3352272727272727,Yes,0.6647727272727273
73062,73062,99.00,122,56,178,0.6853932584269663,0.3146067415730337,Yes,0.6853932584269663
73063,73063,99.00,84,51,135,0.6222222222222222,0.37777777777777777,Yes,0.6222222222222222
73064,73064,99.00,34,13,47,0.723404255319149,0.2765957446808511,Yes,0.723404255319149
73065,73065,46.67,196,87,283,0.6925795053003534,0.30742049469964666,Yes,0.6925795053003534
73066,73066,99.00,25,11,36,0.6944444444444444,0.3055555555555556,Yes,0.6944444444444444
73067,73067,99.00,132,57,189,0.6984126984126984,0.30158730158730157,Yes,0.6984126984126984
73068,73068,46.67,154,50,204,0.7549019607843137,0.24509803921568626,Yes,0.7549019607843137
73069,73069,46.67,134,45,179,0.7486033519553073,0.25139664804469275,Yes,0.7486033519553073
73070,73070,46.67,37,4,41,0.9024390243902439,0.0975609756097561,Yes,0.9024390243902439
73071,73071,99.00,119,73,192,0.6197916666666666,0.3802083333333333,Yes,0.6197916666666666
73072,73072,99.00,5,1,6,0.8333333333333334,0.16666666666666666,Yes,0.8333333333333334
73073,73073,99.00,14,4,18,0.7777777777777778,0.2222222222222222,Yes,0.7777777777777778
73074,73074,99.00,225,93,318,0.7075471698113207,0.29245283018867924,Yes,0.7075471698113207
73075,73075,90.00,131,56,187,0.7005347593582888,0.2994652406417112,Yes,0.7005347593582888
73076,73076,0.00,14,8,22,0.6363636363636364,0.36363636363636365,Yes,0.6363636363636364
73077,73077,99.00,142,82,224,0.6339285714285714,0.36607142857142855,Yes,0.6339285714285714
73078,73078,0.00,20,6,26,0.7692307692307693,0.23076923076923078,Yes,0.7692307692307693
73079,73079,0.00,23,6,29,0.7931034482758621,0.20689655172413793,Yes,0.7931034482758621
73080,73080,0.00,15,4,19,0.7894736842105263,0.21052631578947367,Yes,0.7894736842105263
73081,73081,0.00,12,2,14,0.8571428571428571,0.14285714285714285,Yes,0.8571428571428571
73082,73082,0.00,15,4,19,0.7894736842105263,0.21052631578947367,Yes,0.7894736842105263
73083,73083,0.00,20,7,27,0.7407407407407407,0.25925925925925924,Yes,0.7407407407407407
73084,73084,0.00,14,1,15,0.9333333333333333,0.06666666666666667,Yes,0.9333333333333333
73085,73085,0.00,15,4,19,0.7894736842105263,0.21052631578947367,Yes,0.7894736842105263
73086,73086,0.00,17,2,19,0.8947368421052632,0.10526315789473684,Yes,0.8947368421052632
73087,73087,0.00,11,2,13,0.8461538461538461,0.15384615384615385,Yes,0.8461538461538461
73088,73088,99.00,161,66,227,0.7092511013215859,0.2907488986784141,Yes,0.7092511013215859
73089,73089,50.00,5,3,8,0.625,0.375,Yes,0.625
73090,73090,99.00,313,153,466,0.6716738197424893,0.3283261802575107,Yes,0.6716738197424893
73091,73091,99.00,5,1,6,0.8333333333333334,0.16666666666666666,Yes,0.8333333333333334
73092,73092,0.00,3,0,3,1.0,0.0,Yes,1.0
73093,73093,99.00,274,82,356,0.7696629213483146,0.2303370786516854,Yes,0.7696629213483146
73094,73094,99.00,6,0,6,1.0,0.0,Yes,1.0
73095,73095,0.00,23,2,25,0.92,0.08,Yes,0.92
73096,73096,99.00,17,2,19,0.8947368421052632,0.10526315789473684,Yes,0.8947368421052632
73097,73097,0.00,14,3,17,0.8235294117647058,0.17647058823529413,Yes,0.8235294117647058
73098,73098,0.00,13,4,17,0.7647058823529411,0.23529411764705882,Yes,0.7647058823529411
73099,73099,90.00,16,5,21,0.7619047619047619,0.23809523809523808,Yes,0.7619047619047619
73100,73100,91.67,136,48,184,0.7391304347826086,0.2608695652173913,Yes,0.7391304347826086
73101,73101,91.67,2,4,6,0.3333333333333333,0.6666666666666666,No,0.6666666666666666
73102,73102,99.00,151,61,212,0.7122641509433962,0.28773584905660377,Yes,0.7122641509433962
73103,73103,99.00,8,4,12,0.6666666666666666,0.3333333333333333,Yes,0.6666666666666666
73104,73104,99.00,179,95,274,0.6532846715328468,0.3467153284671533,Yes,0.6532846715328468
73105,73105,99.00,19,7,26,0.7307692307692307,0.2692307692307692,Yes,0.7307692307692307
73106,73106,99.00,101,39,140,0.7214285714285714,0.2785714285714286,Yes,0.7214285714285714
73107,73107,99.00,94,25,119,0.7899159663865546,0.21008403361344538,Yes,0.7899159663865546
74001,74001,99.00,34,5,39,0.8717948717948718,0.1282051282051282,Yes,0.8717948717948718
74002,74002,66.67,68,21,89,0.7640449438202247,0.23595505617977527,Yes,0.7640449438202247
74003,74003,66.67,2,1,3,0.6666666666666666,0.3333333333333333,Yes,0.6666666666666666
74004,74004,66.67,0,0,0,0,0,n/a,0
74005,74005,66.67,70,18,88,0.7954545454545454,0.20454545454545456,Yes,0.7954545454545454
74006,74006,99.00,0,1,1,0.0,1.0,No,1.0
74007,74007,66.67,99,29,128,0.7734375,0.2265625,Yes,0.7734375
74008,74008,99.00,136,30,166,0.8192771084337349,0.18072289156626506,Yes,0.8192771084337349
74009,74009,99.00,3,0,3,1.0,0.0,Yes,1.0
74010,74010,99.00,178,26,204,0.8725490196078431,0.12745098039215685,Yes,0.8725490196078431
74011,74011,99.00,73,25,98,0.7448979591836735,0.25510204081632654,Yes,0.7448979591836735
74012,74012,99.00,1,0,1,1.0,0.0,Yes,1.0
74013,74013,99.00,108,24,132,0.8181818181818182,0.18181818181818182,Yes,0.8181818181818182
74014,74014,99.00,75,17,92,0.8152173913043478,0.18478260869565216,Yes,0.8152173913043478
74015,74015,99.00,6,1,7,0.8571428571428571,0.14285714285714285,Yes,0.8571428571428571
74016,74016,99.00,4,4,8,0.5,0.5,Tie,0.5
74017,74017,99.00,73,11,84,0.8690476190476191,0.13095238095238096,Yes,0.8690476190476191
74018,74018,99.00,0,0,0,0,0,n/a,0
74019,74019,99.00,266,81,347,0.7665706051873199,0.2334293948126801,Yes,0.7665706051873199
74020,74020,99.00,6,1,7,0.8571428571428571,0.14285714285714285,Yes,0.8571428571428571
74021,74021,99.00,146,30,176,0.8295454545454546,0.17045454545454544,Yes,0.8295454545454546
74022,74022,99.00,251,42,293,0.856655290102389,0.14334470989761092,Yes,0.856655290102389
74023,74023,99.00,134,37,171,0.783625730994152,0.21637426900584794,Yes,0.783625730994152
74024,74024,99.00,5,0,5,1.0,0.0,Yes,1.0
74025,74025,99.00,75,11,86,0.872093023255814,0.12790697674418605,Yes,0.872093023255814
74026,74026,99.00,2,0,2,1.0,0.0,Yes,1.0
74027,74027,99.00,83,37,120,0.6916666666666667,0.30833333333333335,Yes,0.6916666666666667
74028,74028,99.00,0,0,0,0,0,n/a,0
74029,74029,99.00,80,21,101,0.7920792079207921,0.2079207920792079,Yes,0.7920792079207921
74030,74030,99.00,3,0,3,1.0,0.0,Yes,1.0
74031,74031,99.00,155,47,202,0.7673267326732673,0.23267326732673269,Yes,0.7673267326732673
74032,74032,99.00,253,49,302,0.8377483443708609,0.16225165562913907,Yes,0.8377483443708609
74033,74033,99.00,172,33,205,0.8390243902439024,0.16097560975609757,Yes,0.8390243902439024
74034,74034,99.00,144,38,182,0.7912087912087912,0.2087912087912088,Yes,0.7912087912087912
74035,74035,99.00,118,34,152,0.7763157894736842,0.2236842105263158,Yes,0.7763157894736842
74036,74036,99.00,57,20,77,0.7402597402597403,0.2597402597402597,Yes,0.7402597402597403
74037,74037,99.00,6,2,8,0.75,0.25,Yes,0.75
74038,74038,99.00,7,1,8,0.875,0.125,Yes,0.875
74039,74039,99.00,238,100,338,0.7041420118343196,0.2958579881656805,Yes,0.7041420118343196
74040,74040,99.00,191,47,238,0.8025210084033614,0.19747899159663865,Yes,0.8025210084033614
74041,74041,99.00,170,54,224,0.7589285714285714,0.24107142857142858,Yes,0.7589285714285714
74042,74042,99.00,17,5,22,0.7727272727272727,0.22727272727272727,Yes,0.7727272727272727
74043,74043,99.00,346,125,471,0.7346072186836518,0.2653927813163482,Yes,0.7346072186836518
74044,74044,99.00,22,6,28,0.7857142857142857,0.21428571428571427,Yes,0.7857142857142857
74045,74045,99.00,189,64,253,0.7470355731225297,0.25296442687747034,Yes,0.7470355731225297
74046,74046,99.00,268,77,345,0.7768115942028986,0.22318840579710145,Yes,0.7768115942028986
74047,74047,99.00,183,58,241,0.7593360995850622,0.24066390041493776,Yes,0.7593360995850622
74048,74048,99.00,19,6,25,0.76,0.24,Yes,0.76
74049,74049,99.00,285,102,387,0.7364341085271318,0.26356589147286824,Yes,0.7364341085271318
74050,74050,99.00,9,4,13,0.6923076923076923,0.3076923076923077,Yes,0.6923076923076923
74051,74051,99.00,276,115,391,0.7058823529411765,0.29411764705882354,Yes,0.7058823529411765
74052,74052,99.00,11,3,14,0.7857142857142857,0.21428571428571427,Yes,0.7857142857142857
74053,74053,99.00,106,19,125,0.848,0.152,Yes,0.848
74054,74054,99.00,251,51,302,0.8311258278145696,0.16887417218543047,Yes,0.8311258278145696
74055,74055,99.00,50,11,61,0.819672131147541,0.18032786885245902,Yes,0.819672131147541
74056,74056,33.33,135,27,162,0.8333333333333334,0.16666666666666666,Yes,0.8333333333333334
74057,74057,99.00,174,44,218,0.7981651376146789,0.2018348623853211,Yes,0.7981651376146789
74058,74058,99.00,46,7,53,0.8679245283018868,0.1320754716981132,Yes,0.8679245283018868
74059,74059,99.00,182,48,230,0.7913043478260869,0.20869565217391303,Yes,0.7913043478260869
74060,74060,33.33,122,28,150,0.8133333333333334,0.18666666666666668,Yes,0.8133333333333334
74061,74061,99.00,222,57,279,0.7956989247311828,0.20430107526881722,Yes,0.7956989247311828
74062,74062,80.00,188,56,244,0.7704918032786885,0.22950819672131148,Yes,0.7704918032786885
74063,74063,80.00,14,2,16,0.875,0.125,Yes,0.875
74064,74064,80.00,189,51,240,0.7875,0.2125,Yes,0.7875
74065,74065,80.00,9,2,11,0.8181818181818182,0.18181818181818182,Yes,0.8181818181818182
74066,74066,80.00,199,51,250,0.796,0.204,Yes,0.796
74067,74067,99.00,229,72,301,0.760797342192691,0.23920265780730898,Yes,0.760797342192691
74068,74068,99.00,25,6,31,0.8064516129032258,0.1935483870967742,Yes,0.8064516129032258
74069,74069,99.00,67,17,84,0.7976190476190477,0.20238095238095238,Yes,0.7976190476190477
74070,74070,99.00,163,47,210,0.7761904761904762,0.22380952380952382,Yes,0.7761904761904762
74071,74071,99.00,11,1,12,0.9166666666666666,0.08333333333333333,Yes,0.9166666666666666
74072,74072,99.00,169,58,227,0.7444933920704846,0.2555066079295154,Yes,0.7444933920704846
74073,74073,99.00,135,51,186,0.7258064516129032,0.27419354838709675,Yes,0.7258064516129032
74074,74074,99.00,10,1,11,0.9090909090909091,0.09090909090909091,Yes,0.9090909090909091
74075,74075,99.00,29,4,33,0.8787878787878788,0.12121212121212122,Yes,0.8787878787878788
74076,74076,99.00,257,93,350,0.7342857142857143,0.26571428571428574,Yes,0.7342857142857143
74077,74077,99.00,13,4,17,0.7647058823529411,0.23529411764705882,Yes,0.7647058823529411
74078,74078,99.00,162,51,213,0.7605633802816901,0.23943661971830985,Yes,0.7605633802816901
74079,74079,99.00,201,57,258,0.7790697674418605,0.22093023255813954,Yes,0.7790697674418605
74080,74080,99.00,6,1,7,0.8571428571428571,0.14285714285714285,Yes,0.8571428571428571
74081,74081,99.00,4,3,7,0.5714285714285714,0.42857142857142855,Yes,0.5714285714285714
74082,74082,53.85,32,3,35,0.9142857142857143,0.08571428571428572,Yes,0.9142857142857143
74083,74083,99.00,290,99,389,0.7455012853470437,0.2544987146529563,Yes,0.7455012853470437
74084,74084,99.00,36,15,51,0.7058823529411765,0.29411764705882354,Yes,0.7058823529411765
74085,74085,99.00,4,5,9,0.4444444444444444,0.5555555555555556,No,0.5555555555555556
74086,74086,99.00,3,3,6,0.5,0.5,Tie,0.5
74087,74087,99.00,169,73,242,0.6983471074380165,0.30165289256198347,Yes,0.6983471074380165
74088,74088,99.00,255,98,353,0.7223796033994334,0.2776203966005666,Yes,0.7223796033994334
74089,74089,99.00,13,3,16,0.8125,0.1875,Yes,0.8125
74090,74090,99.00,125,33,158,0.7911392405063291,0.2088607594936709,Yes,0.7911392405063291
74091,74091,99.00,165,52,217,0.7603686635944701,0.23963133640552994,Yes,0.7603686635944701
74092,74092,99.00,22,4,26,0.8461538461538461,0.15384615384615385,Yes,0.8461538461538461
74093,74093,99.00,0,0,0,0,0,n/a,0
74094,74094,99.00,0,0,0,0,0,n/a,0
74095,74095,99.00,0,0,0,0,0,n/a,0
74096,74096,99.00,0,0,0,0,0,n/a,0
74097,74097,99.00,0,0,0,0,0,n/a,0
74098,74098,80.00,17,5,22,0.7727272727272727,0.22727272727272727,Yes,0.7727272727272727
74099,74099,99.00,13,4,17,0.7647058823529411,0.23529411764705882,Yes,0.7647058823529411
74100,74100,99.00,7,1,8,0.875,0.125,Yes,0.875
74101,74101,53.85,193,57,250,0.772,0.228,Yes,0.772
74102,74102,53.85,24,4,28,0.8571428571428571,0.14285714285714285,Yes,0.8571428571428571
74103,74103,99.00,14,9,23,0.6086956521739131,0.391304347826087,Yes,0.6086956521739131
74104,74104,99.00,131,29,160,0.81875,0.18125,Yes,0.81875
74105,74105,99.00,231,48,279,0.8279569892473119,0.17204301075268819,Yes,0.8279569892473119
74106,74106,99.00,10,0,10,1.0,0.0,Yes,1.0
74107,74107,99.00,13,4,17,0.7647058823529411,0.23529411764705882,Yes,0.7647058823529411
75001,75001,33.33,224,59,283,0.7915194346289752,0.20848056537102475,Yes,0.7915194346289752
75002,75002,99.00,233,49,282,0.8262411347517731,0.17375886524822695,Yes,0.8262411347517731
75003,75003,99.00,99,15,114,0.868421052631579,0.13157894736842105,Yes,0.868421052631579
75004,75004,99.00,29,5,34,0.8529411764705882,0.14705882352941177,Yes,0.8529411764705882
75005,75005,33.33,25,0,25,1.0,0.0,Yes,1.0
75006,75006,33.33,280,70,350,0.8,0.2,Yes,0.8
75007,75007,99.00,159,33,192,0.828125,0.171875,Yes,0.828125
75008,75008,99.00,162,30,192,0.84375,0.15625,Yes,0.84375
75009,75009,99.00,102,27,129,0.7906976744186046,0.20930232558139536,Yes,0.7906976744186046
75010,75010,99.00,134,29,163,0.8220858895705522,0.17791411042944785,Yes,0.8220858895705522
75011,75011,99.00,122,22,144,0.8472222222222222,0.1527777777777778,Yes,0.8472222222222222
75012,75012,99.00,125,41,166,0.7530120481927711,0.2469879518072289,Yes,0.7530120481927711
75013,75013,99.00,214,46,260,0.823076923076923,0.17692307692307693,Yes,0.823076923076923
75014,75014,99.00,49,12,61,0.8032786885245902,0.19672131147540983,Yes,0.8032786885245902
75015,75015,99.00,199,46,245,0.8122448979591836,0.18775510204081633,Yes,0.8122448979591836
75016,75016,99.00,10,1,11,0.9090909090909091,0.09090909090909091,Yes,0.9090909090909091
75017,75017,99.00,129,31,160,0.80625,0.19375,Yes,0.80625
75018,75018,99.00,6,0,6,1.0,0.0,Yes,1.0
75019,75019,99.00,259,50,309,0.8381877022653722,0.16181229773462782,Yes,0.8381877022653722
75020,75020,99.00,12,0,12,1.0,0.0,Yes,1.0
75021,75021,99.00,11,0,11,1.0,0.0,Yes,1.0
75022,75022,99.00,242,49,291,0.8316151202749141,0.16838487972508592,Yes,0.8316151202749141
75023,75023,99.00,251,70,321,0.7819314641744548,0.21806853582554517,Yes,0.7819314641744548
75024,75024,99.00,11,0,11,1.0,0.0,Yes,1.0
75025,75025,99.00,290,54,344,0.8430232558139535,0.1569767441860465,Yes,0.8430232558139535
75026,75026,99.00,9,0,9,1.0,0.0,Yes,1.0
75027,75027,33.33,24,6,30,0.8,0.2,Yes,0.8
75028,75028,99.00,161,24,185,0.8702702702702703,0.12972972972972974,Yes,0.8702702702702703
75029,75029,99.00,68,25,93,0.7311827956989247,0.26881720430107525,Yes,0.7311827956989247
75030,75030,99.00,12,8,20,0.6,0.4,Yes,0.6
75031,75031,99.00,101,35,136,0.7426470588235294,0.25735294117647056,Yes,0.7426470588235294
75032,75032,99.00,138,50,188,0.7340425531914894,0.26595744680851063,Yes,0.7340425531914894
75033,75033,99.00,191,59,250,0.764,0.236,Yes,0.764
75034,75034,99.00,58,17,75,0.7733333333333333,0.22666666666666666,Yes,0.7733333333333333
75035,75035,99.00,8,1,9,0.8888888888888888,0.1111111111111111,Yes,0.8888888888888888
75036,75036,99.00,108,30,138,0.782608695652174,0.21739130434782608,Yes,0.782608695652174
75037,75037,99.00,140,39,179,0.7821229050279329,0.21787709497206703,Yes,0.7821229050279329
75038,75038,99.00,394,68,462,0.8528138528138528,0.1471861471861472,Yes,0.8528138528138528
75039,75039,99.00,9,1,10,0.9,0.1,Yes,0.9
75040,75040,99.00,138,43,181,0.7624309392265194,0.23756906077348067,Yes,0.7624309392265194
75041,75041,99.00,5,0,5,1.0,0.0,Yes,1.0
75042,75042,99.00,1,1,2,0.5,0.5,Tie,0.5
75043,75043,99.00,296,51,347,0.8530259365994236,0.14697406340057637,Yes,0.8530259365994236
75044,75044,99.00,244,49,293,0.8327645051194539,0.16723549488054607,Yes,0.8327645051194539
75045,75045,99.00,200,36,236,0.847457627118644,0.15254237288135594,Yes,0.847457627118644
75046,75046,99.00,1,0,1,1.0,0.0,Yes,1.0
75047,75047,99.00,7,0,7,1.0,0.0,Yes,1.0
75048,75048,99.00,206,48,254,0.8110236220472441,0.1889763779527559,Yes,0.8110236220472441
75049,75049,99.00,117,31,148,0.7905405405405406,0.20945945945945946,Yes,0.7905405405405406
75050,75050,99.00,64,17,81,0.7901234567901234,0.20987654320987653,Yes,0.7901234567901234
75051,75051,99.00,103,25,128,0.8046875,0.1953125,Yes,0.8046875
75052,75052,99.00,25,3,28,0.8928571428571429,0.10714285714285714,Yes,0.8928571428571429
75053,75053,53.85,159,48,207,0.7681159420289855,0.2318840579710145,Yes,0.7681159420289855
75054,75054,53.85,29,13,42,0.6904761904761905,0.30952380952380953,Yes,0.6904761904761905
75055,75055,53.85,24,7,31,0.7741935483870968,0.22580645161290322,Yes,0.7741935483870968
75056,75056,99.00,181,47,228,0.793859649122807,0.20614035087719298,Yes,0.793859649122807
75057,75057,99.00,2,3,5,0.4,0.6,No,0.6
75058,75058,99.00,72,27,99,0.7272727272727273,0.2727272727272727,Yes,0.7272727272727273
75059,75059,80.00,197,57,254,0.7755905511811023,0.22440944881889763,Yes,0.7755905511811023
75060,75060,99.00,10,3,13,0.7692307692307693,0.23076923076923078,Yes,0.7692307692307693
75061,75061,99.00,0,0,0,0,0,n/a,0
75062,75062,99.00,157,36,193,0.8134715025906736,0.18652849740932642,Yes,0.8134715025906736
75063,75063,99.00,106,26,132,0.803030303030303,0.19696969696969696,Yes,0.803030303030303
75064,75064,80.00,10,4,14,0.7142857142857143,0.2857142857142857,Yes,0.7142857142857143
75065,75065,99.00,37,25,62,0.5967741935483871,0.4032258064516129,Yes,0.5967741935483871
75066,75066,99.00,240,85,325,0.7384615384615385,0.26153846153846155,Yes,0.7384615384615385
75067,75067,99.00,108,28,136,0.7941176470588235,0.20588235294117646,Yes,0.7941176470588235
75068,75068,99.00,18,2,20,0.9,0.1,Yes,0.9
75069,75069,99.00,103,38,141,0.7304964539007093,0.2695035460992908,Yes,0.7304964539007093
75070,75070,99.00,174,47,221,0.7873303167420814,0.21266968325791855,Yes,0.7873303167420814
75071,75071,99.00,397,83,480,0.8270833333333333,0.17291666666666666,Yes,0.8270833333333333
75072,75072,99.00,377,49,426,0.8849765258215962,0.11502347417840375,Yes,0.8849765258215962
75073,75073,99.00,121,27,148,0.8175675675675675,0.18243243243243243,Yes,0.8175675675675675
75074,75074,99.00,70,19,89,0.7865168539325843,0.21348314606741572,Yes,0.7865168539325843
75075,75075,99.00,58,29,87,0.6666666666666666,0.3333333333333333,Yes,0.6666666666666666
75076,75076,99.00,11,2,13,0.8461538461538461,0.15384615384615385,Yes,0.8461538461538461
75077,75077,99.00,13,1,14,0.9285714285714286,0.07142857142857142,Yes,0.9285714285714286
75078,75078,99.00,15,1,16,0.9375,0.0625,Yes,0.9375
75079,75079,99.00,12,3,15,0.8,0.2,Yes,0.8
75080,75080,99.00,23,1,24,0.9583333333333334,0.041666666666666664,Yes,0.9583333333333334
75081,75081,99.00,7,1,8,0.875,0.125,Yes,0.875
75082,75082,99.00,278,57,335,0.8298507462686567,0.1701492537313433,Yes,0.8298507462686567
75083,75083,99.00,214,45,259,0.8262548262548263,0.17374517374517376,Yes,0.8262548262548263
75084,75084,99.00,5,1,6,0.8333333333333334,0.16666666666666666,Yes,0.8333333333333334
75085,75085,99.00,14,3,17,0.8235294117647058,0.17647058823529413,Yes,0.8235294117647058
75086,75086,99.00,4,1,5,0.8,0.2,Yes,0.8
75087,75087,99.00,171,58,229,0.7467248908296943,0.25327510917030566,Yes,0.7467248908296943
75088,75088,99.00,3,4,7,0.42857142857142855,0.5714285714285714,No,0.5714285714285714
75089,75089,99.00,9,2,11,0.8181818181818182,0.18181818181818182,Yes,0.8181818181818182
75090,75090,99.00,9,3,12,0.75,0.25,Yes,0.75
75091,75091,99.00,116,52,168,0.6904761904761905,0.30952380952380953,Yes,0.6904761904761905
75092,75092,99.00,100,40,140,0.7142857142857143,0.2857142857142857,Yes,0.7142857142857143
75093,75093,99.00,65,17,82,0.7926829268292683,0.2073170731707317,Yes,0.7926829268292683
75094,75094,99.00,6,4,10,0.6,0.4,Yes,0.6
75095,75095,99.00,4,0,4,1.0,0.0,Yes,1.0
75096,75096,99.00,15,6,21,0.7142857142857143,0.2857142857142857,Yes,0.7142857142857143
75097,75097,99.00,196,70,266,0.7368421052631579,0.2631578947368421,Yes,0.7368421052631579
75098,75098,99.00,21,8,29,0.7241379310344828,0.27586206896551724,Yes,0.7241379310344828
75099,75099,99.00,207,48,255,0.8117647058823529,0.18823529411764706,Yes,0.8117647058823529
75100,75100,99.00,20,5,25,0.8,0.2,Yes,0.8
75101,75101,99.00,0,0,0,0,0,n/a,0
75102,75102,99.00,0,0,0,0,0,n/a,0
75103,75103,99.00,0,0,0,0,0,n/a,0
75104,75104,99.00,0,0,0,0,0,n/a,0
75105,75105,99.00,0,0,0,0,0,n/a,0
75106,75106,99.00,0,0,0,0,0,n/a,0
75107,75107,99.00,23,1,24,0.9583333333333334,0.041666666666666664,Yes,0.9583333333333334
75108,75108,99.00,144,36,180,0.8,0.2,Yes,0.8
75109,75109,99.00,7,4,11,0.6363636363636364,0.36363636363636365,Yes,0.6363636363636364
75110,75110,99.00,15,2,17,0.8823529411764706,0.11764705882352941,Yes,0.8823529411764706
75111,75111,99.00,215,40,255,0.8431372549019608,0.1568627450980392,Yes,0.8431372549019608
75112,75112,99.00,288,58,346,0.8323699421965318,0.1676300578034682,Yes,0.8323699421965318
75113,75113,99.00,3,0,3,1.0,0.0,Yes,1.0
75114,75114,99.00,8,1,9,0.8888888888888888,0.1111111111111111,Yes,0.8888888888888888
75115,75115,99.00,222,57,279,0.7956989247311828,0.20430107526881722,Yes,0.7956989247311828
76001,76001,99.00,218,65,283,0.7703180212014135,0.22968197879858657,Yes,0.7703180212014135
76002,76002,99.00,134,54,188,0.7127659574468085,0.2872340425531915,Yes,0.7127659574468085
76003,76003,99.00,10,3,13,0.7692307692307693,0.23076923076923078,Yes,0.7692307692307693
76004,76004,99.00,14,3,17,0.8235294117647058,0.17647058823529413,Yes,0.8235294117647058
76005,76005,99.00,9,3,12,0.75,0.25,Yes,0.75
76006,76006,99.00,169,69,238,0.7100840336134454,0.28991596638655465,Yes,0.7100840336134454
76007,76007,99.00,160,67,227,0.7048458149779736,0.29515418502202645,Yes,0.7048458149779736
76008,76008,99.00,12,3,15,0.8,0.2,Yes,0.8
76009,76009,99.00,110,56,166,0.6626506024096386,0.3373493975903614,Yes,0.6626506024096386
76010,76010,99.00,186,72,258,0.7209302325581395,0.27906976744186046,Yes,0.7209302325581395
76011,76011,99.00,15,3,18,0.8333333333333334,0.16666666666666666,Yes,0.8333333333333334
76012,76012,99.00,142,65,207,0.6859903381642513,0.3140096618357488,Yes,0.6859903381642513
76013,76013,99.00,23,4,27,0.8518518518518519,0.14814814814814814,Yes,0.8518518518518519
76014,76014,99.00,138,70,208,0.6634615384615384,0.33653846153846156,Yes,0.6634615384615384
76015,76015,99.00,23,5,28,0.8214285714285714,0.17857142857142858,Yes,0.8214285714285714
76016,76016,99.00,294,97,391,0.7519181585677749,0.24808184143222506,Yes,0.7519181585677749
76017,76017,99.00,8,6,14,0.5714285714285714,0.42857142857142855,Yes,0.5714285714285714
76018,76018,99.00,15,3,18,0.8333333333333334,0.16666666666666666,Yes,0.8333333333333334
76019,76019,0.00,19,2,21,0.9047619047619048,0.09523809523809523,Yes,0.9047619047619048
76020,76020,99.00,191,79,270,0.7074074074074074,0.29259259259259257,Yes,0.7074074074074074
76021,76021,99.00,228,89,317,0.7192429022082019,0.2807570977917981,Yes,0.7192429022082019
76022,76022,0.00,7,3,10,0.7,0.3,Yes,0.7
76023,76023,0.00,10,3,13,0.7692307692307693,0.23076923076923078,Yes,0.7692307692307693
76024,76024,0.00,29,6,35,0.8285714285714286,0.17142857142857143,Yes,0.8285714285714286
76025,76025,0.00,42,10,52,0.8076923076923077,0.19230769230769232,Yes,0.8076923076923077
76026,76026,0.00,29,7,36,0.8055555555555556,0.19444444444444445,Yes,0.8055555555555556
76027,76027,0.00,22,6,28,0.7857142857142857,0.21428571428571427,Yes,0.7857142857142857
76028,76028,0.00,34,11,45,0.7555555555555555,0.24444444444444444,Yes,0.7555555555555555
76029,76029,99.00,78,30,108,0.7222222222222222,0.2777777777777778,Yes,0.7222222222222222
76030,76030,46.67,26,16,42,0.6190476190476191,0.38095238095238093,Yes,0.6190476190476191
76031,76031,0.00,18,8,26,0.6923076923076923,0.3076923076923077,Yes,0.6923076923076923
76032,76032,0.00,15,5,20,0.75,0.25,Yes,0.75
76033,76033,99.00,184,70,254,0.7244094488188977,0.2755905511811024,Yes,0.7244094488188977
76034,76034,0.00,59,24,83,0.7108433734939759,0.2891566265060241,Yes,0.7108433734939759
76035,76035,0.00,16,2,18,0.8888888888888888,0.1111111111111111,Yes,0.8888888888888888
76036,76036,99.00,12,2,14,0.8571428571428571,0.14285714285714285,Yes,0.8571428571428571
76037,76037,46.67,208,94,302,0.6887417218543046,0.31125827814569534,Yes,0.6887417218543046
76038,76038,46.67,41,8,49,0.8367346938775511,0.16326530612244897,Yes,0.8367346938775511
76039,76039,46.67,197,84,281,0.701067615658363,0.298932384341637,Yes,0.701067615658363
76040,76040,0.00,23,2,25,0.92,0.08,Yes,0.92
76041,76041,0.00,22,0,22,1.0,0.0,Yes,1.0
76042,76042,0.00,29,9,38,0.7631578947368421,0.23684210526315788,Yes,0.7631578947368421
76043,76043,0.00,18,3,21,0.8571428571428571,0.14285714285714285,Yes,0.8571428571428571
76044,76044,0.00,15,4,19,0.7894736842105263,0.21052631578947367,Yes,0.7894736842105263
76045,76045,0.00,18,4,22,0.8181818181818182,0.18181818181818182,Yes,0.8181818181818182
76046,76046,46.67,48,16,64,0.75,0.25,Yes,0.75
76047,76047,46.67,137,54,191,0.7172774869109948,0.28272251308900526,Yes,0.7172774869109948
76048,76048,90.00,223,68,291,0.7663230240549829,0.23367697594501718,Yes,0.7663230240549829
76049,76049,0.00,30,11,41,0.7317073170731707,0.2682926829268293,Yes,0.7317073170731707
76050,76050,0.00,14,7,21,0.6666666666666666,0.3333333333333333,Yes,0.6666666666666666
76051,76051,0.00,35,11,46,0.7608695652173914,0.2391304347826087,Yes,0.7608695652173914
76052,76052,90.00,222,70,292,0.7602739726027398,0.23972602739726026,Yes,0.7602739726027398
76053,76053,90.00,18,4,22,0.8181818181818182,0.18181818181818182,Yes,0.8181818181818182
76054,76054,90.00,123,56,179,0.6871508379888268,0.3128491620111732,Yes,0.6871508379888268
76055,76055,99.00,181,57,238,0.7605042016806722,0.23949579831932774,Yes,0.7605042016806722
76056,76056,90.00,15,3,18,0.8333333333333334,0.16666666666666666,Yes,0.8333333333333334
76057,76057,90.00,238,90,328,0.725609756097561,0.27439024390243905,Yes,0.725609756097561
76058,76058,0.00,21,8,29,0.7241379310344828,0.27586206896551724,Yes,0.7241379310344828
76059,76059,90.00,27,8,35,0.7714285714285715,0.22857142857142856,Yes,0.7714285714285715
76060,76060,90.00,222,66,288,0.7708333333333334,0.22916666666666666,Yes,0.7708333333333334
76061,76061,90.00,15,3,18,0.8333333333333334,0.16666666666666666,Yes,0.8333333333333334
76062,76062,90.00,191,67,258,0.7403100775193798,0.2596899224806202,Yes,0.7403100775193798
76063,76063,90.00,16,3,19,0.8421052631578947,0.15789473684210525,Yes,0.8421052631578947
76064,76064,0.00,13,4,17,0.7647058823529411,0.23529411764705882,Yes,0.7647058823529411
76065,76065,99.00,175,65,240,0.7291666666666666,0.2708333333333333,Yes,0.7291666666666666
76066,76066,0.00,17,4,21,0.8095238095238095,0.19047619047619047,Yes,0.8095238095238095
76067,76067,99.00,255,88,343,0.7434402332361516,0.2565597667638484,Yes,0.7434402332361516
76068,76068,0.00,25,7,32,0.78125,0.21875,Yes,0.78125
76069,76069,99.00,29,9,38,0.7631578947368421,0.23684210526315788,Yes,0.7631578947368421
76070,76070,0.00,16,7,23,0.6956521739130435,0.30434782608695654,Yes,0.6956521739130435
76071,76071,0.00,25,5,30,0.8333333333333334,0.16666666666666666,Yes,0.8333333333333334
76072,76072,0.00,38,7,45,0.8444444444444444,0.15555555555555556,Yes,0.8444444444444444
76073,76073,0.00,7,2,9,0.7777777777777778,0.2222222222222222,Yes,0.7777777777777778
76074,76074,0.00,13,2,15,0.8666666666666667,0.13333333333333333,Yes,0.8666666666666667
76075,76075,0.00,16,5,21,0.7619047619047619,0.23809523809523808,Yes,0.7619047619047619
76076,76076,99.00,168,37,205,0.8195121951219512,0.18048780487804877,Yes,0.8195121951219512
76077,76077,0.00,25,1,26,0.9615384615384616,0.038461538461538464,Yes,0.9615384615384616
76078,76078,99.00,8,1,9,0.8888888888888888,0.1111111111111111,Yes,0.8888888888888888
76079,76079,99.00,229,85,314,0.7292993630573248,0.27070063694267515,Yes,0.7292993630573248
76080,76080,99.00,248,54,302,0.8211920529801324,0.17880794701986755,Yes,0.8211920529801324
76081,76081,99.00,3,2,5,0.6,0.4,Yes,0.6
76082,76082,99.00,92,31,123,0.7479674796747967,0.25203252032520324,Yes,0.7479674796747967
76083,76083,99.00,311,72,383,0.8120104438642297,0.18798955613577023,Yes,0.8120104438642297
76084,76084,99.00,6,3,9,0.6666666666666666,0.3333333333333333,Yes,0.6666666666666666
76085,76085,99.00,200,41,241,0.8298755186721992,0.17012448132780084,Yes,0.8298755186721992
76086,76086,99.00,8,0,8,1.0,0.0,Yes,1.0
76087,76087,99.00,47,11,58,0.8103448275862069,0.1896551724137931,Yes,0.8103448275862069
76088,76088,46.67,51,21,72,0.7083333333333334,0.2916666666666667,Yes,0.7083333333333334
76089,76089,90.00,177,57,234,0.7564102564102564,0.24358974358974358,Yes,0.7564102564102564
76090,76090,0.00,0,0,0,0,0,n/a,0
76091,76091,99.00,0,0,0,0,0,n/a,0
76092,76092,99.00,0,0,0,0,0,n/a,0
76093,76093,99.00,0,0,0,0,0,n/a,0
76094,76094,0.00,0,0,0,0,0,n/a,0
76095,76095,99.00,0,0,0,0,0,n/a,0
76096,76096,99.00,0,0,0,0,0,n/a,0
76097,76097,0.00,0,0,0,0,0,n/a,0
76098,76098,99.00,0,0,0,0,0,n/a,0
76099,76099,90.00,22,4,26,0.8461538461538461,0.15384615384615385,Yes,0.8461538461538461
76100,76100,0.00,27,4,31,0.8709677419354839,0.12903225806451613,Yes,0.8709677419354839
76101,76101,99.00,26,7,33,0.7878787878787878,0.21212121212121213,Yes,0.7878787878787878
76102,76102,99.00,13,6,19,0.6842105263157895,0.3157894736842105,Yes,0.6842105263157895
76103,76103,0.00,5,4,9,0.5555555555555556,0.4444444444444444,Yes,0.5555555555555556
77001,77001,99.00,2,0,2,1.0,0.0,Yes,1.0
77002,77002,99.00,67,22,89,0.7528089887640449,0.24719101123595505,Yes,0.7528089887640449
77003,77003,99.00,127,28,155,0.8193548387096774,0.18064516129032257,Yes,0.8193548387096774
77004,77004,99.00,1,1,2,0.5,0.5,Tie,0.5
77005,77005,99.00,101,42,143,0.7062937062937062,0.2937062937062937,Yes,0.7062937062937062
77006,77006,99.00,65,12,77,0.8441558441558441,0.15584415584415584,Yes,0.8441558441558441
77007,77007,99.00,72,22,94,0.7659574468085106,0.23404255319148937,Yes,0.7659574468085106
77008,77008,99.00,50,13,63,0.7936507936507936,0.20634920634920634,Yes,0.7936507936507936
77009,77009,99.00,64,16,80,0.8,0.2,Yes,0.8
77010,77010,99.00,151,46,197,0.766497461928934,0.233502538071066,Yes,0.766497461928934
77011,77011,99.00,47,12,59,0.7966101694915254,0.2033898305084746,Yes,0.7966101694915254
77012,77012,99.00,113,21,134,0.8432835820895522,0.15671641791044777,Yes,0.8432835820895522
77013,77013,99.00,0,0,0,0,0,n/a,0
77014,77014,99.00,110,30,140,0.7857142857142857,0.21428571428571427,Yes,0.7857142857142857
77015,77015,99.00,0,0,0,0,0,n/a,0
77016,77016,99.00,85,21,106,0.8018867924528302,0.19811320754716982,Yes,0.8018867924528302
77017,77017,99.00,87,23,110,0.7909090909090909,0.20909090909090908,Yes,0.7909090909090909
77018,77018,0.00,3,0,3,1.0,0.0,Yes,1.0
77019,77019,99.00,67,22,89,0.7528089887640449,0.24719101123595505,Yes,0.7528089887640449
77020,77020,99.00,1,0,1,1.0,0.0,Yes,1.0
77021,77021,99.00,81,18,99,0.8181818181818182,0.18181818181818182,Yes,0.8181818181818182
77022,77022,99.00,90,19,109,0.8256880733944955,0.1743119266055046,Yes,0.8256880733944955
77023,77023,99.00,65,21,86,0.7558139534883721,0.2441860465116279,Yes,0.7558139534883721
77024,77024,99.00,0,1,1,0.0,1.0,No,1.0
77025,77025,99.00,114,31,145,0.7862068965517242,0.21379310344827587,Yes,0.7862068965517242
77026,77026,99.00,0,0,0,0,0,n/a,0
77027,77027,99.00,71,16,87,0.8160919540229885,0.1839080459770115,Yes,0.8160919540229885
77028,77028,99.00,102,22,124,0.8225806451612904,0.1774193548387097,Yes,0.8225806451612904
77029,77029,99.00,4,0,4,1.0,0.0,Yes,1.0
77030,77030,99.00,0,0,0,0,0,n/a,0
77031,77031,99.00,55,19,74,0.7432432432432432,0.25675675675675674,Yes,0.7432432432432432
77032,77032,0.00,1,0,1,1.0,0.0,Yes,1.0
77033,77033,0.00,0,0,0,0,0,n/a,0
77034,77034,0.00,0,0,0,0,0,n/a,0
77035,77035,0.00,1,0,1,1.0,0.0,Yes,1.0
77036,77036,0.00,2,0,2,1.0,0.0,Yes,1.0
77037,77037,99.00,83,29,112,0.7410714285714286,0.25892857142857145,Yes,0.7410714285714286
77038,77038,99.00,1,0,1,1.0,0.0,Yes,1.0
77039,77039,99.00,111,25,136,0.8161764705882353,0.18382352941176472,Yes,0.8161764705882353
77040,77040,99.00,2,0,2,1.0,0.0,Yes,1.0
77041,77041,99.00,2,0,2,1.0,0.0,Yes,1.0
77042,77042,99.00,106,27,133,0.7969924812030075,0.20300751879699247,Yes,0.7969924812030075
77043,77043,99.00,76,11,87,0.8735632183908046,0.12643678160919541,Yes,0.8735632183908046
77044,77044,99.00,105,19,124,0.8467741935483871,0.1532258064516129,Yes,0.8467741935483871
77045,77045,99.00,84,24,108,0.7777777777777778,0.2222222222222222,Yes,0.7777777777777778
77046,77046,99.00,0,0,0,0,0,n/a,0
77047,77047,99.00,135,30,165,0.8181818181818182,0.18181818181818182,Yes,0.8181818181818182
77048,77048,99.00,121,32,153,0.7908496732026143,0.20915032679738563,Yes,0.7908496732026143
77049,77049,55.56,141,37,178,0.7921348314606742,0.20786516853932585,Yes,0.7921348314606742
77050,77050,99.00,149,26,175,0.8514285714285714,0.14857142857142858,Yes,0.8514285714285714
77051,77051,99.00,2,0,2,1.0,0.0,Yes,1.0
77052,77052,99.00,10,2,12,0.8333333333333334,0.16666666666666666,Yes,0.8333333333333334
77053,77053,99.00,130,13,143,0.9090909090909091,0.09090909090909091,Yes,0.9090909090909091
77054,77054,99.00,46,6,52,0.8846153846153846,0.11538461538461539,Yes,0.8846153846153846
77055,77055,99.00,107,24,131,0.816793893129771,0.183206106870229,Yes,0.816793893129771
77056,77056,99.00,3,0,3,1.0,0.0,Yes,1.0
77057,77057,99.00,4,1,5,0.8,0.2,Yes,0.8
77058,77058,99.00,210,53,263,0.7984790874524715,0.20152091254752852,Yes,0.7984790874524715
77059,77059,55.56,7,3,10,0.7,0.3,Yes,0.7
77060,77060,55.56,12,4,16,0.75,0.25,Yes,0.75
77061,77061,55.56,119,38,157,0.7579617834394905,0.24203821656050956,Yes,0.7579617834394905
77062,77062,99.00,64,22,86,0.7441860465116279,0.2558139534883721,Yes,0.7441860465116279
77063,77063,99.00,3,0,3,1.0,0.0,Yes,1.0
77064,77064,99.00,2,0,2,1.0,0.0,Yes,1.0
77065,77065,99.00,52,16,68,0.7647058823529411,0.23529411764705882,Yes,0.7647058823529411
77066,77066,99.00,109,44,153,0.7124183006535948,0.2875816993464052,Yes,0.7124183006535948
77067,77067,99.00,0,0,0,0,0,n/a,0
77068,77068,99.00,52,17,69,0.7536231884057971,0.2463768115942029,Yes,0.7536231884057971
77069,77069,55.56,0,0,0,0,0,n/a,0
77070,77070,99.00,0,0,0,0,0,n/a,0
77071,77071,99.00,127,28,155,0.8193548387096774,0.18064516129032257,Yes,0.8193548387096774
77072,77072,55.56,12,3,15,0.8,0.2,Yes,0.8
77073,77073,55.56,0,0,0,0,0,n/a,0
77074,77074,99.00,0,0,0,0,0,n/a,0
77075,77075,99.00,1,1,2,0.5,0.5,Tie,0.5
77076,77076,99.00,82,17,99,0.8282828282828283,0.1717171717171717,Yes,0.8282828282828283
77077,77077,99.00,0,0,0,0,0,n/a,0
77078,77078,99.00,58,13,71,0.8169014084507042,0.18309859154929578,Yes,0.8169014084507042
77079,77079,99.00,0,0,0,0,0,n/a,0
77080,77080,99.00,1,0,1,1.0,0.0,Yes,1.0
77081,77081,99.00,1,0,1,1.0,0.0,Yes,1.0
77082,77082,99.00,7,0,7,1.0,0.0,Yes,1.0
78001,78001,99.00,2,2,4,0.5,0.5,Tie,0.5
78002,78002,99.00,111,23,134,0.8283582089552238,0.17164179104477612,Yes,0.8283582089552238
78003,78003,99.00,106,26,132,0.803030303030303,0.19696969696969696,Yes,0.803030303030303
78004,78004,99.00,0,1,1,0.0,1.0,No,1.0
78005,78005,99.00,123,28,151,0.8145695364238411,0.18543046357615894,Yes,0.8145695364238411
78006,78006,99.00,128,39,167,0.7664670658682635,0.23353293413173654,Yes,0.7664670658682635
78007,78007,20.00,58,18,76,0.7631578947368421,0.23684210526315788,Yes,0.7631578947368421
78008,78008,99.00,113,27,140,0.8071428571428572,0.19285714285714287,Yes,0.8071428571428572
78009,78009,20.00,8,1,9,0.8888888888888888,0.1111111111111111,Yes,0.8888888888888888
78010,78010,0.00,0,0,0,0,0,n/a,0
78011,78011,0.00,0,0,0,0,0,n/a,0
78012,78012,99.00,87,17,104,0.8365384615384616,0.16346153846153846,Yes,0.8365384615384616
78013,78013,99.00,85,23,108,0.7870370370370371,0.21296296296296297,Yes,0.7870370370370371
78014,78014,99.00,65,18,83,0.7831325301204819,0.21686746987951808,Yes,0.7831325301204819
78015,78015,99.00,52,10,62,0.8387096774193549,0.16129032258064516,Yes,0.8387096774193549
78016,78016,83.33,81,45,126,0.6428571428571429,0.35714285714285715,Yes,0.6428571428571429
78017,78017,99.00,0,0,0,0,0,n/a,0
78018,78018,99.00,78,22,100,0.78,0.22,Yes,0.78
78019,78019,99.00,59,11,70,0.8428571428571429,0.15714285714285714,Yes,0.8428571428571429
78020,78020,99.00,55,19,74,0.7432432432432432,0.25675675675675674,Yes,0.7432432432432432
78021,78021,99.00,6,0,6,1.0,0.0,Yes,1.0
78022,78022,99.00,4,0,4,1.0,0.0,Yes,1.0
78023,78023,99.00,47,21,68,0.6911764705882353,0.3088235294117647,Yes,0.6911764705882353
78024,78024,99.00,58,17,75,0.7733333333333333,0.22666666666666666,Yes,0.7733333333333333
78025,78025,99.00,0,3,3,0.0,1.0,No,1.0
78026,78026,99.00,2,1,3,0.6666666666666666,0.3333333333333333,Yes,0.6666666666666666
78027,78027,99.00,127,32,159,0.7987421383647799,0.20125786163522014,Yes,0.7987421383647799
78028,78028,83.33,0,0,0,0,0,n/a,0
78029,78029,99.00,73,35,108,0.6759259259259259,0.32407407407407407,Yes,0.6759259259259259
78030,78030,99.00,2,1,3,0.6666666666666666,0.3333333333333333,Yes,0.6666666666666666
78031,78031,83.33,94,52,146,0.6438356164383562,0.3561643835616438,Yes,0.6438356164383562
78032,78032,83.33,3,0,3,1.0,0.0,Yes,1.0
78033,78033,99.00,153,57,210,0.7285714285714285,0.2714285714285714,Yes,0.7285714285714285
78034,78034,99.00,97,31,128,0.7578125,0.2421875,Yes,0.7578125
78035,78035,83.33,2,0,2,1.0,0.0,Yes,1.0
78036,78036,83.33,39,13,52,0.75,0.25,Yes,0.75
78037,78037,20.00,81,14,95,0.8526315789473684,0.14736842105263157,Yes,0.8526315789473684
78038,78038,83.33,62,28,90,0.6888888888888889,0.3111111111111111,Yes,0.6888888888888889
78039,78039,20.00,5,2,7,0.7142857142857143,0.2857142857142857,Yes,0.7142857142857143
78040,78040,99.00,156,44,200,0.78,0.22,Yes,0.78
78041,78041,99.00,97,49,146,0.6643835616438356,0.3356164383561644,Yes,0.6643835616438356
78042,78042,99.00,0,0,0,0,0,n/a,0
78043,78043,99.00,79,25,104,0.7596153846153846,0.2403846153846154,Yes,0.7596153846153846
78044,78044,99.00,95,21,116,0.8189655172413793,0.1810344827586207,Yes,0.8189655172413793
78045,78045,99.00,3,0,3,1.0,0.0,Yes,1.0
78046,78046,99.00,4,2,6,0.6666666666666666,0.3333333333333333,Yes,0.6666666666666666
78047,78047,99.00,85,20,105,0.8095238095238095,0.19047619047619047,Yes,0.8095238095238095
78048,78048,99.00,262,80,342,0.7660818713450293,0.23391812865497075,Yes,0.7660818713450293
78049,78049,99.00,8,2,10,0.8,0.2,Yes,0.8
78050,78050,99.00,92,20,112,0.8214285714285714,0.17857142857142858,Yes,0.8214285714285714
78051,78051,99.00,0,0,0,0,0,n/a,0
78052,78052,99.00,89,20,109,0.8165137614678899,0.1834862385321101,Yes,0.8165137614678899
78053,78053,99.00,57,16,73,0.7808219178082192,0.2191780821917808,Yes,0.7808219178082192
78054,78054,99.00,1,0,1,1.0,0.0,Yes,1.0
78055,78055,20.00,0,0,0,0,0,n/a,0
78056,78056,20.00,0,0,0,0,0,n/a,0
78057,78057,99.00,0,0,0,0,0,n/a,0
78058,78058,20.00,0,0,0,0,0,n/a,0
78059,78059,99.00,110,17,127,0.8661417322834646,0.13385826771653545,Yes,0.8661417322834646
78060,78060,99.00,107,29,136,0.7867647058823529,0.21323529411764705,Yes,0.7867647058823529
78061,78061,83.33,113,44,157,0.7197452229299363,0.2802547770700637,Yes,0.7197452229299363
78062,78062,20.00,4,1,5,0.8,0.2,Yes,0.8
78063,78063,99.00,0,0,0,0,0,n/a,0
78064,78064,0.00,0,0,0,0,0,n/a,0
78065,78065,99.00,70,18,88,0.7954545454545454,0.20454545454545456,Yes,0.7954545454545454
78066,78066,99.00,3,3,6,0.5,0.5,Tie,0.5
78067,78067,83.33,3,0,3,1.0,0.0,Yes,1.0
78068,78068,99.00,2,0,2,1.0,0.0,Yes,1.0
78069,78069,99.00,2,1,3,0.6666666666666666,0.3333333333333333,Yes,0.6666666666666666
78070,78070,99.00,1,0,1,1.0,0.0,Yes,1.0
78071,78071,99.00,3,1,4,0.75,0.25,Yes,0.75
78072,78072,99.00,3,1,4,0.75,0.25,Yes,0.75
78073,78073,99.00,3,0,3,1.0,0.0,Yes,1.0
79001,79001,99.00,69,25,94,0.7340425531914894,0.26595744680851063,Yes,0.7340425531914894
79002,79002,99.00,4,0,4,1.0,0.0,Yes,1.0
79003,79003,99.00,58,16,74,0.7837837837837838,0.21621621621621623,Yes,0.7837837837837838
79004,79004,99.00,110,25,135,0.8148148148148148,0.18518518518518517,Yes,0.8148148148148148
79005,79005,99.00,1,1,2,0.5,0.5,Tie,0.5
79006,79006,99.00,35,16,51,0.6862745098039216,0.3137254901960784,Yes,0.6862745098039216
79007,79007,99.00,67,22,89,0.7528089887640449,0.24719101123595505,Yes,0.7528089887640449
79008,79008,99.00,72,37,109,0.6605504587155964,0.3394495412844037,Yes,0.6605504587155964
79009,79009,99.00,1,0,1,1.0,0.0,Yes,1.0
79010,79010,99.00,64,15,79,0.810126582278481,0.189873417721519,Yes,0.810126582278481
79011,79011,99.00,2,0,2,1.0,0.0,Yes,1.0
79012,79012,99.00,0,0,0,0,0,n/a,0
79013,79013,99.00,102,20,122,0.8360655737704918,0.16393442622950818,Yes,0.8360655737704918
79014,79014,66.67,1,1,2,0.5,0.5,Tie,0.5
79015,79015,66.67,74,20,94,0.7872340425531915,0.2127659574468085,Yes,0.7872340425531915
79016,79016,66.67,105,21,126,0.8333333333333334,0.16666666666666666,Yes,0.8333333333333334
79017,79017,99.00,111,28,139,0.7985611510791367,0.2014388489208633,Yes,0.7985611510791367
79018,79018,66.67,0,1,1,0.0,1.0,No,1.0
79019,79019,99.00,5,0,5,1.0,0.0,Yes,1.0
79020,79020,99.00,85,25,110,0.7727272727272727,0.22727272727272727,Yes,0.7727272727272727
79021,79021,99.00,0,0,0,0,0,n/a,0
79022,79022,99.00,125,32,157,0.7961783439490446,0.20382165605095542,Yes,0.7961783439490446
79023,79023,99.00,117,25,142,0.823943661971831,0.176056338028169,Yes,0.823943661971831
79024,79024,99.00,2,0,2,1.0,0.0,Yes,1.0
79025,79025,37.50,38,11,49,0.7755102040816326,0.22448979591836735,Yes,0.7755102040816326
79026,79026,37.50,40,12,52,0.7692307692307693,0.23076923076923078,Yes,0.7692307692307693
79027,79027,37.50,49,13,62,0.7903225806451613,0.20967741935483872,Yes,0.7903225806451613
79028,79028,37.50,43,12,55,0.7818181818181819,0.21818181818181817,Yes,0.7818181818181819
79029,79029,99.00,23,7,30,0.7666666666666667,0.23333333333333334,Yes,0.7666666666666667
79030,79030,99.00,125,50,175,0.7142857142857143,0.2857142857142857,Yes,0.7142857142857143
79031,79031,99.00,1,1,2,0.5,0.5,Tie,0.5
79032,79032,99.00,2,0,2,1.0,0.0,Yes,1.0
79033,79033,99.00,73,23,96,0.7604166666666666,0.23958333333333334,Yes,0.7604166666666666
79034,79034,99.00,2,0,2,1.0,0.0,Yes,1.0
79035,79035,99.00,109,38,147,0.7414965986394558,0.2585034013605442,Yes,0.7414965986394558
79036,79036,99.00,105,34,139,0.7553956834532374,0.2446043165467626,Yes,0.7553956834532374
79037,79037,99.00,0,0,0,0,0,n/a,0
79038,79038,0.00,0,0,0,0,0,n/a,0
79039,79039,0.00,0,0,0,0,0,n/a,0
79040,79040,99.00,162,39,201,0.8059701492537313,0.19402985074626866,Yes,0.8059701492537313
79041,79041,0.00,0,1,1,0.0,1.0,No,1.0
79042,79042,99.00,98,32,130,0.7538461538461538,0.24615384615384617,Yes,0.7538461538461538
79043,79043,99.00,63,14,77,0.8181818181818182,0.18181818181818182,Yes,0.8181818181818182
79044,79044,99.00,64,17,81,0.7901234567901234,0.20987654320987653,Yes,0.7901234567901234
79045,79045,99.00,2,0,2,1.0,0.0,Yes,1.0
79046,79046,99.00,83,29,112,0.7410714285714286,0.25892857142857145,Yes,0.7410714285714286
79047,79047,99.00,1,0,1,1.0,0.0,Yes,1.0
79048,79048,99.00,48,13,61,0.7868852459016393,0.21311475409836064,Yes,0.7868852459016393
79049,79049,99.00,77,39,116,0.6637931034482759,0.33620689655172414,Yes,0.6637931034482759
79050,79050,99.00,117,26,143,0.8181818181818182,0.18181818181818182,Yes,0.8181818181818182
79051,79051,99.00,1,1,2,0.5,0.5,Tie,0.5
79052,79052,99.00,2,1,3,0.6666666666666666,0.3333333333333333,Yes,0.6666666666666666
79053,79053,99.00,156,35,191,0.8167539267015707,0.18324607329842932,Yes,0.8167539267015707
79054,79054,99.00,60,13,73,0.821917808219178,0.1780821917808219,Yes,0.821917808219178
79055,79055,99.00,66,24,90,0.7333333333333333,0.26666666666666666,Yes,0.7333333333333333
79056,79056,99.00,86,54,140,0.6142857142857143,0.38571428571428573,Yes,0.6142857142857143
79057,79057,99.00,142,41,183,0.7759562841530054,0.22404371584699453,Yes,0.7759562841530054
79058,79058,99.00,50,8,58,0.8620689655172413,0.13793103448275862,Yes,0.8620689655172413
79059,79059,99.00,3,0,3,1.0,0.0,Yes,1.0
79060,79060,99.00,3,0,3,1.0,0.0,Yes,1.0
79061,79061,99.00,96,22,118,0.8135593220338984,0.1864406779661017,Yes,0.8135593220338984
79062,79062,99.00,59,23,82,0.7195121951219512,0.2804878048780488,Yes,0.7195121951219512
79063,79063,99.00,48,17,65,0.7384615384615385,0.26153846153846155,Yes,0.7384615384615385
79064,79064,99.00,40,11,51,0.7843137254901961,0.21568627450980393,Yes,0.7843137254901961
79065,79065,99.00,0,0,0,0,0,n/a,0
79066,79066,99.00,76,18,94,0.8085106382978723,0.19148936170212766,Yes,0.8085106382978723
79067,79067,99.00,90,15,105,0.8571428571428571,0.14285714285714285,Yes,0.8571428571428571
79068,79068,99.00,161,55,216,0.7453703703703703,0.25462962962962965,Yes,0.7453703703703703
79069,79069,99.00,348,137,485,0.7175257731958763,0.2824742268041237,Yes,0.7175257731958763
79070,79070,99.00,67,19,86,0.7790697674418605,0.22093023255813954,Yes,0.7790697674418605
79071,79071,99.00,1,2,3,0.3333333333333333,0.6666666666666666,No,0.6666666666666666
79072,79072,99.00,119,33,152,0.7828947368421053,0.21710526315789475,Yes,0.7828947368421053
79073,79073,99.00,5,0,5,1.0,0.0,Yes,1.0
79074,79074,99.00,0,0,0,0,0,n/a,0
79075,79075,99.00,73,24,97,0.7525773195876289,0.24742268041237114,Yes,0.7525773195876289
79076,79076,99.00,8,0,8,1.0,0.0,Yes,1.0
79077,79077,99.00,1,0,1,1.0,0.0,Yes,1.0
79078,79078,99.00,0,1,1,0.0,1.0,No,1.0
79079,79079,99.00,1,0,1,1.0,0.0,Yes,1.0
79080,79080,99.00,0,0,0,0,0,n/a,0
79081,79081,99.00,0,0,0,0,0,n/a,0
79082,79082,99.00,0,0,0,0,0,n/a,0
79083,79083,99.00,1,0,1,1.0,0.0,Yes,1.0
79084,79084,99.00,119,39,158,0.7531645569620253,0.2468354430379747,Yes,0.7531645569620253
79085,79085,99.00,1,0,1,1.0,0.0,Yes,1.0
79086,79086,99.00,85,34,119,0.7142857142857143,0.2857142857142857,Yes,0.7142857142857143
79087,79087,99.00,0,0,0,0,0,n/a,0
79088,79088,99.00,0,0,0,0,0,n/a,0
79089,79089,99.00,2,2,4,0.5,0.5,Tie,0.5
79090,79090,99.00,16,3,19,0.8421052631578947,0.15789473684210525,Yes,0.8421052631578947
80001,80001,99.00,125,121,246,0.508130081300813,0.491869918699187,Yes,0.508130081300813
80002,80002,99.00,4,0,4,1.0,0.0,Yes,1.0
80003,80003,99.00,5,3,8,0.625,0.375,Yes,0.625
80004,80004,99.00,62,45,107,0.5794392523364486,0.4205607476635514,Yes,0.5794392523364486
80005,80005,99.00,2,0,2,1.0,0.0,Yes,1.0
80006,80006,99.00,126,72,198,0.6363636363636364,0.36363636363636365,Yes,0.6363636363636364
80007,80007,99.00,0,0,0,0,0,n/a,0
80008,80008,99.00,5,0,5,1.0,0.0,Yes,1.0
80009,80009,99.00,111,47,158,0.7025316455696202,0.2974683544303797,Yes,0.7025316455696202
80010,80010,99.00,1,0,1,1.0,0.0,Yes,1.0
80011,80011,99.00,79,60,139,0.5683453237410072,0.4316546762589928,Yes,0.5683453237410072
80012,80012,99.00,1,0,1,1.0,0.0,Yes,1.0
80013,80013,99.00,109,42,151,0.7218543046357616,0.2781456953642384,Yes,0.7218543046357616
80014,80014,99.00,107,37,144,0.7430555555555556,0.2569444444444444,Yes,0.7430555555555556
80015,80015,99.00,164,50,214,0.7663551401869159,0.2336448598130841,Yes,0.7663551401869159
80016,80016,99.00,9,1,10,0.9,0.1,Yes,0.9
80017,80017,99.00,128,42,170,0.7529411764705882,0.24705882352941178,Yes,0.7529411764705882
80018,80018,99.00,1,0,1,1.0,0.0,Yes,1.0
80019,80019,99.00,0,3,3,0.0,1.0,No,1.0
80020,80020,99.00,8,3,11,0.7272727272727273,0.2727272727272727,Yes,0.7272727272727273
80021,80021,99.00,140,40,180,0.7777777777777778,0.2222222222222222,Yes,0.7777777777777778
80022,80022,99.00,4,1,5,0.8,0.2,Yes,0.8
80023,80023,99.00,128,37,165,0.7757575757575758,0.22424242424242424,Yes,0.7757575757575758
80024,80024,99.00,2,1,3,0.6666666666666666,0.3333333333333333,Yes,0.6666666666666666
80025,80025,99.00,141,46,187,0.7540106951871658,0.24598930481283424,Yes,0.7540106951871658
80026,80026,99.00,149,71,220,0.6772727272727272,0.32272727272727275,Yes,0.6772727272727272
80027,80027,99.00,1,0,1,1.0,0.0,Yes,1.0
80028,80028,99.00,1,0,1,1.0,0.0,Yes,1.0
80029,80029,99.00,1,0,1,1.0,0.0,Yes,1.0
80030,80030,99.00,107,80,187,0.5721925133689839,0.42780748663101603,Yes,0.5721925133689839
80031,80031,75.00,106,74,180,0.5888888888888889,0.4111111111111111,Yes,0.5888888888888889
80032,80032,75.00,2,2,4,0.5,0.5,Tie,0.5
80033,80033,75.00,64,30,94,0.6808510638297872,0.3191489361702128,Yes,0.6808510638297872
80034,80034,75.00,6,1,7,0.8571428571428571,0.14285714285714285,Yes,0.8571428571428571
80035,80035,99.00,8,2,10,0.8,0.2,Yes,0.8
80036,80036,99.00,94,53,147,0.6394557823129252,0.36054421768707484,Yes,0.6394557823129252
80037,80037,33.33,74,37,111,0.6666666666666666,0.3333333333333333,Yes,0.6666666666666666
80038,80038,99.00,147,60,207,0.7101449275362319,0.2898550724637681,Yes,0.7101449275362319
80039,80039,99.00,4,0,4,1.0,0.0,Yes,1.0
80040,80040,33.33,3,4,7,0.42857142857142855,0.5714285714285714,No,0.5714285714285714
80041,80041,99.00,91,24,115,0.7913043478260869,0.20869565217391303,Yes,0.7913043478260869
80042,80042,99.00,68,25,93,0.7311827956989247,0.26881720430107525,Yes,0.7311827956989247
80043,80043,33.33,85,27,112,0.7589285714285714,0.24107142857142858,Yes,0.7589285714285714
80044,80044,33.33,3,0,3,1.0,0.0,Yes,1.0
80045,80045,99.00,67,32,99,0.6767676767676768,0.32323232323232326,Yes,0.6767676767676768
80046,80046,99.00,84,29,113,0.7433628318584071,0.25663716814159293,Yes,0.7433628318584071
80047,80047,99.00,2,1,3,0.6666666666666666,0.3333333333333333,Yes,0.6666666666666666
80048,80048,99.00,133,45,178,0.7471910112359551,0.25280898876404495,Yes,0.7471910112359551
80049,80049,99.00,0,0,0,0,0,n/a,0
80050,80050,99.00,2,0,2,1.0,0.0,Yes,1.0
80051,80051,99.00,2,0,2,1.0,0.0,Yes,1.0
80052,80052,99.00,107,24,131,0.816793893129771,0.183206106870229,Yes,0.816793893129771
80053,80053,99.00,3,1,4,0.75,0.25,Yes,0.75
80054,80054,99.00,0,0,0,0,0,n/a,0
80055,80055,99.00,92,29,121,0.7603305785123967,0.2396694214876033,Yes,0.7603305785123967
80056,80056,99.00,51,21,72,0.7083333333333334,0.2916666666666667,Yes,0.7083333333333334
80057,80057,99.00,0,0,0,0,0,n/a,0
80058,80058,99.00,72,17,89,0.8089887640449438,0.19101123595505617,Yes,0.8089887640449438
80059,80059,99.00,0,2,2,0.0,1.0,No,1.0
80060,80060,99.00,67,25,92,0.7282608695652174,0.2717391304347826,Yes,0.7282608695652174
80061,80061,99.00,0,0,0,0,0,n/a,0
80062,80062,99.00,2,1,3,0.6666666666666666,0.3333333333333333,Yes,0.6666666666666666
80063,80063,99.00,128,40,168,0.7619047619047619,0.23809523809523808,Yes,0.7619047619047619
80064,80064,99.00,1,0,1,1.0,0.0,Yes,1.0
80065,80065,99.00,103,33,136,0.7573529411764706,0.2426470588235294,Yes,0.7573529411764706
80066,80066,75.00,2,0,2,1.0,0.0,Yes,1.0
80067,80067,75.00,119,57,176,0.6761363636363636,0.32386363636363635,Yes,0.6761363636363636
80068,80068,75.00,4,0,4,1.0,0.0,Yes,1.0
80069,80069,75.00,1,0,1,1.0,0.0,Yes,1.0
80070,80070,99.00,0,1,1,0.0,1.0,No,1.0
80071,80071,99.00,117,69,186,0.6290322580645161,0.3709677419354839,Yes,0.6290322580645161
80072,80072,99.00,0,0,0,0,0,n/a,0
80073,80073,99.00,0,0,0,0,0,n/a,0
80074,80074,99.00,97,21,118,0.8220338983050848,0.17796610169491525,Yes,0.8220338983050848
80075,80075,99.00,0,0,0,0,0,n/a,0
80076,80076,99.00,53,19,72,0.7361111111111112,0.2638888888888889,Yes,0.7361111111111112
80077,80077,99.00,2,1,3,0.6666666666666666,0.3333333333333333,Yes,0.6666666666666666
80078,80078,99.00,157,44,201,0.7810945273631841,0.21890547263681592,Yes,0.7810945273631841
80079,80079,99.00,2,1,3,0.6666666666666666,0.3333333333333333,Yes,0.6666666666666666
80080,80080,99.00,76,29,105,0.7238095238095238,0.2761904761904762,Yes,0.7238095238095238
80081,80081,99.00,100,26,126,0.7936507936507936,0.20634920634920634,Yes,0.7936507936507936
80082,80082,83.33,0,1,1,0.0,1.0,No,1.0
80083,80083,99.00,163,47,210,0.7761904761904762,0.22380952380952382,Yes,0.7761904761904762
80084,80084,99.00,2,3,5,0.4,0.6,No,0.6
80085,80085,99.00,94,37,131,0.7175572519083969,0.2824427480916031,Yes,0.7175572519083969
80086,80086,99.00,0,0,0,0,0,n/a,0
80087,80087,99.00,0,0,0,0,0,n/a,0
80088,80088,99.00,0,0,0,0,0,n/a,0
80089,80089,33.33,0,0,0,0,0,n/a,0
80090,80090,99.00,0,0,0,0,0,n/a,0
80091,80091,99.00,0,0,0,0,0,n/a,0
80092,80092,99.00,0,0,0,0,0,n/a,0
80093,80093,99.00,0,0,0,0,0,n/a,0
80094,80094,99.00,89,17,106,0.839622641509434,0.16037735849056603,Yes,0.839622641509434
80095,80095,99.00,58,23,81,0.7160493827160493,0.2839506172839506,Yes,0.7160493827160493
81001,81001,99.00,4,0,4,1.0,0.0,Yes,1.0
81002,81002,99.00,108,30,138,0.782608695652174,0.21739130434782608,Yes,0.782608695652174
81003,81003,99.00,71,34,105,0.6761904761904762,0.3238095238095238,Yes,0.6761904761904762
81004,81004,99.00,2,0,2,1.0,0.0,Yes,1.0
81005,81005,99.00,2,1,3,0.6666666666666666,0.3333333333333333,Yes,0.6666666666666666
81006,81006,99.00,92,34,126,0.7301587301587301,0.2698412698412698,Yes,0.7301587301587301
81007,81007,99.00,58,20,78,0.7435897435897436,0.2564102564102564,Yes,0.7435897435897436
81008,81008,99.00,60,25,85,0.7058823529411765,0.29411764705882354,Yes,0.7058823529411765
81009,81009,99.00,1,0,1,1.0,0.0,Yes,1.0
81010,81010,99.00,2,0,2,1.0,0.0,Yes,1.0
81011,81011,83.33,0,1,1,0.0,1.0,No,1.0
81012,81012,99.00,164,46,210,0.780952380952381,0.21904761904761905,Yes,0.780952380952381
81013,81013,99.00,1,0,1,1.0,0.0,Yes,1.0
81014,81014,99.00,194,71,265,0.7320754716981132,0.2679245283018868,Yes,0.7320754716981132
81015,81015,99.00,19,3,22,0.8636363636363636,0.13636363636363635,Yes,0.8636363636363636
81016,81016,99.00,0,0,0,0,0,n/a,0
81017,81017,83.33,122,22,144,0.8472222222222222,0.1527777777777778,Yes,0.8472222222222222
81018,81018,83.33,7,0,7,1.0,0.0,Yes,1.0
81019,81019,83.33,75,26,101,0.7425742574257426,0.25742574257425743,Yes,0.7425742574257426
81020,81020,99.00,74,19,93,0.7956989247311828,0.20430107526881722,Yes,0.7956989247311828
81021,81021,99.00,137,24,161,0.8509316770186336,0.14906832298136646,Yes,0.8509316770186336
81022,81022,99.00,5,4,9,0.5555555555555556,0.4444444444444444,Yes,0.5555555555555556
81023,81023,99.00,164,48,212,0.7735849056603774,0.22641509433962265,Yes,0.7735849056603774
81024,81024,99.00,2,0,2,1.0,0.0,Yes,1.0
81025,81025,99.00,189,137,326,0.5797546012269938,0.42024539877300615,Yes,0.5797546012269938
81026,81026,99.00,2,1,3,0.6666666666666666,0.3333333333333333,Yes,0.6666666666666666
81027,81027,99.00,0,1,1,0.0,1.0,No,1.0
81028,81028,99.00,70,43,113,0.6194690265486725,0.3805309734513274,Yes,0.6194690265486725
81029,81029,99.00,2,0,2,1.0,0.0,Yes,1.0
81030,81030,99.00,165,161,326,0.5061349693251533,0.4938650306748466,Yes,0.5061349693251533
81031,81031,99.00,4,2,6,0.6666666666666666,0.3333333333333333,Yes,0.6666666666666666
81032,81032,99.00,2,4,6,0.3333333333333333,0.6666666666666666,No,0.6666666666666666
81033,81033,99.00,207,94,301,0.6877076411960132,0.3122923588039867,Yes,0.6877076411960132
81034,81034,99.00,6,1,7,0.8571428571428571,0.14285714285714285,Yes,0.8571428571428571
81035,81035,99.00,174,52,226,0.7699115044247787,0.23008849557522124,Yes,0.7699115044247787
81036,81036,99.00,8,4,12,0.6666666666666666,0.3333333333333333,Yes,0.6666666666666666
81037,81037,99.00,95,28,123,0.7723577235772358,0.22764227642276422,Yes,0.7723577235772358
81038,81038,99.00,77,16,93,0.8279569892473119,0.17204301075268819,Yes,0.8279569892473119
81039,81039,50.00,2,1,3,0.6666666666666666,0.3333333333333333,Yes,0.6666666666666666
81040,81040,50.00,133,43,176,0.7556818181818182,0.24431818181818182,Yes,0.7556818181818182
81041,81041,50.00,139,61,200,0.695,0.305,Yes,0.695
81042,81042,50.00,2,2,4,0.5,0.5,Tie,0.5
81043,81043,50.00,167,40,207,0.8067632850241546,0.1932367149758454,Yes,0.8067632850241546
81044,81044,50.00,5,4,9,0.5555555555555556,0.4444444444444444,Yes,0.5555555555555556
81045,81045,50.00,2,2,4,0.5,0.5,Tie,0.5
81046,81046,50.00,3,3,6,0.5,0.5,Tie,0.5
81047,81047,99.00,245,91,336,0.7291666666666666,0.2708333333333333,Yes,0.7291666666666666
81048,81048,99.00,178,50,228,0.7807017543859649,0.21929824561403508,Yes,0.7807017543859649
81049,81049,99.00,233,84,317,0.7350157728706624,0.26498422712933756,Yes,0.7350157728706624
81050,81050,99.00,20,5,25,0.8,0.2,Yes,0.8
81051,81051,99.00,8,2,10,0.8,0.2,Yes,0.8
81052,81052,99.00,4,3,7,0.5714285714285714,0.42857142857142855,Yes,0.5714285714285714
81053,81053,99.00,135,67,202,0.6683168316831684,0.3316831683168317,Yes,0.6683168316831684
81054,81054,99.00,111,32,143,0.7762237762237763,0.22377622377622378,Yes,0.7762237762237763
81055,81055,99.00,23,7,30,0.7666666666666667,0.23333333333333334,Yes,0.7666666666666667
81056,81056,99.00,151,97,248,0.6088709677419355,0.3911290322580645,Yes,0.6088709677419355
81057,81057,99.00,6,4,10,0.6,0.4,Yes,0.6
81058,81058,99.00,161,60,221,0.7285067873303167,0.27149321266968324,Yes,0.7285067873303167
81059,81059,99.00,10,3,13,0.7692307692307693,0.23076923076923078,Yes,0.7692307692307693
81060,81060,99.00,235,114,349,0.673352435530086,0.32664756446991405,Yes,0.673352435530086
81061,81061,99.00,5,0,5,1.0,0.0,Yes,1.0
81062,81062,99.00,9,1,10,0.9,0.1,Yes,0.9
81063,81063,99.00,8,2,10,0.8,0.2,Yes,0.8
81064,81064,99.00,304,84,388,0.7835051546391752,0.21649484536082475,Yes,0.7835051546391752
81065,81065,99.00,239,110,349,0.6848137535816619,0.3151862464183381,Yes,0.6848137535816619
81066,81066,99.00,9,1,10,0.9,0.1,Yes,0.9
81067,81067,99.00,15,2,17,0.8823529411764706,0.11764705882352941,Yes,0.8823529411764706
81068,81068,99.00,291,111,402,0.7238805970149254,0.27611940298507465,Yes,0.7238805970149254
81069,81069,99.00,6,4,10,0.6,0.4,Yes,0.6
81070,81070,99.00,3,0,3,1.0,0.0,Yes,1.0
81071,81071,99.00,244,66,310,0.7870967741935484,0.2129032258064516,Yes,0.7870967741935484
81072,81072,99.00,16,9,25,0.64,0.36,Yes,0.64
81073,81073,99.00,308,117,425,0.7247058823529412,0.2752941176470588,Yes,0.7247058823529412
81074,81074,99.00,237,77,314,0.7547770700636943,0.24522292993630573,Yes,0.7547770700636943
81075,81075,99.00,15,1,16,0.9375,0.0625,Yes,0.9375
81076,81076,99.00,5,0,5,1.0,0.0,Yes,1.0
81077,81077,99.00,19,1,20,0.95,0.05,Yes,0.95
81078,81078,99.00,173,58,231,0.7489177489177489,0.2510822510822511,Yes,0.7489177489177489
81079,81079,99.00,12,4,16,0.75,0.25,Yes,0.75
81080,81080,99.00,142,43,185,0.7675675675675676,0.23243243243243245,Yes,0.7675675675675676
81081,81081,99.00,215,73,288,0.7465277777777778,0.2534722222222222,Yes,0.7465277777777778
81082,81082,99.00,4,1,5,0.8,0.2,Yes,0.8
81083,81083,99.00,267,71,338,0.7899408284023669,0.21005917159763313,Yes,0.7899408284023669
81084,81084,99.00,13,3,16,0.8125,0.1875,Yes,0.8125
81085,81085,99.00,287,127,414,0.6932367149758454,0.30676328502415456,Yes,0.6932367149758454
81086,81086,99.00,7,2,9,0.7777777777777778,0.2222222222222222,Yes,0.7777777777777778
81087,81087,50.00,225,75,300,0.75,0.25,Yes,0.75
81088,81088,99.00,6,3,9,0.6666666666666666,0.3333333333333333,Yes,0.6666666666666666
81089,81089,50.00,4,1,5,0.8,0.2,Yes,0.8
81090,81090,50.00,8,5,13,0.6153846153846154,0.38461538461538464,Yes,0.6153846153846154
81091,81091,99.00,84,16,100,0.84,0.16,Yes,0.84
81092,81092,99.00,77,27,104,0.7403846153846154,0.25961538461538464,Yes,0.7403846153846154
81093,81093,99.00,1,2,3,0.3333333333333333,0.6666666666666666,No,0.6666666666666666
81094,81094,99.00,68,31,99,0.6868686868686869,0.31313131313131315,Yes,0.6868686868686869
81095,81095,99.00,1,0,1,1.0,0.0,Yes,1.0
81096,81096,99.00,1,4,5,0.2,0.8,No,0.8
81097,81097,99.00,154,36,190,0.8105263157894737,0.18947368421052632,Yes,0.8105263157894737
81098,81098,99.00,2,1,3,0.6666666666666666,0.3333333333333333,Yes,0.6666666666666666
81099,81099,99.00,65,20,85,0.7647058823529411,0.23529411764705882,Yes,0.7647058823529411
81100,81100,99.00,64,16,80,0.8,0.2,Yes,0.8
81101,81101,99.00,0,0,0,0,0,n/a,0
81102,81102,99.00,0,0,0,0,0,n/a,0
81103,81103,99.00,0,0,0,0,0,n/a,0
81104,81104,99.00,0,0,0,0,0,n/a,0
81105,81105,83.33,0,0,0,0,0,n/a,0
81106,81106,99.00,0,0,0,0,0,n/a,0
81107,81107,99.00,1,0,1,1.0,0.0,Yes,1.0
82001,82001,42.86,136,179,315,0.43174603174603177,0.5682539682539682,No,0.5682539682539682
82002,82002,42.86,18,8,26,0.6923076923076923,0.3076923076923077,Yes,0.6923076923076923
82003,82003,99.00,36,51,87,0.41379310344827586,0.5862068965517241,No,0.5862068965517241
82004,82004,99.00,7,6,13,0.5384615384615384,0.46153846153846156,Yes,0.5384615384615384
82005,82005,99.00,132,169,301,0.43853820598006643,0.5614617940199336,No,0.5614617940199336
82006,82006,42.86,118,86,204,0.5784313725490197,0.4215686274509804,Yes,0.5784313725490197
82007,82007,42.86,13,13,26,0.5,0.5,Tie,0.5
82008,82008,99.00,99,36,135,0.7333333333333333,0.26666666666666666,Yes,0.7333333333333333
82009,82009,99.00,143,83,226,0.6327433628318584,0.3672566371681416,Yes,0.6327433628318584
82010,82010,99.00,10,3,13,0.7692307692307693,0.23076923076923078,Yes,0.7692307692307693
82011,82011,99.00,46,34,80,0.575,0.425,Yes,0.575
82012,82012,99.00,61,19,80,0.7625,0.2375,Yes,0.7625
82013,82013,99.00,87,26,113,0.7699115044247787,0.23008849557522124,Yes,0.7699115044247787
82014,82014,99.00,1,0,1,1.0,0.0,Yes,1.0
82015,82015,99.00,4,1,5,0.8,0.2,Yes,0.8
82016,82016,99.00,117,90,207,0.5652173913043478,0.43478260869565216,Yes,0.5652173913043478
82017,82017,99.00,5,4,9,0.5555555555555556,0.4444444444444444,Yes,0.5555555555555556
82018,82018,99.00,58,48,106,0.5471698113207547,0.4528301886792453,Yes,0.5471698113207547
82019,82019,99.00,5,3,8,0.625,0.375,Yes,0.625
82020,82020,99.00,78,92,170,0.4588235294117647,0.5411764705882353,No,0.5411764705882353
82021,82021,99.00,98,84,182,0.5384615384615384,0.46153846153846156,Yes,0.5384615384615384
82022,82022,99.00,4,3,7,0.5714285714285714,0.42857142857142855,Yes,0.5714285714285714
82023,82023,0.00,3,1,4,0.75,0.25,Yes,0.75
82024,82024,99.00,59,30,89,0.6629213483146067,0.33707865168539325,Yes,0.6629213483146067
82025,82025,99.00,2,3,5,0.4,0.6,No,0.6
82026,82026,99.00,0,0,0,0,0,n/a,0
82027,82027,0.00,0,0,0,0,0,n/a,0
82028,82028,99.00,83,19,102,0.8137254901960784,0.18627450980392157,Yes,0.8137254901960784
82029,82029,99.00,0,0,0,0,0,n/a,0
82030,82030,99.00,144,52,196,0.7346938775510204,0.2653061224489796,Yes,0.7346938775510204
82031,82031,99.00,2,1,3,0.6666666666666666,0.3333333333333333,Yes,0.6666666666666666
82032,82032,99.00,118,81,199,0.592964824120603,0.40703517587939697,Yes,0.592964824120603
82033,82033,99.00,9,1,10,0.9,0.1,Yes,0.9
82034,82034,99.00,2,0,2,1.0,0.0,Yes,1.0
82035,82035,99.00,114,91,205,0.5560975609756098,0.44390243902439025,Yes,0.5560975609756098
82036,82036,99.00,76,56,132,0.5757575757575758,0.42424242424242425,Yes,0.5757575757575758
82037,82037,99.00,73,37,110,0.6636363636363637,0.33636363636363636,Yes,0.6636363636363637
82038,82038,99.00,118,85,203,0.5812807881773399,0.4187192118226601,Yes,0.5812807881773399
82039,82039,99.00,3,0,3,1.0,0.0,Yes,1.0
82040,82040,99.00,79,78,157,0.5031847133757962,0.4968152866242038,Yes,0.5031847133757962
82041,82041,99.00,113,127,240,0.4708333333333333,0.5291666666666667,No,0.5291666666666667
82042,82042,99.00,117,148,265,0.44150943396226416,0.5584905660377358,No,0.5584905660377358
82043,82043,99.00,7,3,10,0.7,0.3,Yes,0.7
82044,82044,99.00,5,4,9,0.5555555555555556,0.4444444444444444,Yes,0.5555555555555556
82045,82045,99.00,5,2,7,0.7142857142857143,0.2857142857142857,Yes,0.7142857142857143
82046,82046,99.00,3,0,3,1.0,0.0,Yes,1.0
82047,82047,50.00,37,45,82,0.45121951219512196,0.5487804878048781,No,0.5487804878048781
82048,82048,50.00,5,2,7,0.7142857142857143,0.2857142857142857,Yes,0.7142857142857143
82049,82049,50.00,31,35,66,0.4696969696969697,0.5303030303030303,No,0.5303030303030303
82050,82050,99.00,53,25,78,0.6794871794871795,0.32051282051282054,Yes,0.6794871794871795
82051,82051,99.00,121,67,188,0.6436170212765957,0.35638297872340424,Yes,0.6436170212765957
82052,82052,99.00,148,77,225,0.6577777777777778,0.3422222222222222,Yes,0.6577777777777778
82053,82053,99.00,5,0,5,1.0,0.0,Yes,1.0
82054,82054,75.00,0,0,0,0,0,n/a,0
82055,82055,99.00,0,0,0,0,0,n/a,0
82056,82056,99.00,47,22,69,0.6811594202898551,0.3188405797101449,Yes,0.6811594202898551
82057,82057,99.00,89,84,173,0.5144508670520231,0.48554913294797686,Yes,0.5144508670520231
82058,82058,99.00,3,2,5,0.6,0.4,Yes,0.6
82059,82059,50.00,15,4,19,0.7894736842105263,0.21052631578947367,Yes,0.7894736842105263
82060,82060,66.67,107,99,206,0.5194174757281553,0.48058252427184467,Yes,0.5194174757281553
82061,82061,66.67,1,0,1,1.0,0.0,Yes,1.0
82062,82062,66.67,100,68,168,0.5952380952380952,0.40476190476190477,Yes,0.5952380952380952
82063,82063,66.67,2,1,3,0.6666666666666666,0.3333333333333333,Yes,0.6666666666666666
82064,82064,99.00,110,28,138,0.7971014492753623,0.2028985507246377,Yes,0.7971014492753623
82065,82065,0.00,15,0,15,1.0,0.0,Yes,1.0
82066,82066,99.00,260,72,332,0.7831325301204819,0.21686746987951808,Yes,0.7831325301204819
82067,82067,99.00,10,2,12,0.8333333333333334,0.16666666666666666,Yes,0.8333333333333334
82068,82068,99.00,13,3,16,0.8125,0.1875,Yes,0.8125
82069,82069,99.00,269,75,344,0.7819767441860465,0.2180232558139535,Yes,0.7819767441860465
82070,82070,99.00,5,3,8,0.625,0.375,Yes,0.625
82071,82071,66.67,212,55,267,0.7940074906367042,0.20599250936329588,Yes,0.7940074906367042
82072,82072,66.67,4,1,5,0.8,0.2,Yes,0.8
82073,82073,66.67,5,0,5,1.0,0.0,Yes,1.0
82074,82074,66.67,158,51,209,0.7559808612440191,0.24401913875598086,Yes,0.7559808612440191
82075,82075,66.67,3,0,3,1.0,0.0,Yes,1.0
82076,82076,66.67,6,1,7,0.8571428571428571,0.14285714285714285,Yes,0.8571428571428571
82077,82077,99.00,10,1,11,0.9090909090909091,0.09090909090909091,Yes,0.9090909090909091
82078,82078,0.00,8,4,12,0.6666666666666666,0.3333333333333333,Yes,0.6666666666666666
82079,82079,0.00,13,3,16,0.8125,0.1875,Yes,0.8125
82080,82080,42.86,165,45,210,0.7857142857142857,0.21428571428571427,Yes,0.7857142857142857
82081,82081,42.86,17,6,23,0.7391304347826086,0.2608695652173913,Yes,0.7391304347826086
82082,82082,0.00,9,1,10,0.9,0.1,Yes,0.9
82083,82083,0.00,4,2,6,0.6666666666666666,0.3333333333333333,Yes,0.6666666666666666
82084,82084,0.00,10,4,14,0.7142857142857143,0.2857142857142857,Yes,0.7142857142857143
82085,82085,0.00,10,5,15,0.6666666666666666,0.3333333333333333,Yes,0.6666666666666666
82086,82086,0.00,14,2,16,0.875,0.125,Yes,0.875
82087,82087,0.00,9,3,12,0.75,0.25,Yes,0.75
82088,82088,99.00,206,58,264,0.7803030303030303,0.2196969696969697,Yes,0.7803030303030303
82089,82089,0.00,22,5,27,0.8148148148148148,0.18518518518518517,Yes,0.8148148148148148
82090,82090,99.00,160,39,199,0.8040201005025126,0.19597989949748743,Yes,0.8040201005025126
82091,82091,99.00,1,1,2,0.5,0.5,Tie,0.5
82092,82092,99.00,201,85,286,0.7027972027972028,0.2972027972027972,Yes,0.7027972027972028
82093,82093,0.00,10,3,13,0.7692307692307693,0.23076923076923078,Yes,0.7692307692307693
82094,82094,0.00,15,5,20,0.75,0.25,Yes,0.75
82095,82095,99.00,14,3,17,0.8235294117647058,0.17647058823529413,Yes,0.8235294117647058
82096,82096,99.00,6,1,7,0.8571428571428571,0.14285714285714285,Yes,0.8571428571428571
82097,82097,99.00,12,4,16,0.75,0.25,Yes,0.75
82098,82098,99.00,210,79,289,0.726643598615917,0.27335640138408307,Yes,0.726643598615917
82099,82099,0.00,22,8,30,0.7333333333333333,0.26666666666666666,Yes,0.7333333333333333
82100,82100,99.00,11,1,12,0.9166666666666666,0.08333333333333333,Yes,0.9166666666666666
82101,82101,0.00,25,9,34,0.7352941176470589,0.2647058823529412,Yes,0.7352941176470589
82102,82102,42.86,236,54,290,0.8137931034482758,0.18620689655172415,Yes,0.8137931034482758
82103,82103,42.86,24,3,27,0.8888888888888888,0.1111111111111111,Yes,0.8888888888888888
82104,82104,42.86,35,15,50,0.7,0.3,Yes,0.7
82105,82105,0.00,14,11,25,0.56,0.44,Yes,0.56
82106,82106,0.00,0,0,0,0,0,n/a,0
82107,82107,99.00,1,0,1,1.0,0.0,Yes,1.0
82108,82108,99.00,0,0,0,0,0,n/a,0
82109,82109,0.00,2,1,3,0.6666666666666666,0.3333333333333333,Yes,0.6666666666666666
82110,82110,75.00,0,0,0,0,0,n/a,0
82111,82111,99.00,0,0,0,0,0,n/a,0
82112,82112,99.00,0,0,0,0,0,n/a,0
82113,82113,99.00,0,0,0,0,0,n/a,0
82114,82114,99.00,0,0,0,0,0,n/a,0
82115,82115,66.67,0,0,0,0,0,n/a,0
82116,82116,99.00,0,0,0,0,0,n/a,0
82117,82117,99.00,0,0,0,0,0,n/a,0
82118,82118,99.00,0,0,0,0,0,n/a,0
82119,82119,99.00,1,3,4,0.25,0.75,No,0.75
83001,83001,99.00,209,63,272,0.7683823529411765,0.23161764705882354,Yes,0.7683823529411765
83002,83002,99.00,0,0,0,0,0,n/a,0
83003,83003,99.00,0,1,1,0.0,1.0,No,1.0
83004,83004,99.00,132,46,178,0.7415730337078652,0.25842696629213485,Yes,0.7415730337078652
83005,83005,99.00,0,0,0,0,0,n/a,0
83006,83006,99.00,147,39,186,0.7903225806451613,0.20967741935483872,Yes,0.7903225806451613
83007,83007,99.00,6,3,9,0.6666666666666666,0.3333333333333333,Yes,0.6666666666666666
83008,83008,99.00,197,58,255,0.7725490196078432,0.22745098039215686,Yes,0.7725490196078432
83009,83009,99.00,0,2,2,0.0,1.0,No,1.0
83010,83010,99.00,211,59,270,0.7814814814814814,0.21851851851851853,Yes,0.7814814814814814
83011,83011,99.00,136,25,161,0.84472049689441,0.15527950310559005,Yes,0.84472049689441
83012,83012,99.00,0,0,0,0,0,n/a,0
83013,83013,99.00,117,34,151,0.7748344370860927,0.2251655629139073,Yes,0.7748344370860927
83014,83014,99.00,1,0,1,1.0,0.0,Yes,1.0
83015,83015,99.00,8,0,8,1.0,0.0,Yes,1.0
83016,83016,99.00,162,43,205,0.7902439024390244,0.2097560975609756,Yes,0.7902439024390244
83017,83017,99.00,141,38,179,0.7877094972067039,0.2122905027932961,Yes,0.7877094972067039
83018,83018,99.00,1,0,1,1.0,0.0,Yes,1.0
83019,83019,99.00,4,0,4,1.0,0.0,Yes,1.0
83020,83020,99.00,1,2,3,0.3333333333333333,0.6666666666666666,No,0.6666666666666666
83021,83021,99.00,143,42,185,0.772972972972973,0.22702702702702704,Yes,0.772972972972973
83022,83022,99.00,0,0,0,0,0,n/a,0
83023,83023,99.00,81,31,112,0.7232142857142857,0.2767857142857143,Yes,0.7232142857142857
83024,83024,99.00,2,0,2,1.0,0.0,Yes,1.0
83025,83025,99.00,142,39,181,0.7845303867403315,0.2154696132596685,Yes,0.7845303867403315
83026,83026,99.00,0,1,1,0.0,1.0,No,1.0
83027,83027,99.00,145,38,183,0.7923497267759563,0.20765027322404372,Yes,0.7923497267759563
83028,83028,99.00,86,22,108,0.7962962962962963,0.2037037037037037,Yes,0.7962962962962963
83029,83029,99.00,142,25,167,0.8502994011976048,0.1497005988023952,Yes,0.8502994011976048
83030,83030,99.00,7,2,9,0.7777777777777778,0.2222222222222222,Yes,0.7777777777777778
83031,83031,99.00,99,48,147,0.673469387755102,0.32653061224489793,Yes,0.673469387755102
83032,83032,83.33,118,39,157,0.7515923566878981,0.2484076433121019,Yes,0.7515923566878981
83033,83033,99.00,205,56,261,0.7854406130268199,0.21455938697318008,Yes,0.7854406130268199
83034,83034,99.00,0,1,1,0.0,1.0,No,1.0
83035,83035,99.00,96,18,114,0.8421052631578947,0.15789473684210525,Yes,0.8421052631578947
83036,83036,99.00,2,1,3,0.6666666666666666,0.3333333333333333,Yes,0.6666666666666666
83037,83037,83.33,3,1,4,0.75,0.25,Yes,0.75
83038,83038,83.33,58,26,84,0.6904761904761905,0.30952380952380953,Yes,0.6904761904761905
83039,83039,83.33,119,34,153,0.7777777777777778,0.2222222222222222,Yes,0.7777777777777778
83040,83040,83.33,0,1,1,0.0,1.0,No,1.0
83041,83041,99.00,6,0,6,1.0,0.0,Yes,1.0
83042,83042,83.33,100,25,125,0.8,0.2,Yes,0.8
83043,83043,83.33,1,1,2,0.5,0.5,Tie,0.5
83044,83044,83.33,99,26,125,0.792,0.208,Yes,0.792
83045,83045,99.00,120,30,150,0.8,0.2,Yes,0.8
83046,83046,99.00,79,20,99,0.797979797979798,0.20202020202020202,Yes,0.797979797979798
83047,83047,83.33,79,15,94,0.8404255319148937,0.1595744680851064,Yes,0.8404255319148937
83048,83048,83.33,3,0,3,1.0,0.0,Yes,1.0
83049,83049,99.00,1,2,3,0.3333333333333333,0.6666666666666666,No,0.6666666666666666
83050,83050,83.33,112,19,131,0.8549618320610687,0.1450381679389313,Yes,0.8549618320610687
83051,83051,83.33,61,19,80,0.7625,0.2375,Yes,0.7625
83052,83052,83.33,5,0,5,1.0,0.0,Yes,1.0
83053,83053,83.33,6,0,6,1.0,0.0,Yes,1.0
83054,83054,83.33,5,0,5,1.0,0.0,Yes,1.0
83055,83055,99.00,115,38,153,0.7516339869281046,0.24836601307189543,Yes,0.7516339869281046
83056,83056,99.00,5,1,6,0.8333333333333334,0.16666666666666666,Yes,0.8333333333333334
83057,83057,99.00,154,46,200,0.77,0.23,Yes,0.77
83058,83058,99.00,87,21,108,0.8055555555555556,0.19444444444444445,Yes,0.8055555555555556
83059,83059,99.00,67,15,82,0.8170731707317073,0.18292682926829268,Yes,0.8170731707317073
83060,83060,99.00,0,0,0,0,0,n/a,0
83061,83061,99.00,1,0,1,1.0,0.0,Yes,1.0
83062,83062,99.00,1,0,1,1.0,0.0,Yes,1.0
83063,83063,99.00,80,32,112,0.7142857142857143,0.2857142857142857,Yes,0.7142857142857143
83064,83064,99.00,172,39,211,0.8151658767772512,0.1848341232227488,Yes,0.8151658767772512
83065,83065,99.00,3,1,4,0.75,0.25,Yes,0.75
83066,83066,99.00,159,38,197,0.8071065989847716,0.19289340101522842,Yes,0.8071065989847716
83067,83067,99.00,138,22,160,0.8625,0.1375,Yes,0.8625
83068,83068,99.00,0,0,0,0,0,n/a,0
83069,83069,99.00,149,56,205,0.7268292682926829,0.2731707317073171,Yes,0.7268292682926829
83070,83070,99.00,105,28,133,0.7894736842105263,0.21052631578947367,Yes,0.7894736842105263
83071,83071,99.00,8,2,10,0.8,0.2,Yes,0.8
83072,83072,99.00,134,30,164,0.8170731707317073,0.18292682926829268,Yes,0.8170731707317073
83073,83073,99.00,3,0,3,1.0,0.0,Yes,1.0
83074,83074,99.00,165,49,214,0.7710280373831776,0.22897196261682243,Yes,0.7710280373831776
83075,83075,99.00,3,1,4,0.75,0.25,Yes,0.75
83076,83076,99.00,4,0,4,1.0,0.0,Yes,1.0
83077,83077,99.00,157,39,196,0.8010204081632653,0.1989795918367347,Yes,0.8010204081632653
83078,83078,99.00,128,29,157,0.8152866242038217,0.18471337579617833,Yes,0.8152866242038217
83079,83079,99.00,96,26,122,0.7868852459016393,0.21311475409836064,Yes,0.7868852459016393
83080,83080,99.00,5,1,6,0.8333333333333334,0.16666666666666666,Yes,0.8333333333333334
83081,83081,99.00,5,1,6,0.8333333333333334,0.16666666666666666,Yes,0.8333333333333334
83082,83082,99.00,114,36,150,0.76,0.24,Yes,0.76
83083,83083,99.00,7,3,10,0.7,0.3,Yes,0.7
83084,83084,99.00,21,1,22,0.9545454545454546,0.045454545454545456,Yes,0.9545454545454546
83085,83085,99.00,1,0,1,1.0,0.0,Yes,1.0
83086,83086,99.00,0,0,0,0,0,n/a,0
83087,83087,99.00,0,0,0,0,0,n/a,0
83088,83088,99.00,2,1,3,0.6666666666666666,0.3333333333333333,Yes,0.6666666666666666
83089,83089,99.00,1,0,1,1.0,0.0,Yes,1.0
84001,84001,99.00,47,15,62,0.7580645161290323,0.24193548387096775,Yes,0.7580645161290323
84002,84002,99.00,135,23,158,0.8544303797468354,0.14556962025316456,Yes,0.8544303797468354
84003,84003,99.00,61,10,71,0.8591549295774648,0.14084507042253522,Yes,0.8591549295774648
84004,84004,99.00,109,25,134,0.8134328358208955,0.1865671641791045,Yes,0.8134328358208955
84005,84005,99.00,1,0,1,1.0,0.0,Yes,1.0
84006,84006,99.00,117,36,153,0.7647058823529411,0.23529411764705882,Yes,0.7647058823529411
84007,84007,99.00,74,14,88,0.8409090909090909,0.1590909090909091,Yes,0.8409090909090909
84008,84008,99.00,3,0,3,1.0,0.0,Yes,1.0
84009,84009,55.56,11,0,11,1.0,0.0,Yes,1.0
84010,84010,55.56,147,29,176,0.8352272727272727,0.16477272727272727,Yes,0.8352272727272727
84011,84011,99.00,106,31,137,0.7737226277372263,0.22627737226277372,Yes,0.7737226277372263
84012,84012,99.00,4,1,5,0.8,0.2,Yes,0.8
84013,84013,99.00,51,16,67,0.7611940298507462,0.23880597014925373,Yes,0.7611940298507462
84014,84014,55.56,11,5,16,0.6875,0.3125,Yes,0.6875
84015,84015,55.56,118,25,143,0.8251748251748252,0.17482517482517482,Yes,0.8251748251748252
84016,84016,99.00,6,2,8,0.75,0.25,Yes,0.75
84017,84017,99.00,3,1,4,0.75,0.25,Yes,0.75
84018,84018,99.00,73,25,98,0.7448979591836735,0.25510204081632654,Yes,0.7448979591836735
84019,84019,83.33,144,27,171,0.8421052631578947,0.15789473684210525,Yes,0.8421052631578947
84020,84020,83.33,2,0,2,1.0,0.0,Yes,1.0
84021,84021,83.33,1,0,1,1.0,0.0,Yes,1.0
84022,84022,99.00,1,0,1,1.0,0.0,Yes,1.0
84023,84023,83.33,96,26,122,0.7868852459016393,0.21311475409836064,Yes,0.7868852459016393
84024,84024,83.33,110,39,149,0.738255033557047,0.26174496644295303,Yes,0.738255033557047
84025,84025,83.33,0,0,0,0,0,n/a,0
84026,84026,83.33,0,0,0,0,0,n/a,0
84027,84027,99.00,97,32,129,0.751937984496124,0.24806201550387597,Yes,0.751937984496124
84028,84028,99.00,1,0,1,1.0,0.0,Yes,1.0
84029,84029,99.00,1,0,1,1.0,0.0,Yes,1.0
84030,84030,99.00,44,25,69,0.6376811594202898,0.36231884057971014,Yes,0.6376811594202898
84031,84031,99.00,1,0,1,1.0,0.0,Yes,1.0
84032,84032,99.00,50,18,68,0.7352941176470589,0.2647058823529412,Yes,0.7352941176470589
84033,84033,99.00,0,0,0,0,0,n/a,0
84034,84034,99.00,3,1,4,0.75,0.25,Yes,0.75
84035,84035,99.00,108,38,146,0.7397260273972602,0.2602739726027397,Yes,0.7397260273972602
84036,84036,99.00,1,0,1,1.0,0.0,Yes,1.0
84037,84037,99.00,0,0,0,0,0,n/a,0
84038,84038,99.00,48,16,64,0.75,0.25,Yes,0.75
84039,84039,99.00,65,33,98,0.6632653061224489,0.336734693877551,Yes,0.6632653061224489
84040,84040,99.00,67,14,81,0.8271604938271605,0.1728395061728395,Yes,0.8271604938271605
84041,84041,99.00,86,32,118,0.7288135593220338,0.2711864406779661,Yes,0.7288135593220338
84042,84042,99.00,62,16,78,0.7948717948717948,0.20512820512820512,Yes,0.7948717948717948
84043,84043,99.00,121,17,138,0.8768115942028986,0.12318840579710146,Yes,0.8768115942028986
84044,84044,99.00,0,0,0,0,0,n/a,0
84045,84045,99.00,56,15,71,0.7887323943661971,0.2112676056338028,Yes,0.7887323943661971
84046,84046,99.00,1,1,2,0.5,0.5,Tie,0.5
84047,84047,99.00,20,3,23,0.8695652173913043,0.13043478260869565,Yes,0.8695652173913043
84048,84048,99.00,62,16,78,0.7948717948717948,0.20512820512820512,Yes,0.7948717948717948
84049,84049,99.00,81,34,115,0.7043478260869566,0.2956521739130435,Yes,0.7043478260869566
84050,84050,99.00,94,30,124,0.7580645161290323,0.24193548387096775,Yes,0.7580645161290323
84051,84051,99.00,0,0,0,0,0,n/a,0
84052,84052,99.00,0,1,1,0.0,1.0,No,1.0
84053,84053,99.00,53,26,79,0.6708860759493671,0.3291139240506329,Yes,0.6708860759493671
84054,84054,99.00,0,0,0,0,0,n/a,0
84055,84055,99.00,34,8,42,0.8095238095238095,0.19047619047619047,Yes,0.8095238095238095
84056,84056,99.00,43,13,56,0.7678571428571429,0.23214285714285715,Yes,0.7678571428571429
84057,84057,99.00,52,18,70,0.7428571428571429,0.2571428571428571,Yes,0.7428571428571429
84058,84058,99.00,103,53,156,0.6602564102564102,0.33974358974358976,Yes,0.6602564102564102
84059,84059,99.00,2,0,2,1.0,0.0,Yes,1.0
84060,84060,83.33,37,12,49,0.7551020408163265,0.24489795918367346,Yes,0.7551020408163265
84061,84061,99.00,50,11,61,0.819672131147541,0.18032786885245902,Yes,0.819672131147541
84062,84062,99.00,88,18,106,0.8301886792452831,0.16981132075471697,Yes,0.8301886792452831
84063,84063,99.00,0,0,0,0,0,n/a,0
84064,84064,99.00,54,15,69,0.782608695652174,0.21739130434782608,Yes,0.782608695652174
84065,84065,99.00,66,23,89,0.7415730337078652,0.25842696629213485,Yes,0.7415730337078652
84066,84066,99.00,3,0,3,1.0,0.0,Yes,1.0
84067,84067,99.00,69,25,94,0.7340425531914894,0.26595744680851063,Yes,0.7340425531914894
84068,84068,99.00,0,0,0,0,0,n/a,0
84069,84069,99.00,0,1,1,0.0,1.0,No,1.0
84070,84070,99.00,1,0,1,1.0,0.0,Yes,1.0
84071,84071,99.00,87,24,111,0.7837837837837838,0.21621621621621623,Yes,0.7837837837837838
84072,84072,99.00,74,15,89,0.8314606741573034,0.16853932584269662,Yes,0.8314606741573034
84073,84073,99.00,0,0,0,0,0,n/a,0
84074,84074,99.00,93,19,112,0.8303571428571429,0.16964285714285715,Yes,0.8303571428571429
84075,84075,66.67,51,12,63,0.8095238095238095,0.19047619047619047,Yes,0.8095238095238095
84076,84076,99.00,0,0,0,0,0,n/a,0
84077,84077,99.00,1,0,1,1.0,0.0,Yes,1.0
84078,84078,99.00,0,0,0,0,0,n/a,0
84079,84079,99.00,0,0,0,0,0,n/a,0
84080,84080,55.56,27,3,30,0.9,0.1,Yes,0.9
84081,84081,99.00,0,0,0,0,0,n/a,0
84082,84082,99.00,1,0,1,1.0,0.0,Yes,1.0
84083,84083,99.00,1,0,1,1.0,0.0,Yes,1.0
84084,84084,99.00,0,2,2,0.0,1.0,No,1.0
84085,84085,99.00,86,19,105,0.819047619047619,0.18095238095238095,Yes,0.819047619047619
85001,85001,99.00,108,46,154,0.7012987012987013,0.2987012987012987,Yes,0.7012987012987013
85002,85002,99.00,161,59,220,0.7318181818181818,0.2681818181818182,Yes,0.7318181818181818
85003,85003,99.00,9,2,11,0.8181818181818182,0.18181818181818182,Yes,0.8181818181818182
85004,85004,37.50,93,46,139,0.6690647482014388,0.33093525179856115,Yes,0.6690647482014388
85005,85005,37.50,74,15,89,0.8314606741573034,0.16853932584269662,Yes,0.8314606741573034
85006,85006,37.50,5,1,6,0.8333333333333334,0.16666666666666666,Yes,0.8333333333333334
85007,85007,99.00,101,34,135,0.7481481481481481,0.2518518518518518,Yes,0.7481481481481481
85008,85008,99.00,77,26,103,0.7475728155339806,0.2524271844660194,Yes,0.7475728155339806
85009,85009,99.00,54,21,75,0.72,0.28,Yes,0.72
85010,85010,99.00,8,2,10,0.8,0.2,Yes,0.8
85011,85011,99.00,127,25,152,0.8355263157894737,0.16447368421052633,Yes,0.8355263157894737
85012,85012,99.00,5,1,6,0.8333333333333334,0.16666666666666666,Yes,0.8333333333333334
85013,85013,99.00,220,81,301,0.7308970099667774,0.2691029900332226,Yes,0.7308970099667774
85014,85014,99.00,2,0,2,1.0,0.0,Yes,1.0
85015,85015,99.00,79,17,96,0.8229166666666666,0.17708333333333334,Yes,0.8229166666666666
85016,85016,99.00,46,14,60,0.7666666666666667,0.23333333333333334,Yes,0.7666666666666667
85017,85017,99.00,0,0,0,0,0,n/a,0
85018,85018,99.00,0,0,0,0,0,n/a,0
85019,85019,99.00,10,4,14,0.7142857142857143,0.2857142857142857,Yes,0.7142857142857143
85020,85020,99.00,87,39,126,0.6904761904761905,0.30952380952380953,Yes,0.6904761904761905
85021,85021,99.00,146,45,191,0.7643979057591623,0.2356020942408377,Yes,0.7643979057591623
85022,85022,99.00,40,9,49,0.8163265306122449,0.1836734693877551,Yes,0.8163265306122449
85023,85023,99.00,149,40,189,0.7883597883597884,0.21164021164021163,Yes,0.7883597883597884
85024,85024,99.00,1,1,2,0.5,0.5,Tie,0.5
85025,85025,99.00,117,49,166,0.7048192771084337,0.29518072289156627,Yes,0.7048192771084337
85026,85026,99.00,3,1,4,0.75,0.25,Yes,0.75
85027,85027,99.00,130,52,182,0.7142857142857143,0.2857142857142857,Yes,0.7142857142857143
85028,85028,99.00,57,14,71,0.8028169014084507,0.19718309859154928,Yes,0.8028169014084507
85029,85029,99.00,1,0,1,1.0,0.0,Yes,1.0
85030,85030,99.00,110,29,139,0.7913669064748201,0.20863309352517986,Yes,0.7913669064748201
85031,85031,99.00,1,0,1,1.0,0.0,Yes,1.0
85032,85032,75.00,19,5,24,0.7916666666666666,0.20833333333333334,Yes,0.7916666666666666
85033,85033,50.00,39,19,58,0.6724137931034483,0.3275862068965517,Yes,0.6724137931034483
85034,85034,99.00,102,19,121,0.8429752066115702,0.15702479338842976,Yes,0.8429752066115702
85035,85035,99.00,0,0,0,0,0,n/a,0
85036,85036,99.00,0,1,1,0.0,1.0,No,1.0
85037,85037,99.00,2,1,3,0.6666666666666666,0.3333333333333333,Yes,0.6666666666666666
85038,85038,66.67,0,0,0,0,0,n/a,0
85039,85039,66.67,47,15,62,0.7580645161290323,0.24193548387096775,Yes,0.7580645161290323
85040,85040,66.67,2,0,2,1.0,0.0,Yes,1.0
85041,85041,99.00,1,1,2,0.5,0.5,Tie,0.5
85042,85042,99.00,0,0,0,0,0,n/a,0
85043,85043,99.00,68,20,88,0.7727272727272727,0.22727272727272727,Yes,0.7727272727272727
85044,85044,99.00,4,0,4,1.0,0.0,Yes,1.0
85045,85045,99.00,104,21,125,0.832,0.168,Yes,0.832
85046,85046,99.00,84,27,111,0.7567567567567568,0.24324324324324326,Yes,0.7567567567567568
85047,85047,99.00,0,0,0,0,0,n/a,0
85048,85048,99.00,47,14,61,0.7704918032786885,0.22950819672131148,Yes,0.7704918032786885
85049,85049,99.00,59,23,82,0.7195121951219512,0.2804878048780488,Yes,0.7195121951219512
85050,85050,99.00,117,26,143,0.8181818181818182,0.18181818181818182,Yes,0.8181818181818182
85051,85051,99.00,1,0,1,1.0,0.0,Yes,1.0
85052,85052,99.00,96,28,124,0.7741935483870968,0.22580645161290322,Yes,0.7741935483870968
85053,85053,66.67,44,8,52,0.8461538461538461,0.15384615384615385,Yes,0.8461538461538461
85054,85054,66.67,46,11,57,0.8070175438596491,0.19298245614035087,Yes,0.8070175438596491
85055,85055,66.67,31,18,49,0.6326530612244898,0.3673469387755102,Yes,0.6326530612244898
85056,85056,99.00,88,61,149,0.5906040268456376,0.40939597315436244,Yes,0.5906040268456376
85057,85057,99.00,1,1,2,0.5,0.5,Tie,0.5
85058,85058,99.00,112,36,148,0.7567567567567568,0.24324324324324326,Yes,0.7567567567567568
85059,85059,99.00,0,2,2,0.0,1.0,No,1.0
85060,85060,99.00,1,0,1,1.0,0.0,Yes,1.0
85061,85061,99.00,2,0,2,1.0,0.0,Yes,1.0
85062,85062,99.00,109,28,137,0.7956204379562044,0.20437956204379562,Yes,0.7956204379562044
85063,85063,99.00,6,0,6,1.0,0.0,Yes,1.0
85064,85064,99.00,80,19,99,0.8080808080808081,0.1919191919191919,Yes,0.8080808080808081
85065,85065,99.00,4,0,4,1.0,0.0,Yes,1.0
85066,85066,99.00,88,20,108,0.8148148148148148,0.18518518518518517,Yes,0.8148148148148148
85067,85067,99.00,100,22,122,0.819672131147541,0.18032786885245902,Yes,0.819672131147541
85068,85068,99.00,16,2,18,0.8888888888888888,0.1111111111111111,Yes,0.8888888888888888
85069,85069,99.00,59,25,84,0.7023809523809523,0.2976190476190476,Yes,0.7023809523809523
85070,85070,99.00,92,27,119,0.773109243697479,0.226890756302521,Yes,0.773109243697479
85071,85071,99.00,0,0,0,0,0,n/a,0
85072,85072,99.00,0,0,0,0,0,n/a,0
85073,85073,99.00,0,0,0,0,0,n/a,0
85074,85074,99.00,0,0,0,0,0,n/a,0
85075,85075,99.00,0,0,0,0,0,n/a,0
85076,85076,99.00,0,0,0,0,0,n/a,0
85077,85077,99.00,0,0,0,0,0,n/a,0
85078,85078,99.00,0,0,0,0,0,n/a,0
85079,85079,99.00,0,0,0,0,0,n/a,0
85080,85080,99.00,82,13,95,0.8631578947368421,0.1368421052631579,Yes,0.8631578947368421
85081,85081,99.00,0,0,0,0,0,n/a,0
85082,85082,99.00,0,0,0,0,0,n/a,0
85083,85083,75.00,1,0,1,1.0,0.0,Yes,1.0
85084,85084,99.00,1,1,2,0.5,0.5,Tie,0.5
85085,85085,99.00,1,0,1,1.0,0.0,Yes,1.0
86001,86001,99.00,0,0,0,0,0,n/a,0
86002,86002,99.00,124,31,155,0.8,0.2,Yes,0.8
86003,86003,99.00,0,2,2,0.0,1.0,No,1.0
86004,86004,99.00,92,34,126,0.7301587301587301,0.2698412698412698,Yes,0.7301587301587301
86005,86005,0.00,0,0,0,0,0,n/a,0
86006,86006,0.00,1,0,1,1.0,0.0,Yes,1.0
86007,86007,0.00,1,0,1,1.0,0.0,Yes,1.0
86008,86008,99.00,74,27,101,0.7326732673267327,0.26732673267326734,Yes,0.7326732673267327
86009,86009,99.00,72,19,91,0.7912087912087912,0.2087912087912088,Yes,0.7912087912087912
86010,86010,99.00,0,0,0,0,0,n/a,0
86011,86011,80.00,71,22,93,0.7634408602150538,0.23655913978494625,Yes,0.7634408602150538
86012,86012,99.00,67,19,86,0.7790697674418605,0.22093023255813954,Yes,0.7790697674418605
86013,86013,80.00,1,1,2,0.5,0.5,Tie,0.5
86014,86014,80.00,79,22,101,0.7821782178217822,0.21782178217821782,Yes,0.7821782178217822
86015,86015,99.00,6,0,6,1.0,0.0,Yes,1.0
86016,86016,80.00,0,0,0,0,0,n/a,0
86017,86017,80.00,1,1,2,0.5,0.5,Tie,0.5
86018,86018,99.00,59,20,79,0.7468354430379747,0.25316455696202533,Yes,0.7468354430379747
86019,86019,99.00,95,14,109,0.8715596330275229,0.12844036697247707,Yes,0.8715596330275229
86020,86020,99.00,52,10,62,0.8387096774193549,0.16129032258064516,Yes,0.8387096774193549
86021,86021,0.00,0,0,0,0,0,n/a,0
86022,86022,99.00,82,19,101,0.8118811881188119,0.18811881188118812,Yes,0.8118811881188119
86023,86023,99.00,3,0,3,1.0,0.0,Yes,1.0
86024,86024,99.00,4,0,4,1.0,0.0,Yes,1.0
86025,86025,99.00,73,17,90,0.8111111111111111,0.18888888888888888,Yes,0.8111111111111111
86026,86026,99.00,84,20,104,0.8076923076923077,0.19230769230769232,Yes,0.8076923076923077
86027,86027,99.00,0,0,0,0,0,n/a,0
86028,86028,0.00,2,0,2,1.0,0.0,Yes,1.0
86029,86029,0.00,0,0,0,0,0,n/a,0
86030,86030,0.00,0,0,0,0,0,n/a,0
86031,86031,99.00,1,0,1,1.0,0.0,Yes,1.0
86032,86032,99.00,77,22,99,0.7777777777777778,0.2222222222222222,Yes,0.7777777777777778
86033,86033,99.00,120,44,164,0.7317073170731707,0.2682926829268293,Yes,0.7317073170731707
86034,86034,99.00,2,0,2,1.0,0.0,Yes,1.0
86035,86035,99.00,0,0,0,0,0,n/a,0
86036,86036,99.00,114,18,132,0.8636363636363636,0.13636363636363635,Yes,0.8636363636363636
86037,86037,99.00,1,0,1,1.0,0.0,Yes,1.0
86038,86038,99.00,81,17,98,0.826530612244898,0.17346938775510204,Yes,0.826530612244898
86039,86039,99.00,2,0,2,1.0,0.0,Yes,1.0
86040,86040,99.00,109,35,144,0.7569444444444444,0.24305555555555555,Yes,0.7569444444444444
86041,86041,99.00,1,0,1,1.0,0.0,Yes,1.0
86042,86042,99.00,0,0,0,0,0,n/a,0
86043,86043,99.00,0,0,0,0,0,n/a,0
86044,86044,99.00,1,0,1,1.0,0.0,Yes,1.0
86045,86045,99.00,85,11,96,0.8854166666666666,0.11458333333333333,Yes,0.8854166666666666
86046,86046,0.00,0,0,0,0,0,n/a,0
86047,86047,99.00,67,16,83,0.8072289156626506,0.1927710843373494,Yes,0.8072289156626506
86048,86048,0.00,1,0,1,1.0,0.0,Yes,1.0
86049,86049,99.00,2,0,2,1.0,0.0,Yes,1.0
86050,86050,99.00,63,17,80,0.7875,0.2125,Yes,0.7875
86051,86051,99.00,0,1,1,0.0,1.0,No,1.0
86052,86052,99.00,65,13,78,0.8333333333333334,0.16666666666666666,Yes,0.8333333333333334
86053,86053,99.00,2,0,2,1.0,0.0,Yes,1.0
86054,86054,99.00,2,0,2,1.0,0.0,Yes,1.0
86055,86055,99.00,69,20,89,0.7752808988764045,0.2247191011235955,Yes,0.7752808988764045
86056,86056,99.00,58,16,74,0.7837837837837838,0.21621621621621623,Yes,0.7837837837837838
86057,86057,99.00,73,13,86,0.8488372093023255,0.1511627906976744,Yes,0.8488372093023255
86058,86058,99.00,4,1,5,0.8,0.2,Yes,0.8
86059,86059,0.00,1,1,2,0.5,0.5,Tie,0.5
86060,86060,99.00,0,0,0,0,0,n/a,0
86061,86061,99.00,3,0,3,1.0,0.0,Yes,1.0
86062,86062,99.00,3,0,3,1.0,0.0,Yes,1.0
86063,86063,99.00,60,21,81,0.7407407407407407,0.25925925925925924,Yes,0.7407407407407407
86064,86064,99.00,60,21,81,0.7407407407407407,0.25925925925925924,Yes,0.7407407407407407
86065,86065,99.00,2,0,2,1.0,0.0,Yes,1.0
86066,86066,80.00,112,17,129,0.8682170542635659,0.13178294573643412,Yes,0.8682170542635659
86067,86067,99.00,0,0,0,0,0,n/a,0
86068,86068,99.00,0,1,1,0.0,1.0,No,1.0
86069,86069,99.00,1,1,2,0.5,0.5,Tie,0.5
86070,86070,99.00,0,0,0,0,0,n/a,0
86071,86071,99.00,1,0,1,1.0,0.0,Yes,1.0
86072,86072,99.00,1,0,1,1.0,0.0,Yes,1.0
87001,87001,0.00,0,0,0,0,0,n/a,0
87002,87002,0.00,0,0,0,0,0,n/a,0
87003,87003,0.00,1,0,1,1.0,0.0,Yes,1.0
87004,87004,0.00,1,0,1,1.0,0.0,Yes,1.0
87005,87005,0.00,0,0,0,0,0,n/a,0
87006,87006,0.00,1,0,1,1.0,0.0,Yes,1.0
87007,87007,0.00,1,0,1,1.0,0.0,Yes,1.0
87008,87008,0.00,1,2,3,0.3333333333333333,0.6666666666666666,No,0.6666666666666666
87009,87009,0.00,0,0,0,0,0,n/a,0
87010,87010,0.00,3,0,3,1.0,0.0,Yes,1.0
87011,87011,0.00,2,0,2,1.0,0.0,Yes,1.0
87012,87012,0.00,0,0,0,0,0,n/a,0
87013,87013,0.00,0,0,0,0,0,n/a,0
87014,87014,0.00,1,0,1,1.0,0.0,Yes,1.0
87015,87015,0.00,0,1,1,0.0,1.0,No,1.0
87016,87016,0.00,1,0,1,1.0,0.0,Yes,1.0
87017,87017,99.00,0,0,0,0,0,n/a,0
87018,87018,99.00,2,0,2,1.0,0.0,Yes,1.0
87019,87019,99.00,93,38,131,0.7099236641221374,0.2900763358778626,Yes,0.7099236641221374
87020,87020,99.00,1,0,1,1.0,0.0,Yes,1.0
87021,87021,0.00,0,0,0,0,0,n/a,0
87022,87022,99.00,108,45,153,0.7058823529411765,0.29411764705882354,Yes,0.7058823529411765
87023,87023,99.00,2,0,2,1.0,0.0,Yes,1.0
87024,87024,75.00,0,0,0,0,0,n/a,0
87025,87025,99.00,2,0,2,1.0,0.0,Yes,1.0
87026,87026,99.00,95,23,118,0.8050847457627118,0.19491525423728814,Yes,0.8050847457627118
87027,87027,99.00,1,0,1,1.0,0.0,Yes,1.0
87028,87028,99.00,89,23,112,0.7946428571428571,0.20535714285714285,Yes,0.7946428571428571
87029,87029,99.00,143,30,173,0.8265895953757225,0.17341040462427745,Yes,0.8265895953757225
87030,87030,99.00,103,23,126,0.8174603174603174,0.18253968253968253,Yes,0.8174603174603174
87031,87031,99.00,4,1,5,0.8,0.2,Yes,0.8
87032,87032,99.00,37,19,56,0.6607142857142857,0.3392857142857143,Yes,0.6607142857142857
87033,87033,75.00,87,34,121,0.71900826446281,0.2809917355371901,Yes,0.71900826446281
87034,87034,75.00,3,0,3,1.0,0.0,Yes,1.0
87035,87035,75.00,89,34,123,0.7235772357723578,0.2764227642276423,Yes,0.7235772357723578
87036,87036,75.00,0,1,1,0.0,1.0,No,1.0
87037,87037,99.00,101,22,123,0.8211382113821138,0.17886178861788618,Yes,0.8211382113821138
87038,87038,99.00,0,0,0,0,0,n/a,0
87039,87039,99.00,72,21,93,0.7741935483870968,0.22580645161290322,Yes,0.7741935483870968
87040,87040,66.67,96,31,127,0.7559055118110236,0.2440944881889764,Yes,0.7559055118110236
87041,87041,66.67,4,0,4,1.0,0.0,Yes,1.0
87042,87042,99.00,13,3,16,0.8125,0.1875,Yes,0.8125
87043,87043,0.00,0,0,0,0,0,n/a,0
87044,87044,99.00,0,0,0,0,0,n/a,0
87045,87045,99.00,0,0,0,0,0,n/a,0
87046,87046,99.00,44,16,60,0.7333333333333333,0.26666666666666666,Yes,0.7333333333333333
87047,87047,99.00,150,37,187,0.8021390374331551,0.19786096256684493,Yes,0.8021390374331551
87048,87048,99.00,113,36,149,0.7583892617449665,0.24161073825503357,Yes,0.7583892617449665
87049,87049,99.00,202,65,267,0.7565543071161048,0.24344569288389514,Yes,0.7565543071161048
87050,87050,99.00,4,0,4,1.0,0.0,Yes,1.0
87051,87051,99.00,231,72,303,0.7623762376237624,0.2376237623762376,Yes,0.7623762376237624
87052,87052,99.00,1,0,1,1.0,0.0,Yes,1.0
87053,87053,99.00,4,0,4,1.0,0.0,Yes,1.0
87054,87054,99.00,7,0,7,1.0,0.0,Yes,1.0
87055,87055,99.00,170,39,209,0.8133971291866029,0.18660287081339713,Yes,0.8133971291866029
87056,87056,99.00,186,42,228,0.8157894736842105,0.18421052631578946,Yes,0.8157894736842105
87057,87057,99.00,148,55,203,0.729064039408867,0.270935960591133,Yes,0.729064039408867
87058,87058,99.00,171,56,227,0.7533039647577092,0.24669603524229075,Yes,0.7533039647577092
87059,87059,99.00,1,0,1,1.0,0.0,Yes,1.0
87060,87060,99.00,197,49,246,0.8008130081300813,0.1991869918699187,Yes,0.8008130081300813
87061,87061,99.00,156,61,217,0.7188940092165899,0.28110599078341014,Yes,0.7188940092165899
87062,87062,99.00,1,1,2,0.5,0.5,Tie,0.5
87063,87063,99.00,0,0,0,0,0,n/a,0
87064,87064,99.00,0,0,0,0,0,n/a,0
87065,87065,99.00,4,0,4,1.0,0.0,Yes,1.0
87066,87066,99.00,54,22,76,0.7105263157894737,0.2894736842105263,Yes,0.7105263157894737
87067,87067,99.00,0,1,1,0.0,1.0,No,1.0
87068,87068,99.00,53,23,76,0.6973684210526315,0.3026315789473684,Yes,0.6973684210526315
87069,87069,0.00,5,0,5,1.0,0.0,Yes,1.0
87070,87070,99.00,90,33,123,0.7317073170731707,0.2682926829268293,Yes,0.7317073170731707
87071,87071,99.00,84,21,105,0.8,0.2,Yes,0.8
87072,87072,99.00,116,27,143,0.8111888111888111,0.1888111888111888,Yes,0.8111888111888111
87073,87073,99.00,15,1,16,0.9375,0.0625,Yes,0.9375
87074,87074,66.67,80,29,109,0.7339449541284404,0.26605504587155965,Yes,0.7339449541284404
87075,87075,99.00,1,2,3,0.3333333333333333,0.6666666666666666,No,0.6666666666666666
87076,87076,66.67,1,1,2,0.5,0.5,Tie,0.5
87077,87077,99.00,89,43,132,0.6742424242424242,0.32575757575757575,Yes,0.6742424242424242
87078,87078,99.00,117,37,154,0.7597402597402597,0.24025974025974026,Yes,0.7597402597402597
87079,87079,99.00,0,0,0,0,0,n/a,0
87080,87080,37.50,65,28,93,0.6989247311827957,0.3010752688172043,Yes,0.6989247311827957
87081,87081,99.00,95,20,115,0.8260869565217391,0.17391304347826086,Yes,0.8260869565217391
87082,87082,37.50,2,1,3,0.6666666666666666,0.3333333333333333,Yes,0.6666666666666666
87083,87083,99.00,0,0,0,0,0,n/a,0
87084,87084,99.00,133,28,161,0.8260869565217391,0.17391304347826086,Yes,0.8260869565217391
87085,87085,99.00,1,0,1,1.0,0.0,Yes,1.0
87086,87086,99.00,2,0,2,1.0,0.0,Yes,1.0
87087,87087,99.00,144,47,191,0.7539267015706806,0.24607329842931938,Yes,0.7539267015706806
87088,87088,99.00,0,1,1,0.0,1.0,No,1.0
87089,87089,99.00,2,0,2,1.0,0.0,Yes,1.0
87090,87090,0.00,0,0,0,0,0,n/a,0
87091,87091,0.00,0,0,0,0,0,n/a,0
87092,87092,0.00,0,0,0,0,0,n/a,0
87093,87093,99.00,0,0,0,0,0,n/a,0
87094,87094,99.00,0,0,0,0,0,n/a,0
87095,87095,99.00,0,0,0,0,0,n/a,0
87096,87096,99.00,0,0,0,0,0,n/a,0
87097,87097,99.00,27,25,52,0.5192307692307693,0.4807692307692308,Yes,0.5192307692307693
87098,87098,99.00,2,0,2,1.0,0.0,Yes,1.0
87099,87099,99.00,2,3,5,0.4,0.6,No,0.6
87100,87100,99.00,0,1,1,0.0,1.0,No,1.0
87101,87101,99.00,8,0,8,1.0,0.0,Yes,1.0
87102,87102,99.00,0,0,0,0,0,n/a,0
41001,41001,99.00,5,0,5,1.0,0.0,Yes,1.0
41002,41002,99.00,85,113,198,0.4292929292929293,0.5707070707070707,No,0.5707070707070707
41003,41003,99.00,92,143,235,0.39148936170212767,0.6085106382978723,No,0.6085106382978723
41004,41004,99.00,5,5,10,0.5,0.5,Tie,0.5
41005,41005,36.36,39,125,164,0.23780487804878048,0.7621951219512195,No,0.7621951219512195
41006,41006,99.00,65,42,107,0.6074766355140186,0.3925233644859813,Yes,0.6074766355140186
41007,41007,99.00,68,63,131,0.5190839694656488,0.48091603053435117,Yes,0.5190839694656488
41008,41008,99.00,54,49,103,0.5242718446601942,0.47572815533980584,Yes,0.5242718446601942
41009,41009,99.00,36,60,96,0.375,0.625,No,0.625
41010,41010,99.00,1,2,3,0.3333333333333333,0.6666666666666666,No,0.6666666666666666
41011,41011,99.00,16,30,46,0.34782608695652173,0.6521739130434783,No,0.6521739130434783
41012,41012,36.36,33,44,77,0.42857142857142855,0.5714285714285714,No,0.5714285714285714
41013,41013,36.36,0,1,1,0.0,1.0,No,1.0
41014,41014,99.00,0,0,0,0,0,n/a,0
41015,41015,36.36,8,5,13,0.6153846153846154,0.38461538461538464,Yes,0.6153846153846154
41016,41016,99.00,36,55,91,0.3956043956043956,0.6043956043956044,No,0.6043956043956044
41017,41017,99.00,92,162,254,0.36220472440944884,0.6377952755905512,No,0.6377952755905512
41018,41018,99.00,60,80,140,0.42857142857142855,0.5714285714285714,No,0.5714285714285714
41019,41019,99.00,0,0,0,0,0,n/a,0
41020,41020,99.00,61,62,123,0.4959349593495935,0.5040650406504065,No,0.5040650406504065
41021,41021,99.00,93,73,166,0.5602409638554217,0.4397590361445783,Yes,0.5602409638554217
41022,41022,99.00,16,15,31,0.5161290322580645,0.4838709677419355,Yes,0.5161290322580645
41023,41023,99.00,1,0,1,1.0,0.0,Yes,1.0
41024,41024,66.67,2,1,3,0.6666666666666666,0.3333333333333333,Yes,0.6666666666666666
41025,41025,66.67,11,16,27,0.4074074074074074,0.5925925925925926,No,0.5925925925925926
41026,41026,99.00,0,0,0,0,0,n/a,0
41027,41027,99.00,3,1,4,0.75,0.25,Yes,0.75
41028,41028,99.00,104,38,142,0.7323943661971831,0.2676056338028169,Yes,0.7323943661971831
41029,41029,66.67,0,0,0,0,0,n/a,0
41030,41030,99.00,126,42,168,0.75,0.25,Yes,0.75
41031,41031,99.00,116,30,146,0.7945205479452054,0.2054794520547945,Yes,0.7945205479452054
41032,41032,99.00,16,1,17,0.9411764705882353,0.058823529411764705,Yes,0.9411764705882353
41033,41033,99.00,158,48,206,0.7669902912621359,0.23300970873786409,Yes,0.7669902912621359
41034,41034,99.00,4,0,4,1.0,0.0,Yes,1.0
41035,41035,99.00,56,48,104,0.5384615384615384,0.46153846153846156,Yes,0.5384615384615384
41036,41036,99.00,64,79,143,0.44755244755244755,0.5524475524475524,No,0.5524475524475524
41037,41037,99.00,107,37,144,0.7430555555555556,0.2569444444444444,Yes,0.7430555555555556
41038,41038,99.00,150,34,184,0.8152173913043478,0.18478260869565216,Yes,0.8152173913043478
41039,41039,99.00,110,22,132,0.8333333333333334,0.16666666666666666,Yes,0.8333333333333334
41040,41040,99.00,78,28,106,0.7358490566037735,0.2641509433962264,Yes,0.7358490566037735
41041,41041,99.00,78,26,104,0.75,0.25,Yes,0.75
41042,41042,33.33,2,3,5,0.4,0.6,No,0.6
41043,41043,99.00,103,31,134,0.7686567164179104,0.23134328358208955,Yes,0.7686567164179104
41044,41044,99.00,0,1,1,0.0,1.0,No,1.0
41045,41045,99.00,110,19,129,0.8527131782945736,0.14728682170542637,Yes,0.8527131782945736
41046,41046,99.00,151,163,314,0.48089171974522293,0.5191082802547771,No,0.5191082802547771
41047,41047,99.00,169,33,202,0.8366336633663366,0.16336633663366337,Yes,0.8366336633663366
41048,41048,99.00,73,17,90,0.8111111111111111,0.18888888888888888,Yes,0.8111111111111111
41049,41049,99.00,100,32,132,0.7575757575757576,0.24242424242424243,Yes,0.7575757575757576
41050,41050,99.00,36,145,181,0.19889502762430938,0.8011049723756906,No,0.8011049723756906
41051,41051,99.00,35,29,64,0.546875,0.453125,Yes,0.546875
41052,41052,99.00,5,1,6,0.8333333333333334,0.16666666666666666,Yes,0.8333333333333334
41053,41053,99.00,8,0,8,1.0,0.0,Yes,1.0
41054,41054,99.00,94,21,115,0.8173913043478261,0.1826086956521739,Yes,0.8173913043478261
41055,41055,99.00,174,38,212,0.8207547169811321,0.1792452830188679,Yes,0.8207547169811321
41056,41056,99.00,0,2,2,0.0,1.0,No,1.0
41057,41057,36.36,10,7,17,0.5882352941176471,0.4117647058823529,Yes,0.5882352941176471
41058,41058,36.36,53,131,184,0.28804347826086957,0.7119565217391305,No,0.7119565217391305
41059,41059,36.36,44,81,125,0.352,0.648,No,0.648
41060,41060,33.33,2,3,5,0.4,0.6,No,0.6
41061,41061,33.33,24,23,47,0.5106382978723404,0.48936170212765956,Yes,0.5106382978723404
41062,41062,33.33,18,23,41,0.43902439024390244,0.5609756097560976,No,0.5609756097560976
41063,41063,99.00,155,107,262,0.5916030534351145,0.4083969465648855,Yes,0.5916030534351145
41064,41064,99.00,9,2,11,0.8181818181818182,0.18181818181818182,Yes,0.8181818181818182
41065,41065,99.00,2,0,2,1.0,0.0,Yes,1.0
41066,41066,99.00,0,0,0,0,0,n/a,0
41067,41067,99.00,2,0,2,1.0,0.0,Yes,1.0
41068,41068,99.00,102,50,152,0.6710526315789473,0.32894736842105265,Yes,0.6710526315789473
41069,41069,99.00,68,20,88,0.7727272727272727,0.22727272727272727,Yes,0.7727272727272727
41070,41070,99.00,66,54,120,0.55,0.45,Yes,0.55
41071,41071,0.00,4,1,5,0.8,0.2,Yes,0.8
41072,41072,99.00,0,2,2,0.0,1.0,No,1.0
41073,41073,0.00,6,0,6,1.0,0.0,Yes,1.0
41074,41074,0.00,6,0,6,1.0,0.0,Yes,1.0
41075,41075,99.00,54,38,92,0.5869565217391305,0.41304347826086957,Yes,0.5869565217391305
41076,41076,99.00,88,65,153,0.5751633986928104,0.42483660130718953,Yes,0.5751633986928104
41077,41077,99.00,88,68,156,0.5641025641025641,0.4358974358974359,Yes,0.5641025641025641
41078,41078,99.00,1,0,1,1.0,0.0,Yes,1.0
41079,41079,66.67,41,23,64,0.640625,0.359375,Yes,0.640625
41080,41080,99.00,0,0,0,0,0,n/a,0
41081,41081,99.00,52,39,91,0.5714285714285714,0.42857142857142855,Yes,0.5714285714285714
41082,41082,99.00,68,47,115,0.591304347826087,0.40869565217391307,Yes,0.591304347826087
41083,41083,99.00,2,1,3,0.6666666666666666,0.3333333333333333,Yes,0.6666666666666666
41084,41084,33.33,22,32,54,0.4074074074074074,0.5925925925925926,No,0.5925925925925926
41085,41085,99.00,1,0,1,1.0,0.0,Yes,1.0
41086,41086,99.00,85,67,152,0.5592105263157895,0.4407894736842105,Yes,0.5592105263157895
41087,41087,99.00,62,30,92,0.6739130434782609,0.32608695652173914,Yes,0.6739130434782609
41088,41088,99.00,67,67,134,0.5,0.5,Tie,0.5
41089,41089,99.00,5,0,5,1.0,0.0,Yes,1.0
41090,41090,99.00,16,12,28,0.5714285714285714,0.42857142857142855,Yes,0.5714285714285714
41091,41091,66.67,65,26,91,0.7142857142857143,0.2857142857142857,Yes,0.7142857142857143
41092,41092,99.00,0,0,0,0,0,n/a,0
41093,41093,99.00,0,0,0,0,0,n/a,0
41094,41094,36.36,4,7,11,0.36363636363636365,0.6363636363636364,No,0.6363636363636364
41095,41095,99.00,28,66,94,0.2978723404255319,0.7021276595744681,No,0.7021276595744681
41096,41096,99.00,12,2,14,0.8571428571428571,0.14285714285714285,Yes,0.8571428571428571
41097,41097,99.00,7,1,8,0.875,0.125,Yes,0.875
41098,41098,99.00,63,52,115,0.5478260869565217,0.45217391304347826,Yes,0.5478260869565217
41099,41099,99.00,0,0,0,0,0,n/a,0
42001,42001,99.00,11,4,15,0.7333333333333333,0.26666666666666666,Yes,0.7333333333333333
42002,42002,99.00,8,2,10,0.8,0.2,Yes,0.8
42003,42003,99.00,216,37,253,0.8537549407114624,0.14624505928853754,Yes,0.8537549407114624
42004,42004,99.00,123,33,156,0.7884615384615384,0.21153846153846154,Yes,0.7884615384615384
42005,42005,99.00,4,1,5,0.8,0.2,Yes,0.8
42006,42006,99.00,234,63,297,0.7878787878787878,0.21212121212121213,Yes,0.7878787878787878
42007,42007,99.00,169,34,203,0.8325123152709359,0.16748768472906403,Yes,0.8325123152709359
42008,42008,99.00,122,21,143,0.8531468531468531,0.14685314685314685,Yes,0.8531468531468531
42009,42009,99.00,118,18,136,0.8676470588235294,0.1323529411764706,Yes,0.8676470588235294
42010,42010,99.00,122,33,155,0.7870967741935484,0.2129032258064516,Yes,0.7870967741935484
42011,42011,99.00,96,40,136,0.7058823529411765,0.29411764705882354,Yes,0.7058823529411765
42012,42012,99.00,80,21,101,0.7920792079207921,0.2079207920792079,Yes,0.7920792079207921
42013,42013,99.00,91,30,121,0.7520661157024794,0.24793388429752067,Yes,0.7520661157024794
42014,42014,99.00,87,20,107,0.8130841121495327,0.18691588785046728,Yes,0.8130841121495327
42015,42015,99.00,115,23,138,0.8333333333333334,0.16666666666666666,Yes,0.8333333333333334
42016,42016,99.00,162,42,204,0.7941176470588235,0.20588235294117646,Yes,0.7941176470588235
42017,42017,99.00,3,2,5,0.6,0.4,Yes,0.6
42018,42018,99.00,135,26,161,0.8385093167701864,0.16149068322981366,Yes,0.8385093167701864
42019,42019,99.00,10,1,11,0.9090909090909091,0.09090909090909091,Yes,0.9090909090909091
42020,42020,99.00,183,26,209,0.8755980861244019,0.12440191387559808,Yes,0.8755980861244019
42021,42021,99.00,135,29,164,0.823170731707317,0.17682926829268292,Yes,0.823170731707317
42022,42022,99.00,130,29,159,0.8176100628930818,0.18238993710691823,Yes,0.8176100628930818
42023,42023,99.00,2,3,5,0.4,0.6,No,0.6
42024,42024,0.00,3,0,3,1.0,0.0,Yes,1.0
42025,42025,0.00,36,0,36,1.0,0.0,Yes,1.0
42026,42026,99.00,13,2,15,0.8666666666666667,0.13333333333333333,Yes,0.8666666666666667
42027,42027,99.00,149,47,196,0.7602040816326531,0.23979591836734693,Yes,0.7602040816326531
42028,42028,99.00,190,29,219,0.867579908675799,0.1324200913242009,Yes,0.867579908675799
42029,42029,99.00,223,45,268,0.832089552238806,0.16791044776119404,Yes,0.832089552238806
42030,42030,99.00,301,47,348,0.8649425287356322,0.13505747126436782,Yes,0.8649425287356322
42031,42031,99.00,9,0,9,1.0,0.0,Yes,1.0
42032,42032,99.00,21,2,23,0.9130434782608695,0.08695652173913043,Yes,0.9130434782608695
42033,42033,99.00,12,1,13,0.9230769230769231,0.07692307692307693,Yes,0.9230769230769231
42034,42034,99.00,12,3,15,0.8,0.2,Yes,0.8
42035,42035,99.00,268,51,319,0.8401253918495298,0.15987460815047022,Yes,0.8401253918495298
42036,42036,99.00,136,105,241,0.5643153526970954,0.43568464730290457,Yes,0.5643153526970954
42037,42037,0.00,14,1,15,0.9333333333333333,0.06666666666666667,Yes,0.9333333333333333
42038,42038,99.00,0,4,4,0.0,1.0,No,1.0
42039,42039,99.00,5,0,5,1.0,0.0,Yes,1.0
42040,42040,99.00,113,15,128,0.8828125,0.1171875,Yes,0.8828125
42041,42041,99.00,117,25,142,0.823943661971831,0.176056338028169,Yes,0.823943661971831
42042,42042,99.00,104,22,126,0.8253968253968254,0.1746031746031746,Yes,0.8253968253968254
42043,42043,99.00,109,23,132,0.8257575757575758,0.17424242424242425,Yes,0.8257575757575758
42044,42044,99.00,5,2,7,0.7142857142857143,0.2857142857142857,Yes,0.7142857142857143
42045,42045,99.00,99,23,122,0.8114754098360656,0.1885245901639344,Yes,0.8114754098360656
42046,42046,99.00,123,20,143,0.8601398601398601,0.13986013986013987,Yes,0.8601398601398601
42047,42047,99.00,5,3,8,0.625,0.375,Yes,0.625
42048,42048,99.00,151,28,179,0.8435754189944135,0.1564245810055866,Yes,0.8435754189944135
42049,42049,99.00,231,67,298,0.7751677852348994,0.22483221476510068,Yes,0.7751677852348994
42050,42050,99.00,159,21,180,0.8833333333333333,0.11666666666666667,Yes,0.8833333333333333
42051,42051,99.00,74,186,260,0.2846153846153846,0.7153846153846154,No,0.7153846153846154
42052,42052,99.00,76,45,121,0.628099173553719,0.371900826446281,Yes,0.628099173553719
42053,42053,99.00,91,17,108,0.8425925925925926,0.1574074074074074,Yes,0.8425925925925926
42054,42054,99.00,135,33,168,0.8035714285714286,0.19642857142857142,Yes,0.8035714285714286
42055,42055,99.00,32,5,37,0.8648648648648649,0.13513513513513514,Yes,0.8648648648648649
42056,42056,99.00,111,24,135,0.8222222222222222,0.17777777777777778,Yes,0.8222222222222222
42057,42057,99.00,112,31,143,0.7832167832167832,0.21678321678321677,Yes,0.7832167832167832
42058,42058,99.00,173,42,215,0.8046511627906977,0.19534883720930232,Yes,0.8046511627906977
42059,42059,99.00,6,60,66,0.09090909090909091,0.9090909090909091,No,0.9090909090909091
42060,42060,99.00,10,20,30,0.3333333333333333,0.6666666666666666,No,0.6666666666666666
42061,42061,99.00,58,50,108,0.5370370370370371,0.46296296296296297,Yes,0.5370370370370371
42062,42062,99.00,71,111,182,0.3901098901098901,0.6098901098901099,No,0.6098901098901099
42063,42063,99.00,47,238,285,0.1649122807017544,0.8350877192982457,No,0.8350877192982457
42064,42064,99.00,51,166,217,0.2350230414746544,0.7649769585253456,No,0.7649769585253456
42065,42065,99.00,1,0,1,1.0,0.0,Yes,1.0
42066,42066,99.00,5,4,9,0.5555555555555556,0.4444444444444444,Yes,0.5555555555555556
42067,42067,99.00,51,98,149,0.3422818791946309,0.6577181208053692,No,0.6577181208053692
42068,42068,99.00,3,0,3,1.0,0.0,Yes,1.0
42069,42069,99.00,8,25,33,0.24242424242424243,0.7575757575757576,No,0.7575757575757576
42070,42070,99.00,99,16,115,0.8608695652173913,0.1391304347826087,Yes,0.8608695652173913
42071,42071,99.00,169,37,206,0.8203883495145631,0.1796116504854369,Yes,0.8203883495145631
42072,42072,99.00,124,40,164,0.7560975609756098,0.24390243902439024,Yes,0.7560975609756098
42073,42073,99.00,124,18,142,0.8732394366197183,0.1267605633802817,Yes,0.8732394366197183
42074,42074,99.00,83,16,99,0.8383838383838383,0.16161616161616163,Yes,0.8383838383838383
42075,42075,99.00,268,50,318,0.8427672955974843,0.15723270440251572,Yes,0.8427672955974843
42076,42076,99.00,5,1,6,0.8333333333333334,0.16666666666666666,Yes,0.8333333333333334
42077,42077,99.00,160,24,184,0.8695652173913043,0.13043478260869565,Yes,0.8695652173913043
42078,42078,99.00,29,3,32,0.90625,0.09375,Yes,0.90625
42079,42079,99.00,109,34,143,0.7622377622377622,0.23776223776223776,Yes,0.7622377622377622
42080,42080,99.00,104,23,127,0.8188976377952756,0.18110236220472442,Yes,0.8188976377952756
42081,42081,99.00,20,2,22,0.9090909090909091,0.09090909090909091,Yes,0.9090909090909091
42082,42082,99.00,4,1,5,0.8,0.2,Yes,0.8
43001,43001,99.00,186,34,220,0.8454545454545455,0.15454545454545454,Yes,0.8454545454545455
43002,43002,99.00,23,4,27,0.8518518518518519,0.14814814814814814,Yes,0.8518518518518519
43003,43003,99.00,145,25,170,0.8529411764705882,0.14705882352941177,Yes,0.8529411764705882
43004,43004,99.00,139,19,158,0.879746835443038,0.12025316455696203,Yes,0.879746835443038
43005,43005,99.00,12,0,12,1.0,0.0,Yes,1.0
43006,43006,99.00,274,48,322,0.8509316770186336,0.14906832298136646,Yes,0.8509316770186336
43007,43007,99.00,210,42,252,0.8333333333333334,0.16666666666666666,Yes,0.8333333333333334
43008,43008,99.00,4,0,4,1.0,0.0,Yes,1.0
43009,43009,99.00,160,29,189,0.8465608465608465,0.15343915343915343,Yes,0.8465608465608465
43010,43010,99.00,57,24,81,0.7037037037037037,0.2962962962962963,Yes,0.7037037037037037
43011,43011,99.00,103,52,155,0.6645161290322581,0.33548387096774196,Yes,0.6645161290322581
43012,43012,99.00,236,48,284,0.8309859154929577,0.16901408450704225,Yes,0.8309859154929577
43013,43013,99.00,72,54,126,0.5714285714285714,0.42857142857142855,Yes,0.5714285714285714
43014,43014,99.00,170,31,201,0.845771144278607,0.15422885572139303,Yes,0.845771144278607
43015,43015,99.00,202,44,246,0.8211382113821138,0.17886178861788618,Yes,0.8211382113821138
43016,43016,99.00,9,0,9,1.0,0.0,Yes,1.0
43017,43017,99.00,235,56,291,0.8075601374570447,0.19243986254295534,Yes,0.8075601374570447
43018,43018,99.00,288,56,344,0.8372093023255814,0.16279069767441862,Yes,0.8372093023255814
43019,43019,99.00,6,0,6,1.0,0.0,Yes,1.0
43020,43020,99.00,17,2,19,0.8947368421052632,0.10526315789473684,Yes,0.8947368421052632
43021,43021,99.00,163,40,203,0.8029556650246306,0.19704433497536947,Yes,0.8029556650246306
43022,43022,99.00,10,0,10,1.0,0.0,Yes,1.0
43023,43023,99.00,286,53,339,0.8436578171091446,0.15634218289085547,Yes,0.8436578171091446
43024,43024,99.00,291,44,335,0.8686567164179104,0.13134328358208955,Yes,0.8686567164179104
43025,43025,99.00,9,0,9,1.0,0.0,Yes,1.0
43026,43026,99.00,233,49,282,0.8262411347517731,0.17375886524822695,Yes,0.8262411347517731
43027,43027,99.00,139,36,175,0.7942857142857143,0.2057142857142857,Yes,0.7942857142857143
43028,43028,99.00,156,36,192,0.8125,0.1875,Yes,0.8125
43029,43029,75.00,49,9,58,0.8448275862068966,0.15517241379310345,Yes,0.8448275862068966
43030,43030,75.00,68,14,82,0.8292682926829268,0.17073170731707318,Yes,0.8292682926829268
43031,43031,75.00,108,19,127,0.8503937007874016,0.14960629921259844,Yes,0.8503937007874016
43032,43032,99.00,79,16,95,0.8315789473684211,0.16842105263157894,Yes,0.8315789473684211
43033,43033,75.00,93,32,125,0.744,0.256,Yes,0.744
43034,43034,99.00,5,0,5,1.0,0.0,Yes,1.0
43035,43035,99.00,194,52,246,0.7886178861788617,0.21138211382113822,Yes,0.7886178861788617
43036,43036,99.00,122,22,144,0.8472222222222222,0.1527777777777778,Yes,0.8472222222222222
43037,43037,99.00,157,21,178,0.8820224719101124,0.11797752808988764,Yes,0.8820224719101124
43038,43038,50.00,96,31,127,0.7559055118110236,0.2440944881889764,Yes,0.7559055118110236
43039,43039,50.00,118,25,143,0.8251748251748252,0.17482517482517482,Yes,0.8251748251748252
43040,43040,99.00,2,1,3,0.6666666666666666,0.3333333333333333,Yes,0.6666666666666666
43041,43041,99.00,134,21,155,0.864516129032258,0.13548387096774195,Yes,0.864516129032258
43042,43042,99.00,21,3,24,0.875,0.125,Yes,0.875
43043,43043,99.00,244,65,309,0.7896440129449838,0.21035598705501618,Yes,0.7896440129449838
43044,43044,99.00,250,42,292,0.8561643835616438,0.14383561643835616,Yes,0.8561643835616438
43045,43045,99.00,249,43,292,0.8527397260273972,0.14726027397260275,Yes,0.8527397260273972
43046,43046,99.00,166,18,184,0.9021739130434783,0.09782608695652174,Yes,0.9021739130434783
43047,43047,99.00,7,3,10,0.7,0.3,Yes,0.7
43048,43048,99.00,12,0,12,1.0,0.0,Yes,1.0
43049,43049,99.00,226,44,270,0.837037037037037,0.16296296296296298,Yes,0.837037037037037
43050,43050,99.00,174,45,219,0.7945205479452054,0.2054794520547945,Yes,0.7945205479452054
43051,43051,99.00,197,27,224,0.8794642857142857,0.12053571428571429,Yes,0.8794642857142857
43052,43052,99.00,218,67,285,0.7649122807017544,0.23508771929824562,Yes,0.7649122807017544
43053,43053,99.00,151,45,196,0.7704081632653061,0.22959183673469388,Yes,0.7704081632653061
43054,43054,99.00,146,33,179,0.8156424581005587,0.18435754189944134,Yes,0.8156424581005587
43055,43055,99.00,91,24,115,0.7913043478260869,0.20869565217391303,Yes,0.7913043478260869
43056,43056,99.00,6,0,6,1.0,0.0,Yes,1.0
43057,43057,99.00,31,36,67,0.4626865671641791,0.5373134328358209,No,0.5373134328358209
43058,43058,99.00,1,0,1,1.0,0.0,Yes,1.0
43059,43059,99.00,117,81,198,0.5909090909090909,0.4090909090909091,Yes,0.5909090909090909
43060,43060,99.00,2,0,2,1.0,0.0,Yes,1.0
43061,43061,99.00,68,20,88,0.7727272727272727,0.22727272727272727,Yes,0.7727272727272727
43062,43062,99.00,51,26,77,0.6623376623376623,0.33766233766233766,Yes,0.6623376623376623
43063,43063,99.00,82,35,117,0.7008547008547008,0.29914529914529914,Yes,0.7008547008547008
43064,43064,99.00,131,64,195,0.6717948717948717,0.3282051282051282,Yes,0.6717948717948717
43065,43065,99.00,10,0,10,1.0,0.0,Yes,1.0
43066,43066,99.00,138,21,159,0.8679245283018868,0.1320754716981132,Yes,0.8679245283018868
43067,43067,99.00,204,65,269,0.758364312267658,0.241635687732342,Yes,0.758364312267658
43068,43068,99.00,3,0,3,1.0,0.0,Yes,1.0
43069,43069,99.00,81,13,94,0.8617021276595744,0.13829787234042554,Yes,0.8617021276595744
43070,43070,99.00,2,0,2,1.0,0.0,Yes,1.0
43071,43071,99.00,2,3,5,0.4,0.6,No,0.6
43072,43072,99.00,2,2,4,0.5,0.5,Tie,0.5
43073,43073,99.00,335,56,391,0.8567774936061381,0.1432225063938619,Yes,0.8567774936061381
43074,43074,99.00,115,28,143,0.8041958041958042,0.1958041958041958,Yes,0.8041958041958042
43075,43075,99.00,215,49,264,0.8143939393939394,0.1856060606060606,Yes,0.8143939393939394
43076,43076,99.00,72,28,100,0.72,0.28,Yes,0.72
43077,43077,99.00,1,0,1,1.0,0.0,Yes,1.0
43078,43078,99.00,162,29,191,0.8481675392670157,0.1518324607329843,Yes,0.8481675392670157
43079,43079,99.00,0,0,0,0,0,n/a,0
43080,43080,99.00,217,31,248,0.875,0.125,Yes,0.875
43081,43081,99.00,14,1,15,0.9333333333333333,0.06666666666666667,Yes,0.9333333333333333
43082,43082,99.00,25,3,28,0.8928571428571429,0.10714285714285714,Yes,0.8928571428571429
43083,43083,99.00,1,1,2,0.5,0.5,Tie,0.5
43084,43084,99.00,3,0,3,1.0,0.0,Yes,1.0
43085,43085,99.00,96,79,175,0.5485714285714286,0.4514285714285714,Yes,0.5485714285714286
43086,43086,99.00,7,1,8,0.875,0.125,Yes,0.875
43087,43087,99.00,172,26,198,0.8686868686868687,0.13131313131313133,Yes,0.8686868686868687
44001,44001,99.00,66,68,134,0.4925373134328358,0.5074626865671642,No,0.5074626865671642
44002,44002,99.00,5,49,54,0.09259259259259259,0.9074074074074074,No,0.9074074074074074
44003,44003,99.00,16,90,106,0.1509433962264151,0.8490566037735849,No,0.8490566037735849
44004,44004,99.00,51,70,121,0.4214876033057851,0.5785123966942148,No,0.5785123966942148
44005,44005,99.00,11,1,12,0.9166666666666666,0.08333333333333333,Yes,0.9166666666666666
44006,44006,99.00,195,104,299,0.6521739130434783,0.34782608695652173,Yes,0.6521739130434783
44007,44007,99.00,5,0,5,1.0,0.0,Yes,1.0
44008,44008,99.00,4,0,4,1.0,0.0,Yes,1.0
44009,44009,99.00,150,26,176,0.8522727272727273,0.14772727272727273,Yes,0.8522727272727273
44010,44010,99.00,90,30,120,0.75,0.25,Yes,0.75
44011,44011,99.00,0,0,0,0,0,n/a,0
44012,44012,99.00,7,1,8,0.875,0.125,Yes,0.875
44013,44013,99.00,23,66,89,0.25842696629213485,0.7415730337078652,No,0.7415730337078652
44014,44014,99.00,211,58,269,0.7843866171003717,0.21561338289962825,Yes,0.7843866171003717
44015,44015,99.00,230,58,288,0.7986111111111112,0.2013888888888889,Yes,0.7986111111111112
44016,44016,99.00,6,0,6,1.0,0.0,Yes,1.0
44017,44017,99.00,4,3,7,0.5714285714285714,0.42857142857142855,Yes,0.5714285714285714
44018,44018,99.00,332,79,411,0.8077858880778589,0.1922141119221411,Yes,0.8077858880778589
44019,44019,99.00,81,76,157,0.5159235668789809,0.4840764331210191,Yes,0.5159235668789809
44020,44020,99.00,211,55,266,0.793233082706767,0.20676691729323307,Yes,0.793233082706767
44021,44021,99.00,0,0,0,0,0,n/a,0
44022,44022,99.00,0,0,0,0,0,n/a,0
44023,44023,99.00,42,56,98,0.42857142857142855,0.5714285714285714,No,0.5714285714285714
44024,44024,99.00,32,43,75,0.4266666666666667,0.5733333333333334,No,0.5733333333333334
44025,44025,99.00,99,139,238,0.41596638655462187,0.5840336134453782,No,0.5840336134453782
44026,44026,99.00,80,65,145,0.5517241379310345,0.4482758620689655,Yes,0.5517241379310345
44027,44027,99.00,72,94,166,0.43373493975903615,0.5662650602409639,No,0.5662650602409639
44028,44028,0.00,6,2,8,0.75,0.25,Yes,0.75
44029,44029,99.00,146,73,219,0.6666666666666666,0.3333333333333333,Yes,0.6666666666666666
44030,44030,99.00,1,1,2,0.5,0.5,Tie,0.5
44031,44031,0.00,17,4,21,0.8095238095238095,0.19047619047619047,Yes,0.8095238095238095
44032,44032,99.00,28,11,39,0.717948717948718,0.28205128205128205,Yes,0.717948717948718
44033,44033,0.00,14,0,14,1.0,0.0,Yes,1.0
44034,44034,0.00,4,0,4,1.0,0.0,Yes,1.0
44035,44035,99.00,247,55,302,0.8178807947019867,0.18211920529801323,Yes,0.8178807947019867
44036,44036,99.00,283,44,327,0.8654434250764526,0.1345565749235474,Yes,0.8654434250764526
44037,44037,99.00,8,0,8,1.0,0.0,Yes,1.0
44038,44038,99.00,204,34,238,0.8571428571428571,0.14285714285714285,Yes,0.8571428571428571
44039,44039,99.00,168,57,225,0.7466666666666667,0.25333333333333335,Yes,0.7466666666666667
44040,44040,99.00,0,0,0,0,0,n/a,0
44041,44041,99.00,0,1,1,0.0,1.0,No,1.0
44042,44042,99.00,148,45,193,0.7668393782383419,0.23316062176165803,Yes,0.7668393782383419
44043,44043,99.00,155,97,252,0.6150793650793651,0.38492063492063494,Yes,0.6150793650793651
44044,44044,99.00,3,1,4,0.75,0.25,Yes,0.75
44045,44045,99.00,132,18,150,0.88,0.12,Yes,0.88
44046,44046,99.00,3,0,3,1.0,0.0,Yes,1.0
44047,44047,99.00,2,0,2,1.0,0.0,Yes,1.0
44048,44048,99.00,246,50,296,0.831081081081081,0.16891891891891891,Yes,0.831081081081081
44049,44049,99.00,291,58,349,0.833810888252149,0.166189111747851,Yes,0.833810888252149
44050,44050,99.00,218,39,257,0.8482490272373541,0.1517509727626459,Yes,0.8482490272373541
44051,44051,99.00,356,83,439,0.8109339407744874,0.18906605922551253,Yes,0.8109339407744874
44052,44052,99.00,318,70,388,0.8195876288659794,0.18041237113402062,Yes,0.8195876288659794
44053,44053,99.00,328,108,436,0.7522935779816514,0.24770642201834864,Yes,0.7522935779816514
44054,44054,99.00,214,50,264,0.8106060606060606,0.1893939393939394,Yes,0.8106060606060606
44055,44055,99.00,77,8,85,0.9058823529411765,0.09411764705882353,Yes,0.9058823529411765
44056,44056,99.00,30,3,33,0.9090909090909091,0.09090909090909091,Yes,0.9090909090909091
44057,44057,99.00,464,123,587,0.7904599659284497,0.20954003407155025,Yes,0.7904599659284497
44058,44058,99.00,392,92,484,0.8099173553719008,0.19008264462809918,Yes,0.8099173553719008
44059,44059,99.00,259,52,311,0.8327974276527331,0.16720257234726688,Yes,0.8327974276527331
44060,44060,99.00,263,56,319,0.8244514106583072,0.1755485893416928,Yes,0.8244514106583072
44061,44061,99.00,34,8,42,0.8095238095238095,0.19047619047619047,Yes,0.8095238095238095
44062,44062,99.00,24,6,30,0.8,0.2,Yes,0.8
44063,44063,36.36,181,31,212,0.8537735849056604,0.14622641509433962,Yes,0.8537735849056604
44064,44064,99.00,116,24,140,0.8285714285714286,0.17142857142857143,Yes,0.8285714285714286
44065,44065,99.00,347,64,411,0.8442822384428224,0.15571776155717762,Yes,0.8442822384428224
44066,44066,99.00,31,6,37,0.8378378378378378,0.16216216216216217,Yes,0.8378378378378378
44067,44067,99.00,0,2,2,0.0,1.0,No,1.0
44068,44068,36.36,341,83,424,0.8042452830188679,0.1957547169811321,Yes,0.8042452830188679
44069,44069,36.36,56,3,59,0.9491525423728814,0.05084745762711865,Yes,0.9491525423728814
44070,44070,36.36,63,9,72,0.875,0.125,Yes,0.875
44071,44071,99.00,67,7,74,0.9054054054054054,0.0945945945945946,Yes,0.9054054054054054
44072,44072,36.36,346,62,408,0.8480392156862745,0.15196078431372548,Yes,0.8480392156862745
44073,44073,99.00,245,44,289,0.8477508650519031,0.1522491349480969,Yes,0.8477508650519031
44074,44074,99.00,33,4,37,0.8918918918918919,0.10810810810810811,Yes,0.8918918918918919
44075,44075,99.00,376,64,440,0.8545454545454545,0.14545454545454545,Yes,0.8545454545454545
44076,44076,36.36,276,49,325,0.8492307692307692,0.15076923076923077,Yes,0.8492307692307692
44077,44077,99.00,481,71,552,0.8713768115942029,0.1286231884057971,Yes,0.8713768115942029
44078,44078,99.00,406,78,484,0.8388429752066116,0.16115702479338842,Yes,0.8388429752066116
44079,44079,99.00,388,73,461,0.841648590021692,0.15835140997830802,Yes,0.841648590021692
44080,44080,99.00,24,9,33,0.7272727272727273,0.2727272727272727,Yes,0.7272727272727273
44081,44081,99.00,140,65,205,0.6829268292682927,0.3170731707317073,Yes,0.6829268292682927
44082,44082,99.00,13,1,14,0.9285714285714286,0.07142857142857142,Yes,0.9285714285714286
44083,44083,99.00,227,54,281,0.8078291814946619,0.19217081850533807,Yes,0.8078291814946619
44084,44084,99.00,28,5,33,0.8484848484848485,0.15151515151515152,Yes,0.8484848484848485
44085,44085,99.00,0,0,0,0,0,n/a,0
44086,44086,99.00,14,0,14,1.0,0.0,Yes,1.0
44087,44087,0.00,5,0,5,1.0,0.0,Yes,1.0
44088,44088,99.00,6,1,7,0.8571428571428571,0.14285714285714285,Yes,0.8571428571428571
44089,44089,99.00,5,1,6,0.8333333333333334,0.16666666666666666,Yes,0.8333333333333334
44090,44090,99.00,2,1,3,0.6666666666666666,0.3333333333333333,Yes,0.6666666666666666
44091,44091,99.00,0,0,0,0,0,n/a,0
44092,44092,99.00,0,0,0,0,0,n/a,0
44093,44093,0.00,0,0,0,0,0,n/a,0
45001,45001,99.00,48,121,169,0.28402366863905326,0.7159763313609467,No,0.7159763313609467
45002,45002,99.00,57,119,176,0.32386363636363635,0.6761363636363636,No,0.6761363636363636
45003,45003,99.00,47,103,150,0.31333333333333335,0.6866666666666666,No,0.6866666666666666
45004,45004,75.00,61,57,118,0.5169491525423728,0.4830508474576271,Yes,0.5169491525423728
45005,45005,99.00,45,92,137,0.3284671532846715,0.6715328467153284,No,0.6715328467153284
45006,45006,75.00,28,114,142,0.19718309859154928,0.8028169014084507,No,0.8028169014084507
45007,45007,99.00,0,0,0,0,0,n/a,0
45008,45008,99.00,34,54,88,0.38636363636363635,0.6136363636363636,No,0.6136363636363636
45009,45009,75.00,27,122,149,0.18120805369127516,0.8187919463087249,No,0.8187919463087249
45010,45010,75.00,2,0,2,1.0,0.0,Yes,1.0
45011,45011,75.00,49,47,96,0.5104166666666666,0.4895833333333333,Yes,0.5104166666666666
45012,45012,99.00,9,5,14,0.6428571428571429,0.35714285714285715,Yes,0.6428571428571429
45013,45013,99.00,83,111,194,0.42783505154639173,0.5721649484536082,No,0.5721649484536082
45014,45014,99.00,76,85,161,0.4720496894409938,0.5279503105590062,No,0.5279503105590062
45015,45015,99.00,0,0,0,0,0,n/a,0
45016,45016,99.00,22,105,127,0.1732283464566929,0.8267716535433071,No,0.8267716535433071
45017,45017,99.00,20,46,66,0.30303030303030304,0.696969696969697,No,0.696969696969697
45018,45018,99.00,0,0,0,0,0,n/a,0
45019,45019,99.00,39,99,138,0.2826086956521739,0.717391304347826,No,0.717391304347826
45020,45020,99.00,1,0,1,1.0,0.0,Yes,1.0
45021,45021,99.00,10,35,45,0.2222222222222222,0.7777777777777778,No,0.7777777777777778
45022,45022,99.00,28,68,96,0.2916666666666667,0.7083333333333334,No,0.7083333333333334
45023,45023,99.00,3,0,3,1.0,0.0,Yes,1.0
45024,45024,99.00,4,0,4,1.0,0.0,Yes,1.0
45025,45025,99.00,0,0,0,0,0,n/a,0
45026,45026,99.00,45,29,74,0.6081081081081081,0.3918918918918919,Yes,0.6081081081081081
45027,45027,99.00,51,27,78,0.6538461538461539,0.34615384615384615,Yes,0.6538461538461539
45028,45028,66.67,2,2,4,0.5,0.5,Tie,0.5
45029,45029,99.00,22,23,45,0.4888888888888889,0.5111111111111111,No,0.5111111111111111
45030,45030,66.67,74,36,110,0.6727272727272727,0.32727272727272727,Yes,0.6727272727272727
45031,45031,99.00,61,53,114,0.5350877192982456,0.4649122807017544,Yes,0.5350877192982456
45032,45032,99.00,1,1,2,0.5,0.5,Tie,0.5
45033,45033,99.00,81,68,149,0.5436241610738255,0.4563758389261745,Yes,0.5436241610738255
45034,45034,99.00,4,0,4,1.0,0.0,Yes,1.0
45035,45035,99.00,53,90,143,0.3706293706293706,0.6293706293706294,No,0.6293706293706294
45036,45036,99.00,0,0,0,0,0,n/a,0
45037,45037,99.00,57,45,102,0.5588235294117647,0.4411764705882353,Yes,0.5588235294117647
45038,45038,66.67,45,34,79,0.569620253164557,0.43037974683544306,Yes,0.569620253164557
45039,45039,66.67,1,0,1,1.0,0.0,Yes,1.0
45040,45040,99.00,94,78,172,0.5465116279069767,0.45348837209302323,Yes,0.5465116279069767
45041,45041,99.00,0,2,2,0.0,1.0,No,1.0
45042,45042,99.00,0,0,0,0,0,n/a,0
45043,45043,99.00,78,56,134,0.582089552238806,0.417910447761194,Yes,0.582089552238806
45044,45044,99.00,87,32,119,0.7310924369747899,0.2689075630252101,Yes,0.7310924369747899
45045,45045,99.00,0,0,0,0,0,n/a,0
45046,45046,99.00,42,24,66,0.6363636363636364,0.36363636363636365,Yes,0.6363636363636364
45047,45047,99.00,14,2,16,0.875,0.125,Yes,0.875
45048,45048,99.00,48,65,113,0.4247787610619469,0.5752212389380531,No,0.5752212389380531
45049,45049,99.00,0,0,0,0,0,n/a,0
45050,45050,99.00,53,34,87,0.6091954022988506,0.39080459770114945,Yes,0.6091954022988506
45051,45051,99.00,49,31,80,0.6125,0.3875,Yes,0.6125
45052,45052,99.00,1,0,1,1.0,0.0,Yes,1.0
45053,45053,99.00,77,60,137,0.5620437956204379,0.43795620437956206,Yes,0.5620437956204379
45054,45054,99.00,2,2,4,0.5,0.5,Tie,0.5
45055,45055,99.00,0,0,0,0,0,n/a,0
45056,45056,66.67,2,1,3,0.6666666666666666,0.3333333333333333,Yes,0.6666666666666666
45057,45057,99.00,61,28,89,0.6853932584269663,0.3146067415730337,Yes,0.6853932584269663
45058,45058,99.00,2,0,2,1.0,0.0,Yes,1.0
45059,45059,99.00,95,49,144,0.6597222222222222,0.3402777777777778,Yes,0.6597222222222222
45060,45060,99.00,39,31,70,0.5571428571428572,0.44285714285714284,Yes,0.5571428571428572
45061,45061,99.00,0,0,0,0,0,n/a,0
45062,45062,99.00,33,16,49,0.673469387755102,0.32653061224489793,Yes,0.673469387755102
45063,45063,99.00,0,0,0,0,0,n/a,0
45064,45064,99.00,31,20,51,0.6078431372549019,0.39215686274509803,Yes,0.6078431372549019
45065,45065,99.00,2,1,3,0.6666666666666666,0.3333333333333333,Yes,0.6666666666666666
45066,45066,0.00,1,0,1,1.0,0.0,Yes,1.0
45067,45067,99.00,0,0,0,0,0,n/a,0
45068,45068,99.00,53,59,112,0.4732142857142857,0.5267857142857143,No,0.5267857142857143
45069,45069,99.00,89,99,188,0.4734042553191489,0.526595744680851,No,0.526595744680851
45070,45070,99.00,2,0,2,1.0,0.0,Yes,1.0
45071,45071,99.00,3,1,4,0.75,0.25,Yes,0.75
45072,45072,99.00,0,0,0,0,0,n/a,0
45073,45073,99.00,44,33,77,0.5714285714285714,0.42857142857142855,Yes,0.5714285714285714
45074,45074,99.00,55,59,114,0.4824561403508772,0.5175438596491229,No,0.5175438596491229
45075,45075,99.00,57,44,101,0.5643564356435643,0.43564356435643564,Yes,0.5643564356435643
45076,45076,99.00,2,0,2,1.0,0.0,Yes,1.0
45077,45077,99.00,0,0,0,0,0,n/a,0
45078,45078,99.00,79,68,147,0.5374149659863946,0.46258503401360546,Yes,0.5374149659863946
45079,45079,99.00,0,0,0,0,0,n/a,0
45080,45080,99.00,0,0,0,0,0,n/a,0
46001,46001,99.00,4,4,8,0.5,0.5,Tie,0.5
46002,46002,99.00,3,2,5,0.6,0.4,Yes,0.6
46003,46003,99.00,72,53,125,0.576,0.424,Yes,0.576
46004,46004,99.00,112,61,173,0.6473988439306358,0.35260115606936415,Yes,0.6473988439306358
46005,46005,99.00,58,16,74,0.7837837837837838,0.21621621621621623,Yes,0.7837837837837838
46006,46006,99.00,1,2,3,0.3333333333333333,0.6666666666666666,No,0.6666666666666666
46007,46007,99.00,4,3,7,0.5714285714285714,0.42857142857142855,Yes,0.5714285714285714
46008,46008,99.00,117,43,160,0.73125,0.26875,Yes,0.73125
46009,46009,99.00,9,1,10,0.9,0.1,Yes,0.9
46010,46010,99.00,105,18,123,0.8536585365853658,0.14634146341463414,Yes,0.8536585365853658
46011,46011,99.00,23,4,27,0.8518518518518519,0.14814814814814814,Yes,0.8518518518518519
46012,46012,99.00,95,25,120,0.7916666666666666,0.20833333333333334,Yes,0.7916666666666666
46013,46013,99.00,3,2,5,0.6,0.4,Yes,0.6
46014,46014,99.00,94,31,125,0.752,0.248,Yes,0.752
46015,46015,99.00,0,1,1,0.0,1.0,No,1.0
46016,46016,99.00,71,44,115,0.6173913043478261,0.3826086956521739,Yes,0.6173913043478261
46017,46017,99.00,51,44,95,0.5368421052631579,0.4631578947368421,Yes,0.5368421052631579
46018,46018,99.00,0,0,0,0,0,n/a,0
46019,46019,99.00,58,39,97,0.5979381443298969,0.4020618556701031,Yes,0.5979381443298969
46020,46020,99.00,61,30,91,0.6703296703296703,0.32967032967032966,Yes,0.6703296703296703
46021,46021,99.00,0,0,0,0,0,n/a,0
46022,46022,99.00,45,32,77,0.5844155844155844,0.4155844155844156,Yes,0.5844155844155844
46023,46023,99.00,51,19,70,0.7285714285714285,0.2714285714285714,Yes,0.7285714285714285
46024,46024,99.00,48,25,73,0.6575342465753424,0.3424657534246575,Yes,0.6575342465753424
46025,46025,99.00,0,1,1,0.0,1.0,No,1.0
46026,46026,50.00,13,9,22,0.5909090909090909,0.4090909090909091,Yes,0.5909090909090909
46027,46027,99.00,63,29,92,0.6847826086956522,0.31521739130434784,Yes,0.6847826086956522
46028,46028,99.00,0,0,0,0,0,n/a,0
46029,46029,99.00,47,25,72,0.6527777777777778,0.3472222222222222,Yes,0.6527777777777778
46030,46030,99.00,83,46,129,0.6434108527131783,0.35658914728682173,Yes,0.6434108527131783
46031,46031,99.00,134,69,203,0.6600985221674877,0.3399014778325123,Yes,0.6600985221674877
46032,46032,99.00,4,5,9,0.4444444444444444,0.5555555555555556,No,0.5555555555555556
46033,46033,99.00,91,28,119,0.7647058823529411,0.23529411764705882,Yes,0.7647058823529411
46034,46034,99.00,4,2,6,0.6666666666666666,0.3333333333333333,Yes,0.6666666666666666
46035,46035,99.00,0,0,0,0,0,n/a,0
46036,46036,99.00,6,1,7,0.8571428571428571,0.14285714285714285,Yes,0.8571428571428571
46037,46037,99.00,0,1,1,0.0,1.0,No,1.0
46038,46038,99.00,56,34,90,0.6222222222222222,0.37777777777777777,Yes,0.6222222222222222
46039,46039,99.00,2,0,2,1.0,0.0,Yes,1.0
46040,46040,99.00,20,13,33,0.6060606060606061,0.3939393939393939,Yes,0.6060606060606061
46041,46041,99.00,129,90,219,0.589041095890411,0.410958904109589,Yes,0.589041095890411
46042,46042,99.00,83,131,214,0.3878504672897196,0.6121495327102804,No,0.6121495327102804
46043,46043,99.00,23,17,40,0.575,0.425,Yes,0.575
46044,46044,99.00,29,14,43,0.6744186046511628,0.32558139534883723,Yes,0.6744186046511628
46045,46045,99.00,37,15,52,0.7115384615384616,0.28846153846153844,Yes,0.7115384615384616
46046,46046,99.00,31,7,38,0.8157894736842105,0.18421052631578946,Yes,0.8157894736842105
46047,46047,99.00,68,80,148,0.4594594594594595,0.5405405405405406,No,0.5405405405405406
46048,46048,99.00,70,47,117,0.5982905982905983,0.4017094017094017,Yes,0.5982905982905983
46049,46049,99.00,165,93,258,0.6395348837209303,0.36046511627906974,Yes,0.6395348837209303
46050,46050,99.00,106,75,181,0.585635359116022,0.4143646408839779,Yes,0.585635359116022
46051,46051,33.33,105,91,196,0.5357142857142857,0.4642857142857143,Yes,0.5357142857142857
46052,46052,99.00,6,1,7,0.8571428571428571,0.14285714285714285,Yes,0.8571428571428571
46053,46053,99.00,103,68,171,0.6023391812865497,0.39766081871345027,Yes,0.6023391812865497
46054,46054,99.00,102,45,147,0.6938775510204082,0.30612244897959184,Yes,0.6938775510204082
46055,46055,99.00,70,54,124,0.5645161290322581,0.43548387096774194,Yes,0.5645161290322581
46056,46056,99.00,105,43,148,0.7094594594594594,0.2905405405405405,Yes,0.7094594594594594
46057,46057,99.00,4,5,9,0.4444444444444444,0.5555555555555556,No,0.5555555555555556
46058,46058,99.00,106,72,178,0.5955056179775281,0.4044943820224719,Yes,0.5955056179775281
46059,46059,99.00,98,64,162,0.6049382716049383,0.3950617283950617,Yes,0.6049382716049383
46060,46060,99.00,193,152,345,0.5594202898550724,0.4405797101449275,Yes,0.5594202898550724
46061,46061,99.00,14,6,20,0.7,0.3,Yes,0.7
46062,46062,99.00,178,108,286,0.6223776223776224,0.3776223776223776,Yes,0.6223776223776224
46063,46063,99.00,121,80,201,0.6019900497512438,0.39800995024875624,Yes,0.6019900497512438
46064,46064,99.00,124,91,215,0.5767441860465117,0.4232558139534884,Yes,0.5767441860465117
46065,46065,99.00,123,87,210,0.5857142857142857,0.4142857142857143,Yes,0.5857142857142857
46066,46066,99.00,71,68,139,0.5107913669064749,0.4892086330935252,Yes,0.5107913669064749
46067,46067,99.00,80,114,194,0.41237113402061853,0.5876288659793815,No,0.5876288659793815
46068,46068,99.00,75,99,174,0.43103448275862066,0.5689655172413793,No,0.5689655172413793
46069,46069,99.00,51,87,138,0.3695652173913043,0.6304347826086957,No,0.6304347826086957
46070,46070,99.00,3,0,3,1.0,0.0,Yes,1.0
46071,46071,99.00,67,66,133,0.5037593984962406,0.49624060150375937,Yes,0.5037593984962406
46072,46072,99.00,90,72,162,0.5555555555555556,0.4444444444444444,Yes,0.5555555555555556
46073,46073,99.00,80,57,137,0.583941605839416,0.41605839416058393,Yes,0.583941605839416
46074,46074,99.00,0,2,2,0.0,1.0,No,1.0
46075,46075,99.00,166,128,294,0.564625850340136,0.43537414965986393,Yes,0.564625850340136
46076,46076,99.00,4,2,6,0.6666666666666666,0.3333333333333333,Yes,0.6666666666666666
46077,46077,99.00,29,26,55,0.5272727272727272,0.4727272727272727,Yes,0.5272727272727272
46078,46078,99.00,184,160,344,0.5348837209302325,0.46511627906976744,Yes,0.5348837209302325
46079,46079,99.00,98,147,245,0.4,0.6,No,0.6
46080,46080,99.00,90,21,111,0.8108108108108109,0.1891891891891892,Yes,0.8108108108108109
46081,46081,99.00,1,0,1,1.0,0.0,Yes,1.0
46082,46082,99.00,0,0,0,0,0,n/a,0
46083,46083,99.00,0,0,0,0,0,n/a,0
46084,46084,99.00,0,0,0,0,0,n/a,0
47001,47001,99.00,70,99,169,0.41420118343195267,0.5857988165680473,No,0.5857988165680473
47002,47002,99.00,4,4,8,0.5,0.5,Tie,0.5
47003,47003,99.00,34,29,63,0.5396825396825397,0.4603174603174603,Yes,0.5396825396825397
47004,47004,44.44,1,0,1,1.0,0.0,Yes,1.0
47005,47005,99.00,6,0,6,1.0,0.0,Yes,1.0
47006,47006,99.00,97,93,190,0.5105263157894737,0.48947368421052634,Yes,0.5105263157894737
47007,47007,99.00,8,3,11,0.7272727272727273,0.2727272727272727,Yes,0.7272727272727273
47008,47008,99.00,97,82,179,0.5418994413407822,0.4581005586592179,Yes,0.5418994413407822
47009,47009,99.00,109,88,197,0.5532994923857868,0.4467005076142132,Yes,0.5532994923857868
47010,47010,99.00,6,12,18,0.3333333333333333,0.6666666666666666,No,0.6666666666666666
47011,47011,99.00,1,1,2,0.5,0.5,Tie,0.5
47012,47012,99.00,64,47,111,0.5765765765765766,0.42342342342342343,Yes,0.5765765765765766
47013,47013,99.00,113,60,173,0.653179190751445,0.3468208092485549,Yes,0.653179190751445
47014,47014,99.00,46,48,94,0.48936170212765956,0.5106382978723404,No,0.5106382978723404
47015,47015,99.00,48,14,62,0.7741935483870968,0.22580645161290322,Yes,0.7741935483870968
47016,47016,99.00,2,1,3,0.6666666666666666,0.3333333333333333,Yes,0.6666666666666666
47017,47017,99.00,51,42,93,0.5483870967741935,0.45161290322580644,Yes,0.5483870967741935
47018,47018,99.00,29,38,67,0.43283582089552236,0.5671641791044776,No,0.5671641791044776
47019,47019,99.00,0,1,1,0.0,1.0,No,1.0
47020,47020,99.00,54,45,99,0.5454545454545454,0.45454545454545453,Yes,0.5454545454545454
47021,47021,99.00,0,6,6,0.0,1.0,No,1.0
47022,47022,99.00,3,5,8,0.375,0.625,No,0.625
47023,47023,99.00,93,39,132,0.7045454545454546,0.29545454545454547,Yes,0.7045454545454546
47024,47024,99.00,81,46,127,0.6377952755905512,0.36220472440944884,Yes,0.6377952755905512
47025,47025,99.00,68,66,134,0.5074626865671642,0.4925373134328358,Yes,0.5074626865671642
47026,47026,99.00,44,42,86,0.5116279069767442,0.4883720930232558,Yes,0.5116279069767442
47027,47027,99.00,69,45,114,0.6052631578947368,0.39473684210526316,Yes,0.6052631578947368
47028,47028,99.00,97,53,150,0.6466666666666666,0.35333333333333333,Yes,0.6466666666666666
47029,47029,99.00,74,47,121,0.6115702479338843,0.3884297520661157,Yes,0.6115702479338843
47030,47030,99.00,7,4,11,0.6363636363636364,0.36363636363636365,Yes,0.6363636363636364
47031,47031,99.00,75,41,116,0.646551724137931,0.35344827586206895,Yes,0.646551724137931
47032,47032,99.00,2,1,3,0.6666666666666666,0.3333333333333333,Yes,0.6666666666666666
47033,47033,99.00,1,0,1,1.0,0.0,Yes,1.0
47034,47034,99.00,0,0,0,0,0,n/a,0
47035,47035,99.00,0,0,0,0,0,n/a,0
47036,47036,99.00,1,1,2,0.5,0.5,Tie,0.5
47037,47037,99.00,67,41,108,0.6203703703703703,0.37962962962962965,Yes,0.6203703703703703
47038,47038,99.00,4,1,5,0.8,0.2,Yes,0.8
47039,47039,99.00,2,0,2,1.0,0.0,Yes,1.0
47040,47040,99.00,49,44,93,0.5268817204301075,0.4731182795698925,Yes,0.5268817204301075
47041,47041,99.00,1,1,2,0.5,0.5,Tie,0.5
47042,47042,99.00,3,0,3,1.0,0.0,Yes,1.0
47043,47043,99.00,94,64,158,0.5949367088607594,0.4050632911392405,Yes,0.5949367088607594
47044,47044,99.00,82,54,136,0.6029411764705882,0.39705882352941174,Yes,0.6029411764705882
47045,47045,99.00,56,32,88,0.6363636363636364,0.36363636363636365,Yes,0.6363636363636364
47046,47046,99.00,40,43,83,0.4819277108433735,0.5180722891566265,No,0.5180722891566265
47047,47047,99.00,58,50,108,0.5370370370370371,0.46296296296296297,Yes,0.5370370370370371
47048,47048,99.00,71,47,118,0.6016949152542372,0.3983050847457627,Yes,0.6016949152542372
47049,47049,99.00,5,3,8,0.625,0.375,Yes,0.625
47050,47050,99.00,76,63,139,0.5467625899280576,0.45323741007194246,Yes,0.5467625899280576
47051,47051,99.00,73,80,153,0.477124183006536,0.5228758169934641,No,0.5228758169934641
47052,47052,99.00,2,3,5,0.4,0.6,No,0.6
47053,47053,99.00,65,30,95,0.6842105263157895,0.3157894736842105,Yes,0.6842105263157895
47054,47054,99.00,2,0,2,1.0,0.0,Yes,1.0
47055,47055,99.00,86,54,140,0.6142857142857143,0.38571428571428573,Yes,0.6142857142857143
47056,47056,99.00,0,0,0,0,0,n/a,0
47057,47057,99.00,77,52,129,0.5968992248062015,0.40310077519379844,Yes,0.5968992248062015
47058,47058,99.00,46,31,77,0.5974025974025974,0.4025974025974026,Yes,0.5974025974025974
47059,47059,99.00,44,21,65,0.676923076923077,0.3230769230769231,Yes,0.676923076923077
47060,47060,99.00,0,0,0,0,0,n/a,0
47061,47061,99.00,34,20,54,0.6296296296296297,0.37037037037037035,Yes,0.6296296296296297
47062,47062,99.00,61,38,99,0.6161616161616161,0.3838383838383838,Yes,0.6161616161616161
47063,47063,99.00,33,15,48,0.6875,0.3125,Yes,0.6875
47064,47064,99.00,74,53,127,0.5826771653543307,0.41732283464566927,Yes,0.5826771653543307
47065,47065,99.00,5,3,8,0.625,0.375,Yes,0.625
47066,47066,99.00,1,0,1,1.0,0.0,Yes,1.0
47067,47067,99.00,0,0,0,0,0,n/a,0
47068,47068,99.00,0,1,1,0.0,1.0,No,1.0
47069,47069,99.00,8,0,8,1.0,0.0,Yes,1.0
47070,47070,99.00,45,40,85,0.5294117647058824,0.47058823529411764,Yes,0.5294117647058824
47071,47071,99.00,8,2,10,0.8,0.2,Yes,0.8
47072,47072,44.44,40,24,64,0.625,0.375,Yes,0.625
47073,47073,99.00,0,0,0,0,0,n/a,0
47074,47074,99.00,0,0,0,0,0,n/a,0
48001,48001,99.00,0,0,0,0,0,n/a,0
48002,48002,99.00,0,2,2,0.0,1.0,No,1.0
48003,48003,99.00,19,52,71,0.2676056338028169,0.7323943661971831,No,0.7323943661971831
48004,48004,99.00,35,124,159,0.22012578616352202,0.779874213836478,No,0.779874213836478
48005,48005,99.00,17,54,71,0.23943661971830985,0.7605633802816901,No,0.7605633802816901
48006,48006,99.00,2,2,4,0.5,0.5,Tie,0.5
48007,48007,99.00,12,72,84,0.14285714285714285,0.8571428571428571,No,0.8571428571428571
48008,48008,99.00,5,7,12,0.4166666666666667,0.5833333333333334,No,0.5833333333333334
48009,48009,99.00,14,63,77,0.18181818181818182,0.8181818181818182,No,0.8181818181818182
48010,48010,99.00,21,104,125,0.168,0.832,No,0.832
48011,48011,99.00,0,0,0,0,0,n/a,0
48012,48012,99.00,2,1,3,0.6666666666666666,0.3333333333333333,Yes,0.6666666666666666
48013,48013,99.00,0,0,0,0,0,n/a,0
48014,48014,99.00,9,45,54,0.16666666666666666,0.8333333333333334,No,0.8333333333333334
48015,48015,99.00,25,151,176,0.14204545454545456,0.8579545454545454,No,0.8579545454545454
48016,48016,99.00,18,106,124,0.14516129032258066,0.8548387096774194,No,0.8548387096774194
48017,48017,99.00,0,1,1,0.0,1.0,No,1.0
48018,48018,99.00,6,104,110,0.05454545454545454,0.9454545454545454,No,0.9454545454545454
48019,48019,99.00,31,132,163,0.1901840490797546,0.8098159509202454,No,0.8098159509202454
48020,48020,99.00,0,0,0,0,0,n/a,0
48021,48021,99.00,9,52,61,0.14754098360655737,0.8524590163934426,No,0.8524590163934426
48022,48022,99.00,1,3,4,0.25,0.75,No,0.75
48023,48023,99.00,13,87,100,0.13,0.87,No,0.87
48024,48024,99.00,5,71,76,0.06578947368421052,0.9342105263157895,No,0.9342105263157895
48025,48025,99.00,15,63,78,0.19230769230769232,0.8076923076923077,No,0.8076923076923077
48026,48026,99.00,76,163,239,0.3179916317991632,0.6820083682008368,No,0.6820083682008368
48027,48027,99.00,0,2,2,0.0,1.0,No,1.0
48028,48028,99.00,0,4,4,0.0,1.0,No,1.0
48029,48029,99.00,29,160,189,0.15343915343915343,0.8465608465608465,No,0.8465608465608465
48030,48030,99.00,17,185,202,0.08415841584158416,0.9158415841584159,No,0.9158415841584159
48031,48031,99.00,44,13,57,0.7719298245614035,0.22807017543859648,Yes,0.7719298245614035
48032,48032,99.00,33,150,183,0.18032786885245902,0.819672131147541,No,0.819672131147541
48033,48033,99.00,3,4,7,0.42857142857142855,0.5714285714285714,No,0.5714285714285714
48034,48034,99.00,23,20,43,0.5348837209302325,0.46511627906976744,Yes,0.5348837209302325
48035,48035,99.00,6,4,10,0.6,0.4,Yes,0.6
48036,48036,99.00,47,47,94,0.5,0.5,Tie,0.5
48037,48037,99.00,4,1,5,0.8,0.2,Yes,0.8
48038,48038,99.00,2,1,3,0.6666666666666666,0.3333333333333333,Yes,0.6666666666666666
48039,48039,99.00,2,1,3,0.6666666666666666,0.3333333333333333,Yes,0.6666666666666666
48040,48040,99.00,33,114,147,0.22448979591836735,0.7755102040816326,No,0.7755102040816326
48041,48041,99.00,2,0,2,1.0,0.0,Yes,1.0
48042,48042,99.00,55,137,192,0.2864583333333333,0.7135416666666666,No,0.7135416666666666
48043,48043,99.00,71,40,111,0.6396396396396397,0.36036036036036034,Yes,0.6396396396396397
48044,48044,99.00,51,25,76,0.6710526315789473,0.32894736842105265,Yes,0.6710526315789473
48045,48045,99.00,2,2,4,0.5,0.5,Tie,0.5
48046,48046,99.00,1,2,3,0.3333333333333333,0.6666666666666666,No,0.6666666666666666
48047,48047,99.00,34,88,122,0.2786885245901639,0.7213114754098361,No,0.7213114754098361
48048,48048,99.00,10,80,90,0.1111111111111111,0.8888888888888888,No,0.8888888888888888
48049,48049,99.00,8,13,21,0.38095238095238093,0.6190476190476191,No,0.6190476190476191
48050,48050,75.00,3,53,56,0.05357142857142857,0.9464285714285714,No,0.9464285714285714
48051,48051,99.00,67,79,146,0.4589041095890411,0.541095890410959,No,0.541095890410959
48052,48052,99.00,23,56,79,0.2911392405063291,0.7088607594936709,No,0.7088607594936709
48053,48053,99.00,0,0,0,0,0,n/a,0
48054,48054,99.00,4,2,6,0.6666666666666666,0.3333333333333333,Yes,0.6666666666666666
48055,48055,99.00,83,160,243,0.34156378600823045,0.6584362139917695,No,0.6584362139917695
48056,48056,99.00,60,105,165,0.36363636363636365,0.6363636363636364,No,0.6363636363636364
48057,48057,99.00,6,0,6,1.0,0.0,Yes,1.0
48058,48058,99.00,3,0,3,1.0,0.0,Yes,1.0
48059,48059,99.00,9,133,142,0.06338028169014084,0.9366197183098591,No,0.9366197183098591
48060,48060,99.00,28,136,164,0.17073170731707318,0.8292682926829268,No,0.8292682926829268
48061,48061,99.00,41,166,207,0.19806763285024154,0.8019323671497585,No,0.8019323671497585
48062,48062,99.00,75,72,147,0.5102040816326531,0.4897959183673469,Yes,0.5102040816326531
48063,48063,99.00,71,47,118,0.6016949152542372,0.3983050847457627,Yes,0.6016949152542372
48064,48064,99.00,10,58,68,0.14705882352941177,0.8529411764705882,No,0.8529411764705882
48065,48065,99.00,53,112,165,0.3212121212121212,0.6787878787878788,No,0.6787878787878788
48066,48066,99.00,0,0,0,0,0,n/a,0
48067,48067,99.00,9,33,42,0.21428571428571427,0.7857142857142857,No,0.7857142857142857
48068,48068,99.00,1,0,1,1.0,0.0,Yes,1.0
48069,48069,99.00,1,0,1,1.0,0.0,Yes,1.0
48070,48070,99.00,51,77,128,0.3984375,0.6015625,No,0.6015625
48071,48071,99.00,10,106,116,0.08620689655172414,0.9137931034482759,No,0.9137931034482759
48072,48072,99.00,29,141,170,0.17058823529411765,0.8294117647058824,No,0.8294117647058824
49001,49001,99.00,81,20,101,0.801980198019802,0.19801980198019803,Yes,0.801980198019802
49002,49002,99.00,31,19,50,0.62,0.38,Yes,0.62
49003,49003,66.67,9,3,12,0.75,0.25,Yes,0.75
49004,49004,66.67,75,42,117,0.6410256410256411,0.358974358974359,Yes,0.6410256410256411
49005,49005,66.67,29,23,52,0.5576923076923077,0.4423076923076923,Yes,0.5576923076923077
49006,49006,99.00,2,0,2,1.0,0.0,Yes,1.0
49007,49007,99.00,0,0,0,0,0,n/a,0
49008,49008,99.00,56,31,87,0.6436781609195402,0.3563218390804598,Yes,0.6436781609195402
49009,49009,99.00,29,18,47,0.6170212765957447,0.3829787234042553,Yes,0.6170212765957447
49010,49010,0.00,1,0,1,1.0,0.0,Yes,1.0
49011,49011,0.00,3,0,3,1.0,0.0,Yes,1.0
49012,49012,99.00,2,0,2,1.0,0.0,Yes,1.0
49013,49013,99.00,1,0,1,1.0,0.0,Yes,1.0
49014,49014,66.67,0,0,0,0,0,n/a,0
49015,49015,99.00,0,0,0,0,0,n/a,0
49016,49016,99.00,52,17,69,0.7536231884057971,0.2463768115942029,Yes,0.7536231884057971
49017,49017,99.00,42,42,84,0.5,0.5,Tie,0.5
49018,49018,99.00,0,1,1,0.0,1.0,No,1.0
49019,49019,99.00,45,23,68,0.6617647058823529,0.3382352941176471,Yes,0.6617647058823529
49020,49020,99.00,97,59,156,0.6217948717948718,0.3782051282051282,Yes,0.6217948717948718
49021,49021,99.00,41,27,68,0.6029411764705882,0.39705882352941174,Yes,0.6029411764705882
49022,49022,99.00,48,53,101,0.4752475247524752,0.5247524752475248,No,0.5247524752475248
49023,49023,99.00,95,46,141,0.6737588652482269,0.3262411347517731,Yes,0.6737588652482269
49024,49024,99.00,3,1,4,0.75,0.25,Yes,0.75
49025,49025,99.00,71,44,115,0.6173913043478261,0.3826086956521739,Yes,0.6173913043478261
49026,49026,44.44,79,82,161,0.4906832298136646,0.5093167701863354,No,0.5093167701863354
49027,49027,44.44,52,30,82,0.6341463414634146,0.36585365853658536,Yes,0.6341463414634146
49028,49028,44.44,3,6,9,0.3333333333333333,0.6666666666666666,No,0.6666666666666666
49029,49029,99.00,0,0,0,0,0,n/a,0
49030,49030,99.00,1,2,3,0.3333333333333333,0.6666666666666666,No,0.6666666666666666
49031,49031,99.00,31,20,51,0.6078431372549019,0.39215686274509803,Yes,0.6078431372549019
49032,49032,99.00,0,0,0,0,0,n/a,0
49033,49033,99.00,0,1,1,0.0,1.0,No,1.0
49034,49034,44.44,5,1,6,0.8333333333333334,0.16666666666666666,Yes,0.8333333333333334
49035,49035,99.00,106,71,177,0.5988700564971752,0.4011299435028249,Yes,0.5988700564971752
49036,49036,44.44,0,1,1,0.0,1.0,No,1.0
49037,49037,99.00,40,27,67,0.5970149253731343,0.40298507462686567,Yes,0.5970149253731343
49038,49038,99.00,33,27,60,0.55,0.45,Yes,0.55
49039,49039,99.00,8,0,8,1.0,0.0,Yes,1.0
49040,49040,99.00,95,53,148,0.6418918918918919,0.3581081081081081,Yes,0.6418918918918919
49041,49041,99.00,50,33,83,0.6024096385542169,0.39759036144578314,Yes,0.6024096385542169
49042,49042,99.00,34,32,66,0.5151515151515151,0.48484848484848486,Yes,0.5151515151515151
49043,49043,99.00,28,31,59,0.4745762711864407,0.5254237288135594,No,0.5254237288135594
49044,49044,44.44,5,1,6,0.8333333333333334,0.16666666666666666,Yes,0.8333333333333334
49045,49045,99.00,2,1,3,0.6666666666666666,0.3333333333333333,Yes,0.6666666666666666
49046,49046,99.00,0,0,0,0,0,n/a,0
49047,49047,99.00,69,40,109,0.6330275229357798,0.3669724770642202,Yes,0.6330275229357798
49048,49048,99.00,58,41,99,0.5858585858585859,0.41414141414141414,Yes,0.5858585858585859
49049,49049,99.00,98,98,196,0.5,0.5,Tie,0.5
49050,49050,99.00,88,98,186,0.4731182795698925,0.5268817204301075,No,0.5268817204301075
49051,49051,99.00,3,8,11,0.2727272727272727,0.7272727272727273,No,0.7272727272727273
49052,49052,99.00,5,3,8,0.625,0.375,Yes,0.625
49053,49053,99.00,107,115,222,0.481981981981982,0.5180180180180181,No,0.5180180180180181
49054,49054,99.00,127,113,240,0.5291666666666667,0.4708333333333333,Yes,0.5291666666666667
49055,49055,99.00,41,26,67,0.6119402985074627,0.3880597014925373,Yes,0.6119402985074627
49056,49056,99.00,0,0,0,0,0,n/a,0
49057,49057,99.00,0,0,0,0,0,n/a,0
49058,49058,99.00,52,31,83,0.6265060240963856,0.37349397590361444,Yes,0.6265060240963856
49059,49059,44.44,77,52,129,0.5968992248062015,0.40310077519379844,Yes,0.5968992248062015
49060,49060,99.00,0,0,0,0,0,n/a,0
49061,49061,0.00,1,0,1,1.0,0.0,Yes,1.0
49062,49062,66.67,59,43,102,0.5784313725490197,0.4215686274509804,Yes,0.5784313725490197
49063,49063,99.00,5,1,6,0.8333333333333334,0.16666666666666666,Yes,0.8333333333333334
49064,49064,99.00,27,30,57,0.47368421052631576,0.5263157894736842,No,0.5263157894736842
49065,49065,99.00,5,7,12,0.4166666666666667,0.5833333333333334,No,0.5833333333333334
49066,49066,99.00,35,19,54,0.6481481481481481,0.35185185185185186,Yes,0.6481481481481481
49067,49067,66.67,10,1,11,0.9090909090909091,0.09090909090909091,Yes,0.9090909090909091
49068,49068,99.00,33,15,48,0.6875,0.3125,Yes,0.6875
49069,49069,99.00,1,2,3,0.3333333333333333,0.6666666666666666,No,0.6666666666666666
49070,49070,99.00,1,0,1,1.0,0.0,Yes,1.0
49071,49071,99.00,0,0,0,0,0,n/a,0
50001,50001,99.00,27,17,44,0.6136363636363636,0.38636363636363635,Yes,0.6136363636363636
50002,50002,99.00,160,36,196,0.8163265306122449,0.1836734693877551,Yes,0.8163265306122449
50003,50003,66.67,172,31,203,0.8472906403940886,0.15270935960591134,Yes,0.8472906403940886
50004,50004,99.00,3,0,3,1.0,0.0,Yes,1.0
50005,50005,66.67,124,18,142,0.8732394366197183,0.1267605633802817,Yes,0.8732394366197183
50006,50006,66.67,120,26,146,0.821917808219178,0.1780821917808219,Yes,0.821917808219178
50007,50007,99.00,191,47,238,0.8025210084033614,0.19747899159663865,Yes,0.8025210084033614
50008,50008,99.00,167,37,204,0.8186274509803921,0.18137254901960784,Yes,0.8186274509803921
50009,50009,99.00,155,36,191,0.8115183246073299,0.18848167539267016,Yes,0.8115183246073299
50010,50010,99.00,278,48,326,0.852760736196319,0.147239263803681,Yes,0.852760736196319
50011,50011,99.00,4,2,6,0.6666666666666666,0.3333333333333333,Yes,0.6666666666666666
50012,50012,80.00,213,54,267,0.797752808988764,0.20224719101123595,Yes,0.797752808988764
50013,50013,99.00,4,1,5,0.8,0.2,Yes,0.8
50014,50014,99.00,87,19,106,0.8207547169811321,0.1792452830188679,Yes,0.8207547169811321
50015,50015,80.00,8,0,8,1.0,0.0,Yes,1.0
50016,50016,99.00,2,0,2,1.0,0.0,Yes,1.0
50017,50017,99.00,104,31,135,0.7703703703703704,0.22962962962962963,Yes,0.7703703703703704
50018,50018,80.00,8,4,12,0.6666666666666666,0.3333333333333333,Yes,0.6666666666666666
50019,50019,80.00,248,48,296,0.8378378378378378,0.16216216216216217,Yes,0.8378378378378378
50020,50020,99.00,13,1,14,0.9285714285714286,0.07142857142857142,Yes,0.9285714285714286
50021,50021,99.00,313,61,374,0.8368983957219251,0.16310160427807488,Yes,0.8368983957219251
50022,50022,99.00,84,22,106,0.7924528301886793,0.20754716981132076,Yes,0.7924528301886793
50023,50023,99.00,0,0,0,0,0,n/a,0
50024,50024,99.00,0,0,0,0,0,n/a,0
50025,50025,99.00,1,0,1,1.0,0.0,Yes,1.0
50026,50026,99.00,159,46,205,0.775609756097561,0.22439024390243903,Yes,0.775609756097561
50027,50027,99.00,169,34,203,0.8325123152709359,0.16748768472906403,Yes,0.8325123152709359
50028,50028,99.00,167,48,215,0.7767441860465116,0.22325581395348837,Yes,0.7767441860465116
50029,50029,99.00,11,2,13,0.8461538461538461,0.15384615384615385,Yes,0.8461538461538461
50030,50030,99.00,167,44,211,0.7914691943127962,0.20853080568720378,Yes,0.7914691943127962
50031,50031,99.00,7,2,9,0.7777777777777778,0.2222222222222222,Yes,0.7777777777777778
50032,50032,99.00,247,60,307,0.8045602605863192,0.19543973941368079,Yes,0.8045602605863192
50033,50033,80.00,175,39,214,0.8177570093457944,0.1822429906542056,Yes,0.8177570093457944
50034,50034,99.00,137,28,165,0.8303030303030303,0.1696969696969697,Yes,0.8303030303030303
50035,50035,99.00,147,34,181,0.8121546961325967,0.1878453038674033,Yes,0.8121546961325967
50036,50036,99.00,93,26,119,0.7815126050420168,0.2184873949579832,Yes,0.7815126050420168
50037,50037,99.00,133,26,159,0.8364779874213837,0.16352201257861634,Yes,0.8364779874213837
50038,50038,99.00,102,19,121,0.8429752066115702,0.15702479338842976,Yes,0.8429752066115702
50039,50039,99.00,116,23,139,0.8345323741007195,0.16546762589928057,Yes,0.8345323741007195
50040,50040,99.00,103,23,126,0.8174603174603174,0.18253968253968253,Yes,0.8174603174603174
50041,50041,99.00,137,31,168,0.8154761904761905,0.18452380952380953,Yes,0.8154761904761905
50042,50042,80.00,159,55,214,0.7429906542056075,0.2570093457943925,Yes,0.7429906542056075
50043,50043,99.00,135,19,154,0.8766233766233766,0.12337662337662338,Yes,0.8766233766233766
50044,50044,99.00,10,1,11,0.9090909090909091,0.09090909090909091,Yes,0.9090909090909091
50045,50045,99.00,0,0,0,0,0,n/a,0
50046,50046,99.00,118,18,136,0.8676470588235294,0.1323529411764706,Yes,0.8676470588235294
50047,50047,99.00,6,0,6,1.0,0.0,Yes,1.0
50048,50048,99.00,112,27,139,0.8057553956834532,0.19424460431654678,Yes,0.8057553956834532
50049,50049,99.00,2,0,2,1.0,0.0,Yes,1.0
50050,50050,99.00,177,51,228,0.7763157894736842,0.2236842105263158,Yes,0.7763157894736842
50051,50051,99.00,180,29,209,0.861244019138756,0.13875598086124402,Yes,0.861244019138756
50052,50052,99.00,94,20,114,0.8245614035087719,0.17543859649122806,Yes,0.8245614035087719
50053,50053,99.00,115,29,144,0.7986111111111112,0.2013888888888889,Yes,0.7986111111111112
50054,50054,99.00,2,0,2,1.0,0.0,Yes,1.0
50055,50055,99.00,0,0,0,0,0,n/a,0
50056,50056,99.00,15,7,22,0.6818181818181818,0.3181818181818182,Yes,0.6818181818181818
50057,50057,99.00,53,31,84,0.6309523809523809,0.36904761904761907,Yes,0.6309523809523809
50058,50058,99.00,1,0,1,1.0,0.0,Yes,1.0
50059,50059,99.00,123,27,150,0.82,0.18,Yes,0.82
50060,50060,99.00,2,0,2,1.0,0.0,Yes,1.0
50061,50061,99.00,43,16,59,0.7288135593220338,0.2711864406779661,Yes,0.7288135593220338
50062,50062,99.00,0,0,0,0,0,n/a,0
50063,50063,99.00,31,13,44,0.7045454545454546,0.29545454545454547,Yes,0.7045454545454546
50064,50064,99.00,17,7,24,0.7083333333333334,0.2916666666666667,Yes,0.7083333333333334
50065,50065,99.00,0,0,0,0,0,n/a,0
50066,50066,99.00,3,11,14,0.21428571428571427,0.7857142857142857,No,0.7857142857142857
50067,50067,99.00,0,0,0,0,0,n/a,0
50068,50068,99.00,13,15,28,0.4642857142857143,0.5357142857142857,No,0.5357142857142857
50069,50069,99.00,36,24,60,0.6,0.4,Yes,0.6
50070,50070,99.00,0,0,0,0,0,n/a,0
50071,50071,99.00,0,0,0,0,0,n/a,0
50072,50072,99.00,49,26,75,0.6533333333333333,0.3466666666666667,Yes,0.6533333333333333
50073,50073,99.00,0,0,0,0,0,n/a,0
50074,50074,99.00,1,5,6,0.16666666666666666,0.8333333333333334,No,0.8333333333333334
50075,50075,99.00,15,11,26,0.5769230769230769,0.4230769230769231,Yes,0.5769230769230769
50076,50076,99.00,24,19,43,0.5581395348837209,0.4418604651162791,Yes,0.5581395348837209
50077,50077,99.00,10,18,28,0.35714285714285715,0.6428571428571429,No,0.6428571428571429
50078,50078,99.00,15,16,31,0.4838709677419355,0.5161290322580645,No,0.5161290322580645
50079,50079,99.00,0,0,0,0,0,n/a,0
50080,50080,99.00,3,0,3,1.0,0.0,Yes,1.0
50081,50081,99.00,0,0,0,0,0,n/a,0
50082,50082,99.00,36,15,51,0.7058823529411765,0.29411764705882354,Yes,0.7058823529411765
50083,50083,99.00,47,17,64,0.734375,0.265625,Yes,0.734375
50084,50084,99.00,0,0,0,0,0,n/a,0
50085,50085,99.00,32,13,45,0.7111111111111111,0.28888888888888886,Yes,0.7111111111111111
50086,50086,99.00,0,0,0,0,0,n/a,0
50087,50087,99.00,3,1,4,0.75,0.25,Yes,0.75
50088,50088,99.00,2,0,2,1.0,0.0,Yes,1.0
50089,50089,99.00,156,15,171,0.9122807017543859,0.08771929824561403,Yes,0.9122807017543859
50090,50090,99.00,103,20,123,0.8373983739837398,0.16260162601626016,Yes,0.8373983739837398
50091,50091,99.00,5,0,5,1.0,0.0,Yes,1.0
50092,50092,99.00,227,47,274,0.8284671532846716,0.17153284671532848,Yes,0.8284671532846716
50093,50093,99.00,0,0,0,0,0,n/a,0
50094,50094,99.00,0,1,1,0.0,1.0,No,1.0
50095,50095,99.00,150,39,189,0.7936507936507936,0.20634920634920634,Yes,0.7936507936507936
50096,50096,99.00,101,24,125,0.808,0.192,Yes,0.808
50097,50097,99.00,190,49,239,0.7949790794979079,0.20502092050209206,Yes,0.7949790794979079
50098,50098,99.00,0,0,0,0,0,n/a,0
50099,50099,99.00,148,20,168,0.8809523809523809,0.11904761904761904,Yes,0.8809523809523809
50100,50100,99.00,0,0,0,0,0,n/a,0
50101,50101,99.00,6,0,6,1.0,0.0,Yes,1.0
50102,50102,80.00,3,6,9,0.3333333333333333,0.6666666666666666,No,0.6666666666666666
50103,50103,99.00,0,0,0,0,0,n/a,0
50104,50104,99.00,0,0,0,0,0,n/a,0
50105,50105,99.00,0,0,0,0,0,n/a,0
50106,50106,99.00,0,0,0,0,0,n/a,0
50107,50107,99.00,0,0,0,0,0,n/a,0
51001,51001,99.00,131,38,169,0.7751479289940828,0.22485207100591717,Yes,0.7751479289940828
51002,51002,99.00,53,33,86,0.6162790697674418,0.38372093023255816,Yes,0.6162790697674418
51003,51003,99.00,113,33,146,0.773972602739726,0.22602739726027396,Yes,0.773972602739726
51004,51004,99.00,96,13,109,0.8807339449541285,0.11926605504587157,Yes,0.8807339449541285
51005,51005,99.00,53,15,68,0.7794117647058824,0.22058823529411764,Yes,0.7794117647058824
51006,51006,99.00,13,0,13,1.0,0.0,Yes,1.0
51007,51007,99.00,184,37,221,0.832579185520362,0.167420814479638,Yes,0.832579185520362
51008,51008,0.00,1,0,1,1.0,0.0,Yes,1.0
51009,51009,99.00,34,15,49,0.6938775510204082,0.30612244897959184,Yes,0.6938775510204082
51010,51010,99.00,1,0,1,1.0,0.0,Yes,1.0
51011,51011,99.00,284,50,334,0.8502994011976048,0.1497005988023952,Yes,0.8502994011976048
51012,51012,99.00,187,41,228,0.8201754385964912,0.17982456140350878,Yes,0.8201754385964912
51013,51013,99.00,17,4,21,0.8095238095238095,0.19047619047619047,Yes,0.8095238095238095
51014,51014,99.00,84,66,150,0.56,0.44,Yes,0.56
51015,51015,99.00,2,0,2,1.0,0.0,Yes,1.0
51016,51016,99.00,25,52,77,0.3246753246753247,0.6753246753246753,No,0.6753246753246753
51017,51017,99.00,63,30,93,0.6774193548387096,0.3225806451612903,Yes,0.6774193548387096
51018,51018,99.00,0,0,0,0,0,n/a,0
51019,51019,99.00,2,0,2,1.0,0.0,Yes,1.0
51020,51020,0.00,49,7,56,0.875,0.125,Yes,0.875
51021,51021,99.00,2,1,3,0.6666666666666666,0.3333333333333333,Yes,0.6666666666666666
51022,51022,99.00,11,0,11,1.0,0.0,Yes,1.0
51023,51023,99.00,15,4,19,0.7894736842105263,0.21052631578947367,Yes,0.7894736842105263
51024,51024,50.00,32,20,52,0.6153846153846154,0.38461538461538464,Yes,0.6153846153846154
51025,51025,99.00,0,0,0,0,0,n/a,0
51026,51026,99.00,83,42,125,0.664,0.336,Yes,0.664
51027,51027,99.00,2,2,4,0.5,0.5,Tie,0.5
51028,51028,99.00,0,0,0,0,0,n/a,0
51029,51029,66.67,96,24,120,0.8,0.2,Yes,0.8
51030,51030,99.00,4,1,5,0.8,0.2,Yes,0.8
51031,51031,99.00,115,54,169,0.6804733727810651,0.31952662721893493,Yes,0.6804733727810651
51032,51032,66.67,88,39,127,0.6929133858267716,0.30708661417322836,Yes,0.6929133858267716
51033,51033,66.67,62,15,77,0.8051948051948052,0.19480519480519481,Yes,0.8051948051948052
51034,51034,99.00,109,31,140,0.7785714285714286,0.22142857142857142,Yes,0.7785714285714286
51035,51035,99.00,121,27,148,0.8175675675675675,0.18243243243243243,Yes,0.8175675675675675
51036,51036,99.00,101,16,117,0.8632478632478633,0.13675213675213677,Yes,0.8632478632478633
51037,51037,99.00,102,24,126,0.8095238095238095,0.19047619047619047,Yes,0.8095238095238095
51038,51038,99.00,181,33,214,0.8457943925233645,0.1542056074766355,Yes,0.8457943925233645
51039,51039,99.00,89,29,118,0.7542372881355932,0.2457627118644068,Yes,0.7542372881355932
51040,51040,99.00,182,34,216,0.8425925925925926,0.1574074074074074,Yes,0.8425925925925926
51041,51041,99.00,307,51,358,0.8575418994413407,0.1424581005586592,Yes,0.8575418994413407
51042,51042,99.00,200,36,236,0.847457627118644,0.15254237288135594,Yes,0.847457627118644
51043,51043,99.00,83,17,100,0.83,0.17,Yes,0.83
51044,51044,0.00,7,2,9,0.7777777777777778,0.2222222222222222,Yes,0.7777777777777778
51045,51045,0.00,0,0,0,0,0,n/a,0
51046,51046,99.00,2,0,2,1.0,0.0,Yes,1.0
51047,51047,99.00,3,4,7,0.42857142857142855,0.5714285714285714,No,0.5714285714285714
51048,51048,99.00,0,0,0,0,0,n/a,0
51049,51049,99.00,203,38,241,0.8423236514522822,0.15767634854771784,Yes,0.8423236514522822
51050,51050,99.00,1,0,1,1.0,0.0,Yes,1.0
51051,51051,99.00,77,38,115,0.6695652173913044,0.33043478260869563,Yes,0.6695652173913044
51052,51052,99.00,123,31,154,0.7987012987012987,0.2012987012987013,Yes,0.7987012987012987
51053,51053,99.00,6,1,7,0.8571428571428571,0.14285714285714285,Yes,0.8571428571428571
51054,51054,99.00,89,24,113,0.7876106194690266,0.21238938053097345,Yes,0.7876106194690266
51055,51055,99.00,15,1,16,0.9375,0.0625,Yes,0.9375
51056,51056,99.00,0,0,0,0,0,n/a,0
51057,51057,99.00,0,0,0,0,0,n/a,0
51058,51058,99.00,1,0,1,1.0,0.0,Yes,1.0
51059,51059,99.00,5,1,6,0.8333333333333334,0.16666666666666666,Yes,0.8333333333333334
51060,51060,99.00,112,41,153,0.7320261437908496,0.2679738562091503,Yes,0.7320261437908496
51061,51061,99.00,103,46,149,0.6912751677852349,0.3087248322147651,Yes,0.6912751677852349
51062,51062,99.00,162,83,245,0.6612244897959184,0.33877551020408164,Yes,0.6612244897959184
51063,51063,99.00,107,52,159,0.6729559748427673,0.3270440251572327,Yes,0.6729559748427673
51064,51064,99.00,92,22,114,0.8070175438596491,0.19298245614035087,Yes,0.8070175438596491
51065,51065,99.00,59,21,80,0.7375,0.2625,Yes,0.7375
51066,51066,99.00,88,25,113,0.7787610619469026,0.22123893805309736,Yes,0.7787610619469026
51067,51067,99.00,2,2,4,0.5,0.5,Tie,0.5
51068,51068,99.00,4,0,4,1.0,0.0,Yes,1.0
51069,51069,0.00,3,0,3,1.0,0.0,Yes,1.0
51070,51070,99.00,166,27,193,0.8601036269430051,0.13989637305699482,Yes,0.8601036269430051
51071,51071,99.00,56,14,70,0.8,0.2,Yes,0.8
51072,51072,99.00,5,0,5,1.0,0.0,Yes,1.0
51073,51073,99.00,101,20,121,0.8347107438016529,0.1652892561983471,Yes,0.8347107438016529
51074,51074,99.00,2,0,2,1.0,0.0,Yes,1.0
51075,51075,66.67,12,4,16,0.75,0.25,Yes,0.75
51076,51076,99.00,9,0,9,1.0,0.0,Yes,1.0
51077,51077,99.00,135,73,208,0.6490384615384616,0.35096153846153844,Yes,0.6490384615384616
51078,51078,99.00,2,0,2,1.0,0.0,Yes,1.0
51079,51079,99.00,92,29,121,0.7603305785123967,0.2396694214876033,Yes,0.7603305785123967
51080,51080,99.00,1,0,1,1.0,0.0,Yes,1.0
51081,51081,99.00,74,23,97,0.7628865979381443,0.23711340206185566,Yes,0.7628865979381443
51082,51082,99.00,165,42,207,0.7971014492753623,0.2028985507246377,Yes,0.7971014492753623
51083,51083,99.00,243,45,288,0.84375,0.15625,Yes,0.84375
51084,51084,99.00,0,0,0,0,0,n/a,0
51085,51085,99.00,0,0,0,0,0,n/a,0
51086,51086,99.00,0,0,0,0,0,n/a,0
51087,51087,0.00,0,0,0,0,0,n/a,0
52001,52001,99.00,104,12,116,0.896551724137931,0.10344827586206896,Yes,0.896551724137931
52002,52002,99.00,89,12,101,0.8811881188118812,0.1188118811881188,Yes,0.8811881188118812
52003,52003,18.75,8,2,10,0.8,0.2,Yes,0.8
52004,52004,99.00,220,65,285,0.7719298245614035,0.22807017543859648,Yes,0.7719298245614035
52005,52005,99.00,4,2,6,0.6666666666666666,0.3333333333333333,Yes,0.6666666666666666
52006,52006,99.00,15,1,16,0.9375,0.0625,Yes,0.9375
52007,52007,99.00,296,66,362,0.8176795580110497,0.18232044198895028,Yes,0.8176795580110497
52008,52008,99.00,385,118,503,0.7654075546719682,0.2345924453280318,Yes,0.7654075546719682
52009,52009,99.00,10,3,13,0.7692307692307693,0.23076923076923078,Yes,0.7692307692307693
52010,52010,99.00,275,68,343,0.8017492711370262,0.19825072886297376,Yes,0.8017492711370262
52011,52011,99.00,275,69,344,0.7994186046511628,0.2005813953488372,Yes,0.7994186046511628
52012,52012,99.00,262,70,332,0.7891566265060241,0.21084337349397592,Yes,0.7891566265060241
52013,52013,99.00,45,12,57,0.7894736842105263,0.21052631578947367,Yes,0.7894736842105263
52014,52014,99.00,22,2,24,0.9166666666666666,0.08333333333333333,Yes,0.9166666666666666
52015,52015,99.00,380,66,446,0.852017937219731,0.14798206278026907,Yes,0.852017937219731
52016,52016,99.00,319,100,419,0.7613365155131265,0.2386634844868735,Yes,0.7613365155131265
52017,52017,99.00,28,7,35,0.8,0.2,Yes,0.8
52018,52018,99.00,318,63,381,0.8346456692913385,0.16535433070866143,Yes,0.8346456692913385
52019,52019,99.00,337,74,411,0.8199513381995134,0.18004866180048662,Yes,0.8199513381995134
52020,52020,99.00,137,39,176,0.7784090909090909,0.2215909090909091,Yes,0.7784090909090909
52021,52021,99.00,5,1,6,0.8333333333333334,0.16666666666666666,Yes,0.8333333333333334
52022,52022,99.00,9,5,14,0.6428571428571429,0.35714285714285715,Yes,0.6428571428571429
52023,52023,18.75,341,86,427,0.7985948477751756,0.20140515222482436,Yes,0.7985948477751756
52024,52024,99.00,63,8,71,0.8873239436619719,0.11267605633802817,Yes,0.8873239436619719
52025,52025,18.75,258,62,320,0.80625,0.19375,Yes,0.80625
52026,52026,99.00,8,1,9,0.8888888888888888,0.1111111111111111,Yes,0.8888888888888888
52027,52027,99.00,447,97,544,0.8216911764705882,0.17830882352941177,Yes,0.8216911764705882
52028,52028,99.00,160,39,199,0.8040201005025126,0.19597989949748743,Yes,0.8040201005025126
52029,52029,99.00,297,58,355,0.8366197183098592,0.16338028169014085,Yes,0.8366197183098592
52030,52030,99.00,192,37,229,0.8384279475982532,0.1615720524017467,Yes,0.8384279475982532
52031,52031,99.00,221,31,252,0.876984126984127,0.12301587301587301,Yes,0.876984126984127
52032,52032,99.00,196,46,242,0.8099173553719008,0.19008264462809918,Yes,0.8099173553719008
52033,52033,99.00,235,52,287,0.818815331010453,0.18118466898954705,Yes,0.818815331010453
52034,52034,99.00,192,33,225,0.8533333333333334,0.14666666666666667,Yes,0.8533333333333334
52035,52035,80.00,176,26,202,0.8712871287128713,0.12871287128712872,Yes,0.8712871287128713
52036,52036,80.00,16,1,17,0.9411764705882353,0.058823529411764705,Yes,0.9411764705882353
52037,52037,80.00,34,5,39,0.8717948717948718,0.1282051282051282,Yes,0.8717948717948718
52038,52038,80.00,417,86,503,0.8290258449304175,0.1709741550695825,Yes,0.8290258449304175
52039,52039,80.00,236,41,277,0.851985559566787,0.148014440433213,Yes,0.851985559566787
52040,52040,80.00,99,20,119,0.8319327731092437,0.16806722689075632,Yes,0.8319327731092437
52041,52041,99.00,4,1,5,0.8,0.2,Yes,0.8
52042,52042,99.00,209,43,252,0.8293650793650794,0.17063492063492064,Yes,0.8293650793650794
52043,52043,50.00,122,26,148,0.8243243243243243,0.17567567567567569,Yes,0.8243243243243243
52044,52044,99.00,335,84,419,0.7995226730310262,0.20047732696897375,Yes,0.7995226730310262
52045,52045,99.00,16,4,20,0.8,0.2,Yes,0.8
52046,52046,50.00,105,15,120,0.875,0.125,Yes,0.875
52047,52047,99.00,14,3,17,0.8235294117647058,0.17647058823529413,Yes,0.8235294117647058
52048,52048,99.00,18,3,21,0.8571428571428571,0.14285714285714285,Yes,0.8571428571428571
52049,52049,99.00,13,1,14,0.9285714285714286,0.07142857142857142,Yes,0.9285714285714286
52050,52050,99.00,6,0,6,1.0,0.0,Yes,1.0
52051,52051,99.00,179,35,214,0.8364485981308412,0.16355140186915887,Yes,0.8364485981308412
52052,52052,99.00,77,20,97,0.7938144329896907,0.20618556701030927,Yes,0.7938144329896907
52053,52053,99.00,2,0,2,1.0,0.0,Yes,1.0
52054,52054,99.00,0,0,0,0,0,n/a,0
52055,52055,99.00,265,47,312,0.8493589743589743,0.15064102564102563,Yes,0.8493589743589743
52056,52056,99.00,162,39,201,0.8059701492537313,0.19402985074626866,Yes,0.8059701492537313
52057,52057,99.00,320,58,378,0.8465608465608465,0.15343915343915343,Yes,0.8465608465608465
52058,52058,99.00,13,1,14,0.9285714285714286,0.07142857142857142,Yes,0.9285714285714286
52059,52059,99.00,373,71,444,0.8400900900900901,0.15990990990990991,Yes,0.8400900900900901
52060,52060,99.00,16,1,17,0.9411764705882353,0.058823529411764705,Yes,0.9411764705882353
52061,52061,99.00,299,46,345,0.8666666666666667,0.13333333333333333,Yes,0.8666666666666667
52062,52062,99.00,12,2,14,0.8571428571428571,0.14285714285714285,Yes,0.8571428571428571
52063,52063,99.00,0,0,0,0,0,n/a,0
52064,52064,99.00,318,57,375,0.848,0.152,Yes,0.848
52065,52065,99.00,11,1,12,0.9166666666666666,0.08333333333333333,Yes,0.9166666666666666
52066,52066,99.00,396,70,466,0.8497854077253219,0.15021459227467812,Yes,0.8497854077253219
52067,52067,99.00,8,0,8,1.0,0.0,Yes,1.0
52068,52068,99.00,40,5,45,0.8888888888888888,0.1111111111111111,Yes,0.8888888888888888
52069,52069,99.00,436,80,516,0.8449612403100775,0.15503875968992248,Yes,0.8449612403100775
52070,52070,99.00,289,43,332,0.8704819277108434,0.12951807228915663,Yes,0.8704819277108434
52071,52071,99.00,455,65,520,0.875,0.125,Yes,0.875
52072,52072,99.00,33,1,34,0.9705882352941176,0.029411764705882353,Yes,0.9705882352941176
52073,52073,99.00,331,49,380,0.8710526315789474,0.12894736842105264,Yes,0.8710526315789474
52074,52074,99.00,31,1,32,0.96875,0.03125,Yes,0.96875
52075,52075,99.00,381,50,431,0.8839907192575406,0.11600928074245939,Yes,0.8839907192575406
52076,52076,99.00,70,16,86,0.813953488372093,0.18604651162790697,Yes,0.813953488372093
52077,52077,99.00,9,4,13,0.6923076923076923,0.3076923076923077,Yes,0.6923076923076923
52078,52078,99.00,249,44,293,0.8498293515358362,0.15017064846416384,Yes,0.8498293515358362
52079,52079,99.00,6,1,7,0.8571428571428571,0.14285714285714285,Yes,0.8571428571428571
52080,52080,99.00,11,3,14,0.7857142857142857,0.21428571428571427,Yes,0.7857142857142857
52081,52081,99.00,249,45,294,0.8469387755102041,0.15306122448979592,Yes,0.8469387755102041
52082,52082,99.00,330,60,390,0.8461538461538461,0.15384615384615385,Yes,0.8461538461538461
52083,52083,99.00,47,8,55,0.8545454545454545,0.14545454545454545,Yes,0.8545454545454545
52084,52084,99.00,334,74,408,0.8186274509803921,0.18137254901960784,Yes,0.8186274509803921
52085,52085,99.00,348,52,400,0.87,0.13,Yes,0.87
52086,52086,99.00,34,2,36,0.9444444444444444,0.05555555555555555,Yes,0.9444444444444444
52087,52087,99.00,471,69,540,0.8722222222222222,0.12777777777777777,Yes,0.8722222222222222
52088,52088,99.00,20,3,23,0.8695652173913043,0.13043478260869565,Yes,0.8695652173913043
52089,52089,99.00,369,62,431,0.8561484918793504,0.14385150812064965,Yes,0.8561484918793504
52090,52090,99.00,243,34,277,0.8772563176895307,0.12274368231046931,Yes,0.8772563176895307
52091,52091,99.00,10,2,12,0.8333333333333334,0.16666666666666666,Yes,0.8333333333333334
52092,52092,99.00,427,63,490,0.8714285714285714,0.12857142857142856,Yes,0.8714285714285714
52093,52093,99.00,24,5,29,0.8275862068965517,0.1724137931034483,Yes,0.8275862068965517
52094,52094,99.00,21,1,22,0.9545454545454546,0.045454545454545456,Yes,0.9545454545454546
52095,52095,0.00,1,0,1,1.0,0.0,Yes,1.0
52096,52096,99.00,192,48,240,0.8,0.2,Yes,0.8
52097,52097,99.00,230,56,286,0.8041958041958042,0.1958041958041958,Yes,0.8041958041958042
52098,52098,99.00,385,73,458,0.8406113537117904,0.15938864628820962,Yes,0.8406113537117904
52099,52099,99.00,271,54,325,0.8338461538461538,0.16615384615384615,Yes,0.8338461538461538
52100,52100,99.00,279,100,379,0.7361477572559367,0.2638522427440633,Yes,0.7361477572559367
52101,52101,99.00,23,3,26,0.8846153846153846,0.11538461538461539,Yes,0.8846153846153846
52102,52102,99.00,227,49,276,0.822463768115942,0.17753623188405798,Yes,0.822463768115942
52103,52103,99.00,243,34,277,0.8772563176895307,0.12274368231046931,Yes,0.8772563176895307
52104,52104,99.00,13,1,14,0.9285714285714286,0.07142857142857142,Yes,0.9285714285714286
52105,52105,99.00,276,59,335,0.8238805970149253,0.1761194029850746,Yes,0.8238805970149253
52106,52106,99.00,9,1,10,0.9,0.1,Yes,0.9
52107,52107,99.00,318,47,365,0.8712328767123287,0.12876712328767123,Yes,0.8712328767123287
52108,52108,99.00,16,2,18,0.8888888888888888,0.1111111111111111,Yes,0.8888888888888888
52109,52109,99.00,2,2,4,0.5,0.5,Tie,0.5
52110,52110,80.00,11,1,12,0.9166666666666666,0.08333333333333333,Yes,0.9166666666666666
52111,52111,99.00,10,2,12,0.8333333333333334,0.16666666666666666,Yes,0.8333333333333334
52112,52112,99.00,311,44,355,0.8760563380281691,0.12394366197183099,Yes,0.8760563380281691
52113,52113,99.00,263,27,290,0.906896551724138,0.09310344827586207,Yes,0.906896551724138
52114,52114,99.00,14,1,15,0.9333333333333333,0.06666666666666667,Yes,0.9333333333333333
52115,52115,18.75,41,9,50,0.82,0.18,Yes,0.82
52116,52116,99.00,408,77,485,0.8412371134020619,0.15876288659793814,Yes,0.8412371134020619
52117,52117,99.00,37,3,40,0.925,0.075,Yes,0.925
52118,52118,99.00,0,0,0,0,0,n/a,0
52119,52119,99.00,0,0,0,0,0,n/a,0
52120,52120,99.00,0,0,0,0,0,n/a,0
52121,52121,99.00,0,0,0,0,0,n/a,0
52122,52122,99.00,0,0,0,0,0,n/a,0
52123,52123,99.00,0,0,0,0,0,n/a,0
52124,52124,99.00,0,0,0,0,0,n/a,0
52125,52125,99.00,0,0,0,0,0,n/a,0
52126,52126,99.00,0,0,0,0,0,n/a,0
53001,53001,99.00,0,1,1,0.0,1.0,No,1.0
53002,53002,99.00,105,24,129,0.813953488372093,0.18604651162790697,Yes,0.813953488372093
53003,53003,99.00,71,17,88,0.8068181818181818,0.19318181818181818,Yes,0.8068181818181818
53004,53004,99.00,105,24,129,0.813953488372093,0.18604651162790697,Yes,0.813953488372093
53005,53005,99.00,115,17,132,0.8712121212121212,0.12878787878787878,Yes,0.8712121212121212
53006,53006,99.00,1,0,1,1.0,0.0,Yes,1.0
53007,53007,99.00,147,25,172,0.8546511627906976,0.14534883720930233,Yes,0.8546511627906976
53008,53008,99.00,150,28,178,0.8426966292134831,0.15730337078651685,Yes,0.8426966292134831
53009,53009,99.00,91,13,104,0.875,0.125,Yes,0.875
53010,53010,99.00,0,0,0,0,0,n/a,0
53011,53011,99.00,3,0,3,1.0,0.0,Yes,1.0
53012,53012,99.00,109,31,140,0.7785714285714286,0.22142857142857142,Yes,0.7785714285714286
53013,53013,99.00,120,41,161,0.7453416149068323,0.2546583850931677,Yes,0.7453416149068323
53014,53014,99.00,0,0,0,0,0,n/a,0
53015,53015,99.00,2,1,3,0.6666666666666666,0.3333333333333333,Yes,0.6666666666666666
53016,53016,30.00,123,20,143,0.8601398601398601,0.13986013986013987,Yes,0.8601398601398601
53017,53017,30.00,9,2,11,0.8181818181818182,0.18181818181818182,Yes,0.8181818181818182
53018,53018,99.00,123,26,149,0.825503355704698,0.174496644295302,Yes,0.825503355704698
53019,53019,99.00,2,2,4,0.5,0.5,Tie,0.5
53020,53020,99.00,135,31,166,0.8132530120481928,0.18674698795180722,Yes,0.8132530120481928
53021,53021,99.00,87,15,102,0.8529411764705882,0.14705882352941177,Yes,0.8529411764705882
53022,53022,30.00,127,27,154,0.8246753246753247,0.17532467532467533,Yes,0.8246753246753247
53023,53023,99.00,168,53,221,0.7601809954751131,0.2398190045248869,Yes,0.7601809954751131
53024,53024,99.00,1,0,1,1.0,0.0,Yes,1.0
53025,53025,99.00,149,50,199,0.7487437185929648,0.25125628140703515,Yes,0.7487437185929648
53026,53026,99.00,3,0,3,1.0,0.0,Yes,1.0
53027,53027,99.00,108,22,130,0.8307692307692308,0.16923076923076924,Yes,0.8307692307692308
53028,53028,99.00,100,28,128,0.78125,0.21875,Yes,0.78125
53029,53029,99.00,77,28,105,0.7333333333333333,0.26666666666666666,Yes,0.7333333333333333
53030,53030,30.00,225,44,269,0.8364312267657993,0.16356877323420074,Yes,0.8364312267657993
53031,53031,99.00,3,4,7,0.42857142857142855,0.5714285714285714,No,0.5714285714285714
53032,53032,99.00,158,37,195,0.8102564102564103,0.18974358974358974,Yes,0.8102564102564103
53033,53033,99.00,239,53,292,0.8184931506849316,0.1815068493150685,Yes,0.8184931506849316
53034,53034,99.00,235,51,286,0.8216783216783217,0.17832167832167833,Yes,0.8216783216783217
53035,53035,99.00,5,1,6,0.8333333333333334,0.16666666666666666,Yes,0.8333333333333334
53036,53036,99.00,233,53,286,0.8146853146853147,0.1853146853146853,Yes,0.8146853146853147
53037,53037,99.00,7,0,7,1.0,0.0,Yes,1.0
53038,53038,99.00,3,1,4,0.75,0.25,Yes,0.75
53039,53039,99.00,168,35,203,0.8275862068965517,0.1724137931034483,Yes,0.8275862068965517
53040,53040,99.00,4,0,4,1.0,0.0,Yes,1.0
53041,53041,99.00,35,7,42,0.8333333333333334,0.16666666666666666,Yes,0.8333333333333334
53042,53042,99.00,47,10,57,0.8245614035087719,0.17543859649122806,Yes,0.8245614035087719
53043,53043,99.00,49,13,62,0.7903225806451613,0.20967741935483872,Yes,0.7903225806451613
53044,53044,99.00,91,24,115,0.7913043478260869,0.20869565217391303,Yes,0.7913043478260869
53045,53045,99.00,117,39,156,0.75,0.25,Yes,0.75
53046,53046,99.00,130,23,153,0.8496732026143791,0.1503267973856209,Yes,0.8496732026143791
53047,53047,99.00,111,22,133,0.8345864661654135,0.16541353383458646,Yes,0.8345864661654135
53048,53048,99.00,103,19,122,0.8442622950819673,0.1557377049180328,Yes,0.8442622950819673
53049,53049,99.00,4,2,6,0.6666666666666666,0.3333333333333333,Yes,0.6666666666666666
53050,53050,99.00,93,22,115,0.808695652173913,0.19130434782608696,Yes,0.808695652173913
53051,53051,99.00,0,0,0,0,0,n/a,0
53052,53052,99.00,0,0,0,0,0,n/a,0
53053,53053,99.00,1,1,2,0.5,0.5,Tie,0.5
53054,53054,99.00,118,24,142,0.8309859154929577,0.16901408450704225,Yes,0.8309859154929577
53055,53055,99.00,92,11,103,0.8932038834951457,0.10679611650485436,Yes,0.8932038834951457
53056,53056,99.00,89,22,111,0.8018018018018018,0.1981981981981982,Yes,0.8018018018018018
53057,53057,99.00,102,22,124,0.8225806451612904,0.1774193548387097,Yes,0.8225806451612904
53058,53058,99.00,92,17,109,0.8440366972477065,0.1559633027522936,Yes,0.8440366972477065
53059,53059,99.00,108,30,138,0.782608695652174,0.21739130434782608,Yes,0.782608695652174
53060,53060,99.00,123,49,172,0.7151162790697675,0.28488372093023256,Yes,0.7151162790697675
53061,53061,99.00,109,20,129,0.8449612403100775,0.15503875968992248,Yes,0.8449612403100775
53062,53062,99.00,0,0,0,0,0,n/a,0
53063,53063,99.00,125,30,155,0.8064516129032258,0.1935483870967742,Yes,0.8064516129032258
53064,53064,99.00,74,18,92,0.8043478260869565,0.1956521739130435,Yes,0.8043478260869565
53065,53065,99.00,213,49,262,0.8129770992366412,0.18702290076335878,Yes,0.8129770992366412
53066,53066,99.00,186,37,223,0.8340807174887892,0.16591928251121077,Yes,0.8340807174887892
53067,53067,99.00,121,22,143,0.8461538461538461,0.15384615384615385,Yes,0.8461538461538461
53068,53068,99.00,3,2,5,0.6,0.4,Yes,0.6
53069,53069,99.00,91,23,114,0.7982456140350878,0.20175438596491227,Yes,0.7982456140350878
53070,53070,37.50,97,21,118,0.8220338983050848,0.17796610169491525,Yes,0.8220338983050848
53071,53071,99.00,3,0,3,1.0,0.0,Yes,1.0
53072,53072,99.00,100,14,114,0.8771929824561403,0.12280701754385964,Yes,0.8771929824561403
53073,53073,99.00,2,0,2,1.0,0.0,Yes,1.0
53074,53074,99.00,142,21,163,0.8711656441717791,0.12883435582822086,Yes,0.8711656441717791
53075,53075,99.00,2,0,2,1.0,0.0,Yes,1.0
53076,53076,99.00,204,25,229,0.8908296943231441,0.1091703056768559,Yes,0.8908296943231441
53077,53077,99.00,111,17,128,0.8671875,0.1328125,Yes,0.8671875
53078,53078,99.00,8,22,30,0.26666666666666666,0.7333333333333333,No,0.7333333333333333
53079,53079,99.00,5,0,5,1.0,0.0,Yes,1.0
53080,53080,44.44,101,21,122,0.8278688524590164,0.1721311475409836,Yes,0.8278688524590164
53081,53081,99.00,0,0,0,0,0,n/a,0
53082,53082,99.00,118,13,131,0.9007633587786259,0.09923664122137404,Yes,0.9007633587786259
53083,53083,99.00,2,0,2,1.0,0.0,Yes,1.0
53084,53084,99.00,2,0,2,1.0,0.0,Yes,1.0
53085,53085,99.00,5,4,9,0.5555555555555556,0.4444444444444444,Yes,0.5555555555555556
53086,53086,99.00,87,31,118,0.7372881355932204,0.2627118644067797,Yes,0.7372881355932204
53087,53087,99.00,96,24,120,0.8,0.2,Yes,0.8
53088,53088,99.00,99,21,120,0.825,0.175,Yes,0.825
53089,53089,99.00,0,0,0,0,0,n/a,0
54001,54001,99.00,3,0,3,1.0,0.0,Yes,1.0
54002,54002,99.00,101,19,120,0.8416666666666667,0.15833333333333333,Yes,0.8416666666666667
54003,54003,99.00,61,28,89,0.6853932584269663,0.3146067415730337,Yes,0.6853932584269663
54004,54004,99.00,35,6,41,0.8536585365853658,0.14634146341463414,Yes,0.8536585365853658
54005,54005,99.00,0,2,2,0.0,1.0,No,1.0
54006,54006,99.00,0,0,0,0,0,n/a,0
54007,54007,99.00,5,0,5,1.0,0.0,Yes,1.0
54008,54008,99.00,131,27,158,0.8291139240506329,0.17088607594936708,Yes,0.8291139240506329
54009,54009,99.00,4,0,4,1.0,0.0,Yes,1.0
54010,54010,99.00,177,44,221,0.8009049773755657,0.19909502262443438,Yes,0.8009049773755657
54011,54011,99.00,71,20,91,0.7802197802197802,0.21978021978021978,Yes,0.7802197802197802
54012,54012,99.00,122,20,142,0.8591549295774648,0.14084507042253522,Yes,0.8591549295774648
54013,54013,99.00,4,1,5,0.8,0.2,Yes,0.8
54014,54014,99.00,14,1,15,0.9333333333333333,0.06666666666666667,Yes,0.9333333333333333
54015,54015,99.00,56,11,67,0.835820895522388,0.16417910447761194,Yes,0.835820895522388
54016,54016,99.00,1,0,1,1.0,0.0,Yes,1.0
54017,54017,99.00,1,0,1,1.0,0.0,Yes,1.0
54018,54018,99.00,0,0,0,0,0,n/a,0
54019,54019,99.00,109,30,139,0.7841726618705036,0.2158273381294964,Yes,0.7841726618705036
54020,54020,99.00,93,21,114,0.8157894736842105,0.18421052631578946,Yes,0.8157894736842105
54021,54021,50.00,3,0,3,1.0,0.0,Yes,1.0
54022,54022,99.00,157,42,199,0.7889447236180904,0.21105527638190955,Yes,0.7889447236180904
54023,54023,99.00,74,32,106,0.6981132075471698,0.3018867924528302,Yes,0.6981132075471698
54024,54024,99.00,99,24,123,0.8048780487804879,0.1951219512195122,Yes,0.8048780487804879
54025,54025,99.00,183,38,221,0.8280542986425339,0.17194570135746606,Yes,0.8280542986425339
54026,54026,99.00,0,0,0,0,0,n/a,0
54027,54027,99.00,141,36,177,0.7966101694915254,0.2033898305084746,Yes,0.7966101694915254
54028,54028,50.00,101,31,132,0.7651515151515151,0.23484848484848486,Yes,0.7651515151515151
54029,54029,99.00,99,16,115,0.8608695652173913,0.1391304347826087,Yes,0.8608695652173913
54030,54030,37.50,70,21,91,0.7692307692307693,0.23076923076923078,Yes,0.7692307692307693
54031,54031,37.50,109,30,139,0.7841726618705036,0.2158273381294964,Yes,0.7841726618705036
54032,54032,37.50,10,0,10,1.0,0.0,Yes,1.0
54033,54033,99.00,160,36,196,0.8163265306122449,0.1836734693877551,Yes,0.8163265306122449
54034,54034,99.00,2,0,2,1.0,0.0,Yes,1.0
54035,54035,99.00,4,2,6,0.6666666666666666,0.3333333333333333,Yes,0.6666666666666666
54036,54036,99.00,8,1,9,0.8888888888888888,0.1111111111111111,Yes,0.8888888888888888
54037,54037,99.00,138,37,175,0.7885714285714286,0.21142857142857144,Yes,0.7885714285714286
54038,54038,99.00,0,0,0,0,0,n/a,0
54039,54039,99.00,134,30,164,0.8170731707317073,0.18292682926829268,Yes,0.8170731707317073
54040,54040,99.00,2,0,2,1.0,0.0,Yes,1.0
54041,54041,99.00,106,34,140,0.7571428571428571,0.24285714285714285,Yes,0.7571428571428571
54042,54042,99.00,0,0,0,0,0,n/a,0
54043,54043,99.00,69,27,96,0.71875,0.28125,Yes,0.71875
54044,54044,99.00,93,23,116,0.8017241379310345,0.19827586206896552,Yes,0.8017241379310345
54045,54045,99.00,2,1,3,0.6666666666666666,0.3333333333333333,Yes,0.6666666666666666
54046,54046,99.00,55,13,68,0.8088235294117647,0.19117647058823528,Yes,0.8088235294117647
54047,54047,66.67,79,26,105,0.7523809523809524,0.24761904761904763,Yes,0.7523809523809524
54048,54048,66.67,52,11,63,0.8253968253968254,0.1746031746031746,Yes,0.8253968253968254
54049,54049,99.00,71,25,96,0.7395833333333334,0.2604166666666667,Yes,0.7395833333333334
54050,54050,99.00,81,22,103,0.7864077669902912,0.21359223300970873,Yes,0.7864077669902912
54051,54051,99.00,47,20,67,0.7014925373134329,0.29850746268656714,Yes,0.7014925373134329
54052,54052,99.00,1,0,1,1.0,0.0,Yes,1.0
54053,54053,66.67,0,0,0,0,0,n/a,0
54054,54054,99.00,0,0,0,0,0,n/a,0
54055,54055,99.00,1,1,2,0.5,0.5,Tie,0.5
54056,54056,99.00,2,0,2,1.0,0.0,Yes,1.0
54057,54057,99.00,105,20,125,0.84,0.16,Yes,0.84
54058,54058,99.00,99,16,115,0.8608695652173913,0.1391304347826087,Yes,0.8608695652173913
54059,54059,99.00,73,27,100,0.73,0.27,Yes,0.73
54060,54060,99.00,203,59,262,0.7748091603053435,0.22519083969465647,Yes,0.7748091603053435
54061,54061,99.00,136,28,164,0.8292682926829268,0.17073170731707318,Yes,0.8292682926829268
54062,54062,99.00,2,1,3,0.6666666666666666,0.3333333333333333,Yes,0.6666666666666666
54063,54063,99.00,147,38,185,0.7945945945945946,0.20540540540540542,Yes,0.7945945945945946
54064,54064,99.00,5,2,7,0.7142857142857143,0.2857142857142857,Yes,0.7142857142857143
54065,54065,99.00,2,1,3,0.6666666666666666,0.3333333333333333,Yes,0.6666666666666666
54066,54066,99.00,74,14,88,0.8409090909090909,0.1590909090909091,Yes,0.8409090909090909
54067,54067,99.00,100,16,116,0.8620689655172413,0.13793103448275862,Yes,0.8620689655172413
54068,54068,99.00,74,17,91,0.8131868131868132,0.18681318681318682,Yes,0.8131868131868132
54069,54069,99.00,78,24,102,0.7647058823529411,0.23529411764705882,Yes,0.7647058823529411
54070,54070,99.00,79,23,102,0.7745098039215687,0.22549019607843138,Yes,0.7745098039215687
54071,54071,99.00,1,0,1,1.0,0.0,Yes,1.0
54072,54072,99.00,0,0,0,0,0,n/a,0
54073,54073,99.00,7,1,8,0.875,0.125,Yes,0.875
54074,54074,99.00,6,2,8,0.75,0.25,Yes,0.75
54075,54075,99.00,1,0,1,1.0,0.0,Yes,1.0
54076,54076,99.00,67,22,89,0.7528089887640449,0.24719101123595505,Yes,0.7528089887640449
54077,54077,99.00,1,0,1,1.0,0.0,Yes,1.0
54078,54078,99.00,0,0,0,0,0,n/a,0
54079,54079,99.00,0,0,0,0,0,n/a,0
54080,54080,99.00,55,26,81,0.6790123456790124,0.32098765432098764,Yes,0.6790123456790124
54081,54081,99.00,83,28,111,0.7477477477477478,0.25225225225225223,Yes,0.7477477477477478
54082,54082,99.00,0,0,0,0,0,n/a,0
54083,54083,99.00,104,25,129,0.8062015503875969,0.1937984496124031,Yes,0.8062015503875969
54084,54084,99.00,3,0,3,1.0,0.0,Yes,1.0
54085,54085,99.00,103,34,137,0.7518248175182481,0.24817518248175183,Yes,0.7518248175182481
54086,54086,99.00,107,21,128,0.8359375,0.1640625,Yes,0.8359375
54087,54087,99.00,0,0,0,0,0,n/a,0
54088,54088,99.00,1,0,1,1.0,0.0,Yes,1.0
54089,54089,99.00,130,35,165,0.7878787878787878,0.21212121212121213,Yes,0.7878787878787878
55001,55001,99.00,0,0,0,0,0,n/a,0
55002,55002,99.00,91,26,117,0.7777777777777778,0.2222222222222222,Yes,0.7777777777777778
55003,55003,99.00,0,1,1,0.0,1.0,No,1.0
55004,55004,99.00,5,5,10,0.5,0.5,Tie,0.5
55005,55005,99.00,1,1,2,0.5,0.5,Tie,0.5
55006,55006,50.00,0,0,0,0,0,n/a,0
55007,55007,99.00,76,23,99,0.7676767676767676,0.23232323232323232,Yes,0.7676767676767676
55008,55008,99.00,0,0,0,0,0,n/a,0
55009,55009,99.00,168,55,223,0.7533632286995515,0.24663677130044842,Yes,0.7533632286995515
55010,55010,99.00,160,47,207,0.7729468599033816,0.22705314009661837,Yes,0.7729468599033816
55011,55011,50.00,66,15,81,0.8148148148148148,0.18518518518518517,Yes,0.8148148148148148
55012,55012,50.00,43,21,64,0.671875,0.328125,Yes,0.671875
55013,55013,99.00,3,0,3,1.0,0.0,Yes,1.0
55014,55014,99.00,96,16,112,0.8571428571428571,0.14285714285714285,Yes,0.8571428571428571
55015,55015,99.00,147,38,185,0.7945945945945946,0.20540540540540542,Yes,0.7945945945945946
55016,55016,99.00,122,39,161,0.7577639751552795,0.2422360248447205,Yes,0.7577639751552795
55017,55017,99.00,1,0,1,1.0,0.0,Yes,1.0
55018,55018,99.00,133,35,168,0.7916666666666666,0.20833333333333334,Yes,0.7916666666666666
55019,55019,99.00,138,38,176,0.7840909090909091,0.2159090909090909,Yes,0.7840909090909091
55020,55020,99.00,218,39,257,0.8482490272373541,0.1517509727626459,Yes,0.8482490272373541
55021,55021,99.00,75,17,92,0.8152173913043478,0.18478260869565216,Yes,0.8152173913043478
55022,55022,99.00,3,1,4,0.75,0.25,Yes,0.75
55023,55023,99.00,174,61,235,0.7404255319148936,0.25957446808510637,Yes,0.7404255319148936
55024,55024,99.00,100,15,115,0.8695652173913043,0.13043478260869565,Yes,0.8695652173913043
55025,55025,99.00,98,36,134,0.7313432835820896,0.26865671641791045,Yes,0.7313432835820896
55026,55026,99.00,1,0,1,1.0,0.0,Yes,1.0
55027,55027,99.00,80,23,103,0.7766990291262136,0.22330097087378642,Yes,0.7766990291262136
55028,55028,99.00,1,2,3,0.3333333333333333,0.6666666666666666,No,0.6666666666666666
55029,55029,99.00,0,0,0,0,0,n/a,0
55030,55030,99.00,4,1,5,0.8,0.2,Yes,0.8
55031,55031,99.00,108,43,151,0.7152317880794702,0.2847682119205298,Yes,0.7152317880794702
55032,55032,99.00,172,44,216,0.7962962962962963,0.2037037037037037,Yes,0.7962962962962963
55033,55033,99.00,191,59,250,0.764,0.236,Yes,0.764
55034,55034,99.00,3,0,3,1.0,0.0,Yes,1.0
55035,55035,99.00,38,5,43,0.8837209302325582,0.11627906976744186,Yes,0.8837209302325582
55036,55036,99.00,0,0,0,0,0,n/a,0
55037,55037,99.00,5,6,11,0.45454545454545453,0.5454545454545454,No,0.5454545454545454
55038,55038,99.00,50,23,73,0.684931506849315,0.3150684931506849,Yes,0.684931506849315
55039,55039,99.00,0,0,0,0,0,n/a,0
55040,55040,99.00,0,0,0,0,0,n/a,0
55041,55041,99.00,38,7,45,0.8444444444444444,0.15555555555555556,Yes,0.8444444444444444
55042,55042,99.00,1,0,1,1.0,0.0,Yes,1.0
55043,55043,99.00,0,0,0,0,0,n/a,0
55044,55044,99.00,0,0,0,0,0,n/a,0
55045,55045,99.00,33,15,48,0.6875,0.3125,Yes,0.6875
55046,55046,99.00,114,23,137,0.8321167883211679,0.1678832116788321,Yes,0.8321167883211679
55047,55047,99.00,38,18,56,0.6785714285714286,0.32142857142857145,Yes,0.6785714285714286
55048,55048,99.00,80,17,97,0.8247422680412371,0.17525773195876287,Yes,0.8247422680412371
55049,55049,99.00,54,18,72,0.75,0.25,Yes,0.75
55050,55050,99.00,15,8,23,0.6521739130434783,0.34782608695652173,Yes,0.6521739130434783
55051,55051,99.00,0,0,0,0,0,n/a,0
55052,55052,99.00,32,9,41,0.7804878048780488,0.21951219512195122,Yes,0.7804878048780488
55053,55053,99.00,0,0,0,0,0,n/a,0
55054,55054,99.00,0,0,0,0,0,n/a,0
55055,55055,99.00,82,30,112,0.7321428571428571,0.26785714285714285,Yes,0.7321428571428571
55056,55056,99.00,0,0,0,0,0,n/a,0
55057,55057,99.00,56,10,66,0.8484848484848485,0.15151515151515152,Yes,0.8484848484848485
55058,55058,99.00,7,0,7,1.0,0.0,Yes,1.0
55059,55059,99.00,0,0,0,0,0,n/a,0
55060,55060,99.00,2,0,2,1.0,0.0,Yes,1.0
55061,55061,99.00,0,0,0,0,0,n/a,0
55062,55062,99.00,3,1,4,0.75,0.25,Yes,0.75
55063,55063,99.00,3,1,4,0.75,0.25,Yes,0.75
55064,55064,99.00,138,16,154,0.8961038961038961,0.1038961038961039,Yes,0.8961038961038961
55065,55065,44.44,93,36,129,0.7209302325581395,0.27906976744186046,Yes,0.7209302325581395
55066,55066,99.00,57,14,71,0.8028169014084507,0.19718309859154928,Yes,0.8028169014084507
55067,55067,99.00,91,24,115,0.7913043478260869,0.20869565217391303,Yes,0.7913043478260869
55068,55068,44.44,7,0,7,1.0,0.0,Yes,1.0
55069,55069,44.44,125,29,154,0.8116883116883117,0.18831168831168832,Yes,0.8116883116883117
55070,55070,44.44,0,0,0,0,0,n/a,0
55071,55071,99.00,83,23,106,0.7830188679245284,0.2169811320754717,Yes,0.7830188679245284
55072,55072,99.00,2,3,5,0.4,0.6,No,0.6
55073,55073,99.00,0,0,0,0,0,n/a,0
55074,55074,99.00,60,24,84,0.7142857142857143,0.2857142857142857,Yes,0.7142857142857143
55075,55075,99.00,112,28,140,0.8,0.2,Yes,0.8
55076,55076,99.00,119,18,137,0.8686131386861314,0.13138686131386862,Yes,0.8686131386861314
55077,55077,99.00,1,0,1,1.0,0.0,Yes,1.0
55078,55078,44.44,133,38,171,0.7777777777777778,0.2222222222222222,Yes,0.7777777777777778
55079,55079,99.00,112,32,144,0.7777777777777778,0.2222222222222222,Yes,0.7777777777777778
55080,55080,99.00,141,35,176,0.8011363636363636,0.19886363636363635,Yes,0.8011363636363636
55081,55081,99.00,78,15,93,0.8387096774193549,0.16129032258064516,Yes,0.8387096774193549
55082,55082,99.00,129,40,169,0.7633136094674556,0.23668639053254437,Yes,0.7633136094674556
55083,55083,99.00,113,25,138,0.8188405797101449,0.18115942028985507,Yes,0.8188405797101449
55084,55084,99.00,89,18,107,0.8317757009345794,0.16822429906542055,Yes,0.8317757009345794
55085,55085,99.00,0,2,2,0.0,1.0,No,1.0
55086,55086,99.00,2,0,2,1.0,0.0,Yes,1.0
55087,55087,99.00,0,0,0,0,0,n/a,0
55088,55088,99.00,188,39,227,0.8281938325991189,0.17180616740088106,Yes,0.8281938325991189
55089,55089,99.00,152,51,203,0.7487684729064039,0.2512315270935961,Yes,0.7487684729064039
55090,55090,99.00,5,0,5,1.0,0.0,Yes,1.0
55091,55091,99.00,3,0,3,1.0,0.0,Yes,1.0
55092,55092,99.00,150,44,194,0.7731958762886598,0.2268041237113402,Yes,0.7731958762886598
55093,55093,99.00,186,42,228,0.8157894736842105,0.18421052631578946,Yes,0.8157894736842105
55094,55094,99.00,90,16,106,0.8490566037735849,0.1509433962264151,Yes,0.8490566037735849
55095,55095,99.00,26,10,36,0.7222222222222222,0.2777777777777778,Yes,0.7222222222222222
55096,55096,99.00,99,27,126,0.7857142857142857,0.21428571428571427,Yes,0.7857142857142857
55097,55097,99.00,2,0,2,1.0,0.0,Yes,1.0
55098,55098,99.00,0,0,0,0,0,n/a,0
55099,55099,99.00,112,29,141,0.7943262411347518,0.20567375886524822,Yes,0.7943262411347518
55100,55100,99.00,3,0,3,1.0,0.0,Yes,1.0
55101,55101,99.00,5,0,5,1.0,0.0,Yes,1.0
55102,55102,99.00,129,47,176,0.7329545454545454,0.26704545454545453,Yes,0.7329545454545454
55103,55103,99.00,4,2,6,0.6666666666666666,0.3333333333333333,Yes,0.6666666666666666
55104,55104,99.00,1,1,2,0.5,0.5,Tie,0.5
55105,55105,99.00,1,1,2,0.5,0.5,Tie,0.5
55106,55106,99.00,118,36,154,0.7662337662337663,0.23376623376623376,Yes,0.7662337662337663
55107,55107,99.00,136,34,170,0.8,0.2,Yes,0.8
55108,55108,99.00,131,34,165,0.793939393939394,0.20606060606060606,Yes,0.793939393939394
55109,55109,99.00,2,0,2,1.0,0.0,Yes,1.0
55110,55110,44.44,2,5,7,0.2857142857142857,0.7142857142857143,No,0.7142857142857143
55111,55111,99.00,0,0,0,0,0,n/a,0
55112,55112,99.00,0,0,0,0,0,n/a,0
55113,55113,99.00,0,0,0,0,0,n/a,0
56001,56001,44.44,87,26,113,0.7699115044247787,0.23008849557522124,Yes,0.7699115044247787
56002,56002,44.44,61,8,69,0.8840579710144928,0.11594202898550725,Yes,0.8840579710144928
56003,56003,99.00,47,10,57,0.8245614035087719,0.17543859649122806,Yes,0.8245614035087719
56004,56004,44.44,7,1,8,0.875,0.125,Yes,0.875
56005,56005,99.00,1,2,3,0.3333333333333333,0.6666666666666666,No,0.6666666666666666
56006,56006,44.44,89,20,109,0.8165137614678899,0.1834862385321101,Yes,0.8165137614678899
56007,56007,99.00,5,2,7,0.7142857142857143,0.2857142857142857,Yes,0.7142857142857143
56008,56008,99.00,54,15,69,0.782608695652174,0.21739130434782608,Yes,0.782608695652174
56009,56009,99.00,56,13,69,0.8115942028985508,0.18840579710144928,Yes,0.8115942028985508
56010,56010,99.00,85,23,108,0.7870370370370371,0.21296296296296297,Yes,0.7870370370370371
56011,56011,99.00,117,33,150,0.78,0.22,Yes,0.78
56012,56012,99.00,14,0,14,1.0,0.0,Yes,1.0
56013,56013,99.00,235,50,285,0.8245614035087719,0.17543859649122806,Yes,0.8245614035087719
56014,56014,99.00,115,36,151,0.7615894039735099,0.23841059602649006,Yes,0.7615894039735099
56015,56015,80.00,136,35,171,0.7953216374269005,0.2046783625730994,Yes,0.7953216374269005
56016,56016,80.00,121,30,151,0.8013245033112583,0.1986754966887417,Yes,0.8013245033112583
56017,56017,99.00,93,20,113,0.8230088495575221,0.17699115044247787,Yes,0.8230088495575221
56018,56018,99.00,13,5,18,0.7222222222222222,0.2777777777777778,Yes,0.7222222222222222
56019,56019,99.00,212,58,270,0.7851851851851852,0.21481481481481482,Yes,0.7851851851851852
56020,56020,99.00,1,0,1,1.0,0.0,Yes,1.0
56021,56021,99.00,182,41,223,0.8161434977578476,0.18385650224215247,Yes,0.8161434977578476
56022,56022,99.00,216,52,268,0.8059701492537313,0.19402985074626866,Yes,0.8059701492537313
56023,56023,99.00,141,37,178,0.7921348314606742,0.20786516853932585,Yes,0.7921348314606742
56024,56024,99.00,137,32,169,0.8106508875739645,0.1893491124260355,Yes,0.8106508875739645
56025,56025,99.00,139,28,167,0.8323353293413174,0.16766467065868262,Yes,0.8323353293413174
56026,56026,99.00,219,39,258,0.8488372093023255,0.1511627906976744,Yes,0.8488372093023255
56027,56027,66.67,83,26,109,0.7614678899082569,0.23853211009174313,Yes,0.7614678899082569
56028,56028,66.67,87,28,115,0.7565217391304347,0.24347826086956523,Yes,0.7565217391304347
56029,56029,99.00,174,52,226,0.7699115044247787,0.23008849557522124,Yes,0.7699115044247787
56030,56030,99.00,87,31,118,0.7372881355932204,0.2627118644067797,Yes,0.7372881355932204
56031,56031,99.00,198,52,250,0.792,0.208,Yes,0.792
56032,56032,99.00,159,40,199,0.7989949748743719,0.20100502512562815,Yes,0.7989949748743719
56033,56033,99.00,154,47,201,0.7661691542288557,0.23383084577114427,Yes,0.7661691542288557
56034,56034,99.00,12,0,12,1.0,0.0,Yes,1.0
56035,56035,66.67,88,19,107,0.822429906542056,0.17757009345794392,Yes,0.822429906542056
56036,56036,99.00,124,38,162,0.7654320987654321,0.2345679012345679,Yes,0.7654320987654321
56037,56037,99.00,268,59,327,0.8195718654434251,0.18042813455657492,Yes,0.8195718654434251
56038,56038,99.00,192,38,230,0.8347826086956521,0.16521739130434782,Yes,0.8347826086956521
56039,56039,99.00,5,0,5,1.0,0.0,Yes,1.0
56040,56040,99.00,143,29,172,0.8313953488372093,0.1686046511627907,Yes,0.8313953488372093
56041,56041,99.00,162,44,206,0.7864077669902912,0.21359223300970873,Yes,0.7864077669902912
56042,56042,99.00,168,36,204,0.8235294117647058,0.17647058823529413,Yes,0.8235294117647058
56043,56043,99.00,6,2,8,0.75,0.25,Yes,0.75
56044,56044,99.00,251,60,311,0.8070739549839229,0.19292604501607716,Yes,0.8070739549839229
56045,56045,99.00,163,39,202,0.806930693069307,0.19306930693069307,Yes,0.806930693069307
56046,56046,99.00,11,1,12,0.9166666666666666,0.08333333333333333,Yes,0.9166666666666666
56047,56047,99.00,7,3,10,0.7,0.3,Yes,0.7
56048,56048,99.00,257,71,328,0.7835365853658537,0.21646341463414634,Yes,0.7835365853658537
56049,56049,99.00,296,82,378,0.783068783068783,0.21693121693121692,Yes,0.783068783068783
56050,56050,99.00,7,1,8,0.875,0.125,Yes,0.875
56051,56051,99.00,8,0,8,1.0,0.0,Yes,1.0
56052,56052,99.00,136,42,178,0.7640449438202247,0.23595505617977527,Yes,0.7640449438202247
56053,56053,99.00,185,35,220,0.8409090909090909,0.1590909090909091,Yes,0.8409090909090909
56054,56054,99.00,252,57,309,0.8155339805825242,0.18446601941747573,Yes,0.8155339805825242
56055,56055,66.67,248,61,309,0.8025889967637541,0.19741100323624594,Yes,0.8025889967637541
56056,56056,66.67,1,2,3,0.3333333333333333,0.6666666666666666,No,0.6666666666666666
56057,56057,99.00,156,34,190,0.8210526315789474,0.17894736842105263,Yes,0.8210526315789474
56058,56058,99.00,11,1,12,0.9166666666666666,0.08333333333333333,Yes,0.9166666666666666
56059,56059,0.00,8,0,8,1.0,0.0,Yes,1.0
56060,56060,99.00,213,55,268,0.7947761194029851,0.20522388059701493,Yes,0.7947761194029851
56061,56061,99.00,7,0,7,1.0,0.0,Yes,1.0
56062,56062,99.00,65,17,82,0.7926829268292683,0.2073170731707317,Yes,0.7926829268292683
56063,56063,99.00,118,21,139,0.8489208633093526,0.1510791366906475,Yes,0.8489208633093526
56064,56064,99.00,146,40,186,0.7849462365591398,0.21505376344086022,Yes,0.7849462365591398
56065,56065,99.00,175,41,216,0.8101851851851852,0.18981481481481483,Yes,0.8101851851851852
56066,56066,99.00,3,0,3,1.0,0.0,Yes,1.0
56067,56067,99.00,4,0,4,1.0,0.0,Yes,1.0
56068,56068,99.00,14,2,16,0.875,0.125,Yes,0.875
56069,56069,0.00,19,4,23,0.8260869565217391,0.17391304347826086,Yes,0.8260869565217391
56070,56070,0.00,10,2,12,0.8333333333333334,0.16666666666666666,Yes,0.8333333333333334
56071,56071,99.00,165,44,209,0.7894736842105263,0.21052631578947367,Yes,0.7894736842105263
56072,56072,99.00,190,25,215,0.8837209302325582,0.11627906976744186,Yes,0.8837209302325582
56073,56073,99.00,141,42,183,0.7704918032786885,0.22950819672131148,Yes,0.7704918032786885
56074,56074,99.00,11,2,13,0.8461538461538461,0.15384615384615385,Yes,0.8461538461538461
56075,56075,99.00,4,0,4,1.0,0.0,Yes,1.0
56076,56076,99.00,7,1,8,0.875,0.125,Yes,0.875
56077,56077,99.00,161,39,200,0.805,0.195,Yes,0.805
56078,56078,99.00,182,63,245,0.7428571428571429,0.2571428571428571,Yes,0.7428571428571429
56079,56079,80.00,173,29,202,0.8564356435643564,0.14356435643564355,Yes,0.8564356435643564
56080,56080,99.00,300,84,384,0.78125,0.21875,Yes,0.78125
56081,56081,99.00,4,0,4,1.0,0.0,Yes,1.0
56082,56082,99.00,121,30,151,0.8013245033112583,0.1986754966887417,Yes,0.8013245033112583
56083,56083,0.00,0,0,0,0,0,n/a,0
56084,56084,99.00,6,1,7,0.8571428571428571,0.14285714285714285,Yes,0.8571428571428571
56085,56085,99.00,148,42,190,0.7789473684210526,0.22105263157894736,Yes,0.7789473684210526
56086,56086,99.00,106,27,133,0.7969924812030075,0.20300751879699247,Yes,0.7969924812030075
56087,56087,99.00,6,0,6,1.0,0.0,Yes,1.0
56088,56088,99.00,134,37,171,0.783625730994152,0.21637426900584794,Yes,0.783625730994152
56089,56089,99.00,10,1,11,0.9090909090909091,0.09090909090909091,Yes,0.9090909090909091
56090,56090,99.00,287,63,350,0.82,0.18,Yes,0.82
56091,56091,99.00,194,45,239,0.8117154811715481,0.18828451882845187,Yes,0.8117154811715481
56092,56092,99.00,0,0,0,0,0,n/a,0
57001,57001,99.00,93,24,117,0.7948717948717948,0.20512820512820512,Yes,0.7948717948717948
57002,57002,99.00,76,23,99,0.7676767676767676,0.23232323232323232,Yes,0.7676767676767676
57003,57003,99.00,2,1,3,0.6666666666666666,0.3333333333333333,Yes,0.6666666666666666
57004,57004,99.00,58,10,68,0.8529411764705882,0.14705882352941177,Yes,0.8529411764705882
57005,57005,99.00,2,0,2,1.0,0.0,Yes,1.0
57006,57006,99.00,50,11,61,0.819672131147541,0.18032786885245902,Yes,0.819672131147541
57007,57007,99.00,3,0,3,1.0,0.0,Yes,1.0
57008,57008,99.00,104,28,132,0.7878787878787878,0.21212121212121213,Yes,0.7878787878787878
57009,57009,99.00,120,28,148,0.8108108108108109,0.1891891891891892,Yes,0.8108108108108109
57010,57010,99.00,288,59,347,0.829971181556196,0.17002881844380405,Yes,0.829971181556196
57011,57011,99.00,177,36,213,0.8309859154929577,0.16901408450704225,Yes,0.8309859154929577
57012,57012,99.00,101,34,135,0.7481481481481481,0.2518518518518518,Yes,0.7481481481481481
57013,57013,99.00,3,0,3,1.0,0.0,Yes,1.0
57014,57014,99.00,131,22,153,0.8562091503267973,0.1437908496732026,Yes,0.8562091503267973
57015,57015,99.00,13,0,13,1.0,0.0,Yes,1.0
57016,57016,99.00,244,46,290,0.8413793103448276,0.15862068965517243,Yes,0.8413793103448276
57017,57017,99.00,310,38,348,0.8908045977011494,0.10919540229885058,Yes,0.8908045977011494
57018,57018,99.00,289,48,337,0.857566765578635,0.142433234421365,Yes,0.857566765578635
57019,57019,99.00,4,0,4,1.0,0.0,Yes,1.0
57020,57020,99.00,0,0,0,0,0,n/a,0
57021,57021,80.00,145,24,169,0.8579881656804734,0.14201183431952663,Yes,0.8579881656804734
57022,57022,99.00,147,25,172,0.8546511627906976,0.14534883720930233,Yes,0.8546511627906976
57023,57023,99.00,1,0,1,1.0,0.0,Yes,1.0
57024,57024,99.00,347,60,407,0.8525798525798526,0.14742014742014742,Yes,0.8525798525798526
57025,57025,99.00,289,50,339,0.8525073746312685,0.14749262536873156,Yes,0.8525073746312685
57026,57026,99.00,244,51,295,0.8271186440677966,0.17288135593220338,Yes,0.8271186440677966
57027,57027,99.00,327,49,376,0.8696808510638298,0.13031914893617022,Yes,0.8696808510638298
57028,57028,99.00,7,2,9,0.7777777777777778,0.2222222222222222,Yes,0.7777777777777778
57029,57029,99.00,314,66,380,0.8263157894736842,0.1736842105263158,Yes,0.8263157894736842
57030,57030,99.00,173,56,229,0.7554585152838428,0.2445414847161572,Yes,0.7554585152838428
57031,57031,99.00,286,65,351,0.8148148148148148,0.18518518518518517,Yes,0.8148148148148148
57032,57032,99.00,113,21,134,0.8432835820895522,0.15671641791044777,Yes,0.8432835820895522
57033,57033,99.00,2,0,2,1.0,0.0,Yes,1.0
57034,57034,99.00,264,42,306,0.8627450980392157,0.13725490196078433,Yes,0.8627450980392157
57035,57035,99.00,209,33,242,0.8636363636363636,0.13636363636363635,Yes,0.8636363636363636
57036,57036,80.00,177,41,218,0.8119266055045872,0.18807339449541285,Yes,0.8119266055045872
57037,57037,80.00,112,35,147,0.7619047619047619,0.23809523809523808,Yes,0.7619047619047619
57038,57038,99.00,239,35,274,0.8722627737226277,0.12773722627737227,Yes,0.8722627737226277
57039,57039,99.00,216,35,251,0.8605577689243028,0.1394422310756972,Yes,0.8605577689243028
57040,57040,99.00,243,26,269,0.9033457249070632,0.09665427509293681,Yes,0.9033457249070632
57041,57041,99.00,202,40,242,0.8347107438016529,0.1652892561983471,Yes,0.8347107438016529
57042,57042,99.00,186,34,220,0.8454545454545455,0.15454545454545454,Yes,0.8454545454545455
57043,57043,99.00,256,64,320,0.8,0.2,Yes,0.8
57044,57044,99.00,162,32,194,0.8350515463917526,0.16494845360824742,Yes,0.8350515463917526
57045,57045,99.00,250,65,315,0.7936507936507936,0.20634920634920634,Yes,0.7936507936507936
57046,57046,99.00,2,0,2,1.0,0.0,Yes,1.0
57047,57047,0.00,10,3,13,0.7692307692307693,0.23076923076923078,Yes,0.7692307692307693
57048,57048,99.00,396,52,448,0.8839285714285714,0.11607142857142858,Yes,0.8839285714285714
57049,57049,99.00,188,42,230,0.8173913043478261,0.1826086956521739,Yes,0.8173913043478261
57050,57050,99.00,9,3,12,0.75,0.25,Yes,0.75
57051,57051,99.00,290,56,346,0.838150289017341,0.16184971098265896,Yes,0.838150289017341
57052,57052,99.00,1,0,1,1.0,0.0,Yes,1.0
57053,57053,99.00,5,2,7,0.7142857142857143,0.2857142857142857,Yes,0.7142857142857143
57054,57054,99.00,212,39,251,0.8446215139442231,0.1553784860557769,Yes,0.8446215139442231
57055,57055,99.00,278,69,347,0.8011527377521613,0.1988472622478386,Yes,0.8011527377521613
57056,57056,99.00,197,33,230,0.8565217391304348,0.14347826086956522,Yes,0.8565217391304348
57057,57057,99.00,154,34,188,0.8191489361702128,0.18085106382978725,Yes,0.8191489361702128
57058,57058,99.00,224,35,259,0.8648648648648649,0.13513513513513514,Yes,0.8648648648648649
57059,57059,99.00,306,55,361,0.8476454293628809,0.1523545706371191,Yes,0.8476454293628809
57060,57060,99.00,358,55,413,0.8668280871670703,0.13317191283292978,Yes,0.8668280871670703
57061,57061,0.00,37,1,38,0.9736842105263158,0.02631578947368421,Yes,0.9736842105263158
57062,57062,0.00,13,1,14,0.9285714285714286,0.07142857142857142,Yes,0.9285714285714286
57063,57063,99.00,23,0,23,1.0,0.0,Yes,1.0
57064,57064,99.00,375,68,443,0.8465011286681715,0.15349887133182843,Yes,0.8465011286681715
57065,57065,99.00,24,0,24,1.0,0.0,Yes,1.0
57066,57066,99.00,9,3,12,0.75,0.25,Yes,0.75
57067,57067,99.00,307,60,367,0.8365122615803815,0.16348773841961853,Yes,0.8365122615803815
57068,57068,99.00,215,39,254,0.8464566929133859,0.15354330708661418,Yes,0.8464566929133859
57069,57069,99.00,237,46,283,0.8374558303886925,0.1625441696113074,Yes,0.8374558303886925
57070,57070,99.00,271,35,306,0.8856209150326797,0.11437908496732026,Yes,0.8856209150326797
57071,57071,99.00,17,0,17,1.0,0.0,Yes,1.0
57072,57072,99.00,199,36,235,0.8468085106382979,0.15319148936170213,Yes,0.8468085106382979
57073,57073,99.00,19,2,21,0.9047619047619048,0.09523809523809523,Yes,0.9047619047619048
57074,57074,99.00,210,42,252,0.8333333333333334,0.16666666666666666,Yes,0.8333333333333334
57075,57075,99.00,258,48,306,0.8431372549019608,0.1568627450980392,Yes,0.8431372549019608
57076,57076,99.00,439,86,525,0.8361904761904762,0.16380952380952382,Yes,0.8361904761904762
57077,57077,99.00,106,11,117,0.905982905982906,0.09401709401709402,Yes,0.905982905982906
57078,57078,99.00,13,0,13,1.0,0.0,Yes,1.0
57079,57079,99.00,12,2,14,0.8571428571428571,0.14285714285714285,Yes,0.8571428571428571
57080,57080,99.00,354,61,415,0.8530120481927711,0.14698795180722893,Yes,0.8530120481927711
57081,57081,99.00,314,65,379,0.8284960422163589,0.17150395778364116,Yes,0.8284960422163589
57082,57082,99.00,10,3,13,0.7692307692307693,0.23076923076923078,Yes,0.7692307692307693
57083,57083,99.00,110,31,141,0.7801418439716312,0.2198581560283688,Yes,0.7801418439716312
57084,57084,99.00,305,46,351,0.8689458689458689,0.13105413105413105,Yes,0.8689458689458689
57085,57085,30.00,210,57,267,0.7865168539325843,0.21348314606741572,Yes,0.7865168539325843
57086,57086,99.00,10,3,13,0.7692307692307693,0.23076923076923078,Yes,0.7692307692307693
57087,57087,30.00,275,74,349,0.7879656160458453,0.21203438395415472,Yes,0.7879656160458453
57088,57088,30.00,17,2,19,0.8947368421052632,0.10526315789473684,Yes,0.8947368421052632
57089,57089,99.00,17,6,23,0.7391304347826086,0.2608695652173913,Yes,0.7391304347826086
57090,57090,99.00,171,53,224,0.7633928571428571,0.23660714285714285,Yes,0.7633928571428571
57091,57091,99.00,226,42,268,0.8432835820895522,0.15671641791044777,Yes,0.8432835820895522
57092,57092,99.00,156,33,189,0.8253968253968254,0.1746031746031746,Yes,0.8253968253968254
57093,57093,99.00,125,24,149,0.8389261744966443,0.1610738255033557,Yes,0.8389261744966443
57094,57094,99.00,2,0,2,1.0,0.0,Yes,1.0
57095,57095,99.00,8,1,9,0.8888888888888888,0.1111111111111111,Yes,0.8888888888888888
57096,57096,30.00,22,2,24,0.9166666666666666,0.08333333333333333,Yes,0.9166666666666666
57097,57097,99.00,1,0,1,1.0,0.0,Yes,1.0
57098,57098,99.00,5,1,6,0.8333333333333334,0.16666666666666666,Yes,0.8333333333333334
57099,57099,99.00,113,24,137,0.8248175182481752,0.17518248175182483,Yes,0.8248175182481752
57100,57100,99.00,4,3,7,0.5714285714285714,0.42857142857142855,Yes,0.5714285714285714
57101,57101,99.00,294,66,360,0.8166666666666667,0.18333333333333332,Yes,0.8166666666666667
57102,57102,99.00,189,37,226,0.8362831858407079,0.16371681415929204,Yes,0.8362831858407079
57103,57103,0.00,23,3,26,0.8846153846153846,0.11538461538461539,Yes,0.8846153846153846
57104,57104,99.00,245,47,292,0.839041095890411,0.16095890410958905,Yes,0.839041095890411
57105,57105,99.00,18,1,19,0.9473684210526315,0.05263157894736842,Yes,0.9473684210526315
57106,57106,99.00,0,0,0,0,0,n/a,0
58001,58001,99.00,83,10,93,0.8924731182795699,0.10752688172043011,Yes,0.8924731182795699
58002,58002,99.00,175,38,213,0.8215962441314554,0.1784037558685446,Yes,0.8215962441314554
58003,58003,99.00,2,0,2,1.0,0.0,Yes,1.0
58004,58004,75.00,142,37,179,0.7932960893854749,0.20670391061452514,Yes,0.7932960893854749
58005,58005,75.00,126,39,165,0.7636363636363637,0.23636363636363636,Yes,0.7636363636363637
58006,58006,75.00,1,0,1,1.0,0.0,Yes,1.0
58007,58007,75.00,0,0,0,0,0,n/a,0
58008,58008,99.00,133,42,175,0.76,0.24,Yes,0.76
58009,58009,99.00,104,51,155,0.6709677419354839,0.32903225806451614,Yes,0.6709677419354839
58010,58010,99.00,5,0,5,1.0,0.0,Yes,1.0
58011,58011,99.00,187,33,220,0.85,0.15,Yes,0.85
58012,58012,99.00,116,34,150,0.7733333333333333,0.22666666666666666,Yes,0.7733333333333333
58013,58013,99.00,3,2,5,0.6,0.4,Yes,0.6
58014,58014,99.00,3,0,3,1.0,0.0,Yes,1.0
58015,58015,99.00,138,31,169,0.8165680473372781,0.1834319526627219,Yes,0.8165680473372781
58016,58016,99.00,68,15,83,0.8192771084337349,0.18072289156626506,Yes,0.8192771084337349
58017,58017,99.00,4,2,6,0.6666666666666666,0.3333333333333333,Yes,0.6666666666666666
58018,58018,99.00,104,34,138,0.7536231884057971,0.2463768115942029,Yes,0.7536231884057971
58019,58019,99.00,166,42,208,0.7980769230769231,0.20192307692307693,Yes,0.7980769230769231
58020,58020,99.00,201,48,249,0.8072289156626506,0.1927710843373494,Yes,0.8072289156626506
58021,58021,99.00,122,36,158,0.7721518987341772,0.22784810126582278,Yes,0.7721518987341772
58022,58022,99.00,4,0,4,1.0,0.0,Yes,1.0
58023,58023,0.00,7,1,8,0.875,0.125,Yes,0.875
58024,58024,99.00,8,0,8,1.0,0.0,Yes,1.0
58025,58025,99.00,140,27,167,0.8383233532934131,0.16167664670658682,Yes,0.8383233532934131
58026,58026,99.00,205,49,254,0.8070866141732284,0.19291338582677164,Yes,0.8070866141732284
58027,58027,99.00,113,35,148,0.7635135135135135,0.23648648648648649,Yes,0.7635135135135135
58028,58028,99.00,192,44,236,0.8135593220338984,0.1864406779661017,Yes,0.8135593220338984
58029,58029,99.00,7,1,8,0.875,0.125,Yes,0.875
58030,58030,99.00,132,51,183,0.7213114754098361,0.2786885245901639,Yes,0.7213114754098361
58031,58031,99.00,173,68,241,0.7178423236514523,0.2821576763485477,Yes,0.7178423236514523
58032,58032,99.00,3,1,4,0.75,0.25,Yes,0.75
58033,58033,0.00,5,3,8,0.625,0.375,Yes,0.625
58034,58034,0.00,9,0,9,1.0,0.0,Yes,1.0
58035,58035,0.00,4,2,6,0.6666666666666666,0.3333333333333333,Yes,0.6666666666666666
58036,58036,99.00,4,2,6,0.6666666666666666,0.3333333333333333,Yes,0.6666666666666666
58037,58037,99.00,7,2,9,0.7777777777777778,0.2222222222222222,Yes,0.7777777777777778
58038,58038,99.00,170,49,219,0.776255707762557,0.2237442922374429,Yes,0.776255707762557
58039,58039,37.50,203,55,258,0.7868217054263565,0.2131782945736434,Yes,0.7868217054263565
58040,58040,99.00,3,0,3,1.0,0.0,Yes,1.0
58041,58041,37.50,142,38,180,0.7888888888888889,0.2111111111111111,Yes,0.7888888888888889
58042,58042,37.50,10,0,10,1.0,0.0,Yes,1.0
58043,58043,99.00,184,56,240,0.7666666666666667,0.23333333333333334,Yes,0.7666666666666667
58044,58044,99.00,1,0,1,1.0,0.0,Yes,1.0
58045,58045,99.00,135,43,178,0.7584269662921348,0.24157303370786518,Yes,0.7584269662921348
58046,58046,99.00,207,40,247,0.8380566801619433,0.16194331983805668,Yes,0.8380566801619433
58047,58047,0.00,4,2,6,0.6666666666666666,0.3333333333333333,Yes,0.6666666666666666
58048,58048,0.00,5,0,5,1.0,0.0,Yes,1.0
58049,58049,37.50,21,2,23,0.9130434782608695,0.08695652173913043,Yes,0.9130434782608695
58050,58050,99.00,5,2,7,0.7142857142857143,0.2857142857142857,Yes,0.7142857142857143
58051,58051,99.00,71,17,88,0.8068181818181818,0.19318181818181818,Yes,0.8068181818181818
58052,58052,99.00,101,18,119,0.8487394957983193,0.15126050420168066,Yes,0.8487394957983193
58053,58053,99.00,2,1,3,0.6666666666666666,0.3333333333333333,Yes,0.6666666666666666
58054,58054,99.00,162,23,185,0.8756756756756757,0.12432432432432433,Yes,0.8756756756756757
58055,58055,99.00,122,23,145,0.8413793103448276,0.15862068965517243,Yes,0.8413793103448276
58056,58056,99.00,3,0,3,1.0,0.0,Yes,1.0
58057,58057,50.00,78,23,101,0.7722772277227723,0.22772277227722773,Yes,0.7722772277227723
58058,58058,99.00,5,4,9,0.5555555555555556,0.4444444444444444,Yes,0.5555555555555556
58059,58059,99.00,138,48,186,0.7419354838709677,0.25806451612903225,Yes,0.7419354838709677
58060,58060,99.00,5,4,9,0.5555555555555556,0.4444444444444444,Yes,0.5555555555555556
58061,58061,99.00,108,28,136,0.7941176470588235,0.20588235294117646,Yes,0.7941176470588235
58062,58062,99.00,149,34,183,0.8142076502732241,0.18579234972677597,Yes,0.8142076502732241
58063,58063,99.00,3,0,3,1.0,0.0,Yes,1.0
58064,58064,99.00,133,40,173,0.7687861271676301,0.23121387283236994,Yes,0.7687861271676301
58065,58065,99.00,161,49,210,0.7666666666666667,0.23333333333333334,Yes,0.7666666666666667
58066,58066,99.00,105,19,124,0.8467741935483871,0.1532258064516129,Yes,0.8467741935483871
58067,58067,99.00,191,46,237,0.8059071729957806,0.1940928270042194,Yes,0.8059071729957806
58068,58068,99.00,147,35,182,0.8076923076923077,0.19230769230769232,Yes,0.8076923076923077
58069,58069,99.00,0,0,0,0,0,n/a,0
58070,58070,99.00,79,18,97,0.8144329896907216,0.18556701030927836,Yes,0.8144329896907216
58071,58071,99.00,107,20,127,0.84251968503937,0.15748031496062992,Yes,0.84251968503937
58072,58072,99.00,44,17,61,0.7213114754098361,0.2786885245901639,Yes,0.7213114754098361
58073,58073,99.00,32,7,39,0.8205128205128205,0.1794871794871795,Yes,0.8205128205128205
58074,58074,99.00,4,0,4,1.0,0.0,Yes,1.0
58075,58075,99.00,91,25,116,0.7844827586206896,0.21551724137931033,Yes,0.7844827586206896
58076,58076,99.00,98,25,123,0.7967479674796748,0.2032520325203252,Yes,0.7967479674796748
58077,58077,99.00,112,27,139,0.8057553956834532,0.19424460431654678,Yes,0.8057553956834532
58078,58078,99.00,214,47,261,0.8199233716475096,0.18007662835249041,Yes,0.8199233716475096
58079,58079,99.00,119,22,141,0.8439716312056738,0.15602836879432624,Yes,0.8439716312056738
58080,58080,99.00,179,51,230,0.7782608695652173,0.2217391304347826,Yes,0.7782608695652173
58081,58081,99.00,5,0,5,1.0,0.0,Yes,1.0
58082,58082,99.00,8,0,8,1.0,0.0,Yes,1.0
58083,58083,99.00,7,1,8,0.875,0.125,Yes,0.875
58084,58084,75.00,105,13,118,0.8898305084745762,0.11016949152542373,Yes,0.8898305084745762
58085,58085,99.00,2,0,2,1.0,0.0,Yes,1.0
58086,58086,0.00,6,2,8,0.75,0.25,Yes,0.75
59001,59001,99.00,1,2,3,0.3333333333333333,0.6666666666666666,No,0.6666666666666666
59002,59002,99.00,1,1,2,0.5,0.5,Tie,0.5
59003,59003,99.00,85,17,102,0.8333333333333334,0.16666666666666666,Yes,0.8333333333333334
59004,59004,99.00,107,31,138,0.7753623188405797,0.2246376811594203,Yes,0.7753623188405797
59005,59005,50.00,71,22,93,0.7634408602150538,0.23655913978494625,Yes,0.7634408602150538
59006,59006,50.00,129,30,159,0.8113207547169812,0.18867924528301888,Yes,0.8113207547169812
59007,59007,99.00,8,5,13,0.6153846153846154,0.38461538461538464,Yes,0.6153846153846154
59008,59008,99.00,164,43,207,0.7922705314009661,0.20772946859903382,Yes,0.7922705314009661
59009,59009,99.00,0,4,4,0.0,1.0,No,1.0
59010,59010,99.00,100,37,137,0.7299270072992701,0.27007299270072993,Yes,0.7299270072992701
59011,59011,99.00,132,37,169,0.7810650887573964,0.21893491124260356,Yes,0.7810650887573964
59012,59012,99.00,117,47,164,0.7134146341463414,0.2865853658536585,Yes,0.7134146341463414
59013,59013,50.00,111,27,138,0.8043478260869565,0.1956521739130435,Yes,0.8043478260869565
59014,59014,50.00,101,16,117,0.8632478632478633,0.13675213675213677,Yes,0.8632478632478633
59015,59015,50.00,97,11,108,0.8981481481481481,0.10185185185185185,Yes,0.8981481481481481
59016,59016,99.00,254,63,317,0.8012618296529969,0.19873817034700317,Yes,0.8012618296529969
59017,59017,99.00,99,28,127,0.7795275590551181,0.2204724409448819,Yes,0.7795275590551181
59018,59018,99.00,138,64,202,0.6831683168316832,0.31683168316831684,Yes,0.6831683168316832
59019,59019,99.00,3,3,6,0.5,0.5,Tie,0.5
59020,59020,99.00,137,40,177,0.7740112994350282,0.22598870056497175,Yes,0.7740112994350282
59021,59021,99.00,105,43,148,0.7094594594594594,0.2905405405405405,Yes,0.7094594594594594
59022,59022,99.00,119,38,157,0.7579617834394905,0.24203821656050956,Yes,0.7579617834394905
59023,59023,99.00,69,50,119,0.5798319327731093,0.42016806722689076,Yes,0.5798319327731093
59024,59024,99.00,82,37,119,0.6890756302521008,0.31092436974789917,Yes,0.6890756302521008
59025,59025,50.00,193,53,246,0.7845528455284553,0.21544715447154472,Yes,0.7845528455284553
59026,59026,99.00,96,39,135,0.7111111111111111,0.28888888888888886,Yes,0.7111111111111111
59027,59027,99.00,199,66,265,0.7509433962264151,0.2490566037735849,Yes,0.7509433962264151
59028,59028,99.00,128,104,232,0.5517241379310345,0.4482758620689655,Yes,0.5517241379310345
59029,59029,99.00,85,48,133,0.6390977443609023,0.3609022556390977,Yes,0.6390977443609023
59030,59030,99.00,5,1,6,0.8333333333333334,0.16666666666666666,Yes,0.8333333333333334
59031,59031,99.00,2,6,8,0.25,0.75,No,0.75
59032,59032,99.00,1,1,2,0.5,0.5,Tie,0.5
59033,59033,99.00,127,206,333,0.3813813813813814,0.6186186186186187,No,0.6186186186186187
59034,59034,99.00,2,4,6,0.3333333333333333,0.6666666666666666,No,0.6666666666666666
59035,59035,99.00,100,131,231,0.4329004329004329,0.5670995670995671,No,0.5670995670995671
59036,59036,99.00,102,121,223,0.45739910313901344,0.5426008968609866,No,0.5426008968609866
59037,59037,99.00,84,95,179,0.4692737430167598,0.5307262569832403,No,0.5307262569832403
59038,59038,99.00,96,173,269,0.35687732342007433,0.6431226765799256,No,0.6431226765799256
59039,59039,99.00,86,124,210,0.4095238095238095,0.5904761904761905,No,0.5904761904761905
59040,59040,99.00,93,112,205,0.45365853658536587,0.5463414634146342,No,0.5463414634146342
59041,59041,99.00,133,38,171,0.7777777777777778,0.2222222222222222,Yes,0.7777777777777778
59042,59042,99.00,112,215,327,0.3425076452599388,0.6574923547400612,No,0.6574923547400612
59043,59043,99.00,4,1,5,0.8,0.2,Yes,0.8
59044,59044,99.00,105,243,348,0.3017241379310345,0.6982758620689655,No,0.6982758620689655
59045,59045,99.00,3,4,7,0.42857142857142855,0.5714285714285714,No,0.5714285714285714
59046,59046,99.00,0,0,0,0,0,n/a,0
59047,59047,99.00,11,4,15,0.7333333333333333,0.26666666666666666,Yes,0.7333333333333333
59048,59048,99.00,0,0,0,0,0,n/a,0
59049,59049,99.00,7,0,7,1.0,0.0,Yes,1.0
59050,59050,99.00,99,43,142,0.6971830985915493,0.3028169014084507,Yes,0.6971830985915493
59051,59051,99.00,82,89,171,0.47953216374269003,0.52046783625731,No,0.52046783625731
59052,59052,99.00,52,68,120,0.43333333333333335,0.5666666666666667,No,0.5666666666666667
59053,59053,99.00,30,66,96,0.3125,0.6875,No,0.6875
59054,59054,99.00,62,54,116,0.5344827586206896,0.46551724137931033,Yes,0.5344827586206896
59055,59055,99.00,112,83,195,0.5743589743589743,0.4256410256410256,Yes,0.5743589743589743
59056,59056,99.00,91,27,118,0.7711864406779662,0.2288135593220339,Yes,0.7711864406779662
59057,59057,99.00,115,74,189,0.6084656084656085,0.3915343915343915,Yes,0.6084656084656085
59058,59058,99.00,56,34,90,0.6222222222222222,0.37777777777777777,Yes,0.6222222222222222
59059,59059,99.00,56,69,125,0.448,0.552,No,0.552
59060,59060,99.00,1,6,7,0.14285714285714285,0.8571428571428571,No,0.8571428571428571
59061,59061,99.00,89,130,219,0.4063926940639269,0.593607305936073,No,0.593607305936073
59062,59062,99.00,1,1,2,0.5,0.5,Tie,0.5
59063,59063,99.00,124,36,160,0.775,0.225,Yes,0.775
59064,59064,99.00,12,3,15,0.8,0.2,Yes,0.8
59065,59065,99.00,15,2,17,0.8823529411764706,0.11764705882352941,Yes,0.8823529411764706
59066,59066,99.00,185,34,219,0.8447488584474886,0.1552511415525114,Yes,0.8447488584474886
59067,59067,85.71,14,1,15,0.9333333333333333,0.06666666666666667,Yes,0.9333333333333333
59068,59068,85.71,4,0,4,1.0,0.0,Yes,1.0
59069,59069,85.71,6,3,9,0.6666666666666666,0.3333333333333333,Yes,0.6666666666666666
59070,59070,85.71,146,38,184,0.7934782608695652,0.20652173913043478,Yes,0.7934782608695652
59071,59071,99.00,132,41,173,0.7630057803468208,0.23699421965317918,Yes,0.7630057803468208
59072,59072,99.00,157,84,241,0.6514522821576764,0.34854771784232363,Yes,0.6514522821576764
59073,59073,85.71,172,29,201,0.8557213930348259,0.14427860696517414,Yes,0.8557213930348259
59074,59074,85.71,93,18,111,0.8378378378378378,0.16216216216216217,Yes,0.8378378378378378
59075,59075,85.71,175,45,220,0.7954545454545454,0.20454545454545456,Yes,0.7954545454545454
59076,59076,99.00,6,0,6,1.0,0.0,Yes,1.0
59077,59077,99.00,7,1,8,0.875,0.125,Yes,0.875
59078,59078,99.00,4,0,4,1.0,0.0,Yes,1.0
59079,59079,99.00,11,1,12,0.9166666666666666,0.08333333333333333,Yes,0.9166666666666666
59080,59080,99.00,7,0,7,1.0,0.0,Yes,1.0
59081,59081,85.71,6,1,7,0.8571428571428571,0.14285714285714285,Yes,0.8571428571428571
59082,59082,99.00,3,5,8,0.375,0.625,No,0.625
59083,59083,99.00,59,44,103,0.5728155339805825,0.42718446601941745,Yes,0.5728155339805825
59084,59084,85.71,140,42,182,0.7692307692307693,0.23076923076923078,Yes,0.7692307692307693
59085,59085,50.00,16,2,18,0.8888888888888888,0.1111111111111111,Yes,0.8888888888888888
59086,59086,99.00,0,0,0,0,0,n/a,0
59087,59087,99.00,0,0,0,0,0,n/a,0
59088,59088,99.00,0,0,0,0,0,n/a,0
59089,59089,99.00,0,0,0,0,0,n/a,0
59090,59090,99.00,0,0,0,0,0,n/a,0
60001,60001,99.00,41,11,52,0.7884615384615384,0.21153846153846154,Yes,0.7884615384615384
60002,60002,99.00,103,23,126,0.8174603174603174,0.18253968253968253,Yes,0.8174603174603174
60003,60003,99.00,71,30,101,0.7029702970297029,0.297029702970297,Yes,0.7029702970297029
60004,60004,99.00,4,0,4,1.0,0.0,Yes,1.0
60005,60005,99.00,152,50,202,0.7524752475247525,0.24752475247524752,Yes,0.7524752475247525
60006,60006,99.00,25,9,34,0.7352941176470589,0.2647058823529412,Yes,0.7352941176470589
60007,60007,99.00,106,29,135,0.7851851851851852,0.21481481481481482,Yes,0.7851851851851852
60008,60008,99.00,117,25,142,0.823943661971831,0.176056338028169,Yes,0.823943661971831
60009,60009,99.00,119,30,149,0.7986577181208053,0.20134228187919462,Yes,0.7986577181208053
60010,60010,99.00,67,25,92,0.7282608695652174,0.2717391304347826,Yes,0.7282608695652174
60011,60011,99.00,0,0,0,0,0,n/a,0
60012,60012,99.00,5,0,5,1.0,0.0,Yes,1.0
60013,60013,99.00,80,33,113,0.7079646017699115,0.2920353982300885,Yes,0.7079646017699115
60014,60014,99.00,130,28,158,0.8227848101265823,0.17721518987341772,Yes,0.8227848101265823
60015,60015,66.67,53,11,64,0.828125,0.171875,Yes,0.828125
60016,60016,99.00,0,0,0,0,0,n/a,0
60017,60017,99.00,162,52,214,0.7570093457943925,0.24299065420560748,Yes,0.7570093457943925
60018,60018,66.67,1,0,1,1.0,0.0,Yes,1.0
60019,60019,66.67,1,0,1,1.0,0.0,Yes,1.0
60020,60020,99.00,0,0,0,0,0,n/a,0
60021,60021,99.00,57,18,75,0.76,0.24,Yes,0.76
60022,60022,99.00,63,16,79,0.7974683544303798,0.20253164556962025,Yes,0.7974683544303798
60023,60023,99.00,0,0,0,0,0,n/a,0
60024,60024,99.00,50,13,63,0.7936507936507936,0.20634920634920634,Yes,0.7936507936507936
60025,60025,99.00,0,0,0,0,0,n/a,0
60026,60026,99.00,158,36,194,0.8144329896907216,0.18556701030927836,Yes,0.8144329896907216
60027,60027,99.00,140,43,183,0.7650273224043715,0.23497267759562843,Yes,0.7650273224043715
60028,60028,99.00,212,37,249,0.8514056224899599,0.14859437751004015,Yes,0.8514056224899599
60029,60029,99.00,90,12,102,0.8823529411764706,0.11764705882352941,Yes,0.8823529411764706
60030,60030,99.00,4,0,4,1.0,0.0,Yes,1.0
60031,60031,66.67,48,12,60,0.8,0.2,Yes,0.8
60032,60032,99.00,73,24,97,0.7525773195876289,0.24742268041237114,Yes,0.7525773195876289
60033,60033,99.00,170,49,219,0.776255707762557,0.2237442922374429,Yes,0.776255707762557
60034,60034,99.00,94,20,114,0.8245614035087719,0.17543859649122806,Yes,0.8245614035087719
60035,60035,99.00,3,1,4,0.75,0.25,Yes,0.75
60036,60036,99.00,79,17,96,0.8229166666666666,0.17708333333333334,Yes,0.8229166666666666
60037,60037,99.00,5,0,5,1.0,0.0,Yes,1.0
60038,60038,99.00,5,5,10,0.5,0.5,Tie,0.5
60039,60039,66.67,59,14,73,0.8082191780821918,0.1917808219178082,Yes,0.8082191780821918
60040,60040,66.67,60,15,75,0.8,0.2,Yes,0.8
60041,60041,66.67,67,16,83,0.8072289156626506,0.1927710843373494,Yes,0.8072289156626506
60042,60042,99.00,79,13,92,0.8586956521739131,0.14130434782608695,Yes,0.8586956521739131
60043,60043,99.00,78,17,95,0.8210526315789474,0.17894736842105263,Yes,0.8210526315789474
60044,60044,99.00,7,3,10,0.7,0.3,Yes,0.7
60045,60045,99.00,99,38,137,0.7226277372262774,0.2773722627737226,Yes,0.7226277372262774
60046,60046,99.00,123,42,165,0.7454545454545455,0.2545454545454545,Yes,0.7454545454545455
60047,60047,99.00,100,21,121,0.8264462809917356,0.17355371900826447,Yes,0.8264462809917356
60048,60048,66.67,4,2,6,0.6666666666666666,0.3333333333333333,Yes,0.6666666666666666
60049,60049,66.67,68,27,95,0.7157894736842105,0.28421052631578947,Yes,0.7157894736842105
60050,60050,66.67,0,0,0,0,0,n/a,0
60051,60051,66.67,74,29,103,0.7184466019417476,0.2815533980582524,Yes,0.7184466019417476
60052,60052,99.00,66,20,86,0.7674418604651163,0.23255813953488372,Yes,0.7674418604651163
60053,60053,99.00,117,16,133,0.8796992481203008,0.12030075187969924,Yes,0.8796992481203008
60054,60054,99.00,123,41,164,0.75,0.25,Yes,0.75
60055,60055,99.00,171,56,227,0.7533039647577092,0.24669603524229075,Yes,0.7533039647577092
60056,60056,99.00,130,31,161,0.8074534161490683,0.19254658385093168,Yes,0.8074534161490683
60057,60057,99.00,87,28,115,0.7565217391304347,0.24347826086956523,Yes,0.7565217391304347
60058,60058,99.00,52,12,64,0.8125,0.1875,Yes,0.8125
60059,60059,99.00,4,0,4,1.0,0.0,Yes,1.0
60060,60060,99.00,94,39,133,0.706766917293233,0.2932330827067669,Yes,0.706766917293233
60061,60061,99.00,4,3,7,0.5714285714285714,0.42857142857142855,Yes,0.5714285714285714
60062,60062,99.00,98,30,128,0.765625,0.234375,Yes,0.765625
60063,60063,99.00,113,29,142,0.795774647887324,0.20422535211267606,Yes,0.795774647887324
60064,60064,99.00,4,0,4,1.0,0.0,Yes,1.0
60065,60065,99.00,126,17,143,0.8811188811188811,0.11888111888111888,Yes,0.8811188811188811
60066,60066,99.00,128,35,163,0.7852760736196319,0.2147239263803681,Yes,0.7852760736196319
60067,60067,99.00,0,0,0,0,0,n/a,0
60068,60068,99.00,3,0,3,1.0,0.0,Yes,1.0
60069,60069,99.00,2,1,3,0.6666666666666666,0.3333333333333333,Yes,0.6666666666666666
60070,60070,99.00,7,1,8,0.875,0.125,Yes,0.875
60071,60071,99.00,119,27,146,0.815068493150685,0.18493150684931506,Yes,0.815068493150685
60072,60072,99.00,142,33,175,0.8114285714285714,0.18857142857142858,Yes,0.8114285714285714
60073,60073,99.00,2,0,2,1.0,0.0,Yes,1.0
60074,60074,99.00,92,27,119,0.773109243697479,0.226890756302521,Yes,0.773109243697479
60075,60075,99.00,118,43,161,0.7329192546583851,0.2670807453416149,Yes,0.7329192546583851
60076,60076,99.00,2,0,2,1.0,0.0,Yes,1.0
60077,60077,99.00,2,3,5,0.4,0.6,No,0.6
60078,60078,99.00,171,55,226,0.7566371681415929,0.24336283185840707,Yes,0.7566371681415929
60079,60079,99.00,75,28,103,0.7281553398058253,0.27184466019417475,Yes,0.7281553398058253
60080,60080,99.00,90,33,123,0.7317073170731707,0.2682926829268293,Yes,0.7317073170731707
60081,60081,99.00,181,79,260,0.6961538461538461,0.3038461538461538,Yes,0.6961538461538461
60082,60082,99.00,207,53,260,0.7961538461538461,0.20384615384615384,Yes,0.7961538461538461
60083,60083,22.22,138,44,182,0.7582417582417582,0.24175824175824176,Yes,0.7582417582417582
60084,60084,22.22,16,2,18,0.8888888888888888,0.1111111111111111,Yes,0.8888888888888888
60085,60085,99.00,189,52,241,0.7842323651452282,0.2157676348547718,Yes,0.7842323651452282
60086,60086,22.22,210,61,271,0.7749077490774908,0.22509225092250923,Yes,0.7749077490774908
60087,60087,99.00,6,0,6,1.0,0.0,Yes,1.0
60088,60088,99.00,72,23,95,0.7578947368421053,0.24210526315789474,Yes,0.7578947368421053
60089,60089,99.00,3,0,3,1.0,0.0,Yes,1.0
60090,60090,99.00,4,0,4,1.0,0.0,Yes,1.0
60091,60091,66.67,65,22,87,0.7471264367816092,0.25287356321839083,Yes,0.7471264367816092
64001,64001,50.00,51,87,138,0.3695652173913043,0.6304347826086957,No,0.6304347826086957
64002,64002,50.00,77,126,203,0.3793103448275862,0.6206896551724138,No,0.6206896551724138
64003,64003,99.00,87,265,352,0.2471590909090909,0.7528409090909091,No,0.7528409090909091
64004,64004,99.00,3,4,7,0.42857142857142855,0.5714285714285714,No,0.5714285714285714
64005,64005,99.00,119,241,360,0.33055555555555555,0.6694444444444444,No,0.6694444444444444
64006,64006,50.00,71,148,219,0.3242009132420091,0.6757990867579908,No,0.6757990867579908
64007,64007,50.00,73,155,228,0.3201754385964912,0.6798245614035088,No,0.6798245614035088
64008,64008,99.00,5,18,23,0.21739130434782608,0.782608695652174,No,0.782608695652174
64009,64009,99.00,69,218,287,0.24041811846689895,0.759581881533101,No,0.759581881533101
64010,64010,99.00,9,0,9,1.0,0.0,Yes,1.0
64011,64011,99.00,74,172,246,0.3008130081300813,0.6991869918699187,No,0.6991869918699187
64012,64012,99.00,4,0,4,1.0,0.0,Yes,1.0
64013,64013,99.00,4,1,5,0.8,0.2,Yes,0.8
64014,64014,99.00,119,252,371,0.32075471698113206,0.6792452830188679,No,0.6792452830188679
64015,64015,99.00,6,11,17,0.35294117647058826,0.6470588235294118,No,0.6470588235294118
64016,64016,57.14,127,218,345,0.3681159420289855,0.6318840579710145,No,0.6318840579710145
64017,64017,57.14,22,19,41,0.5365853658536586,0.4634146341463415,Yes,0.5365853658536586
64018,64018,99.00,70,59,129,0.5426356589147286,0.4573643410852713,Yes,0.5426356589147286
64019,64019,57.14,46,38,84,0.5476190476190477,0.4523809523809524,Yes,0.5476190476190477
64020,64020,99.00,61,69,130,0.46923076923076923,0.5307692307692308,No,0.5307692307692308
64021,64021,99.00,56,93,149,0.37583892617449666,0.6241610738255033,No,0.6241610738255033
64022,64022,57.14,118,232,350,0.33714285714285713,0.6628571428571428,No,0.6628571428571428
64023,64023,99.00,102,206,308,0.33116883116883117,0.6688311688311688,No,0.6688311688311688
64024,64024,99.00,92,157,249,0.36947791164658633,0.6305220883534136,No,0.6305220883534136
64025,64025,99.00,60,86,146,0.410958904109589,0.589041095890411,No,0.589041095890411
64026,64026,99.00,5,3,8,0.625,0.375,Yes,0.625
64027,64027,99.00,43,91,134,0.3208955223880597,0.6791044776119403,No,0.6791044776119403
64028,64028,99.00,78,159,237,0.3291139240506329,0.6708860759493671,No,0.6708860759493671
64029,64029,99.00,10,7,17,0.5882352941176471,0.4117647058823529,Yes,0.5882352941176471
64030,64030,99.00,120,148,268,0.44776119402985076,0.5522388059701493,No,0.5522388059701493
64031,64031,99.00,6,4,10,0.6,0.4,Yes,0.6
64032,64032,99.00,107,168,275,0.3890909090909091,0.610909090909091,No,0.610909090909091
64033,64033,99.00,49,89,138,0.35507246376811596,0.644927536231884,No,0.644927536231884
64034,64034,99.00,8,4,12,0.6666666666666666,0.3333333333333333,Yes,0.6666666666666666
64035,64035,99.00,68,82,150,0.4533333333333333,0.5466666666666666,No,0.5466666666666666
64036,64036,99.00,93,155,248,0.375,0.625,No,0.625
64037,64037,99.00,92,158,250,0.368,0.632,No,0.632
64038,64038,99.00,66,81,147,0.4489795918367347,0.5510204081632653,No,0.5510204081632653
64039,64039,99.00,3,4,7,0.42857142857142855,0.5714285714285714,No,0.5714285714285714
64040,64040,99.00,70,51,121,0.5785123966942148,0.4214876033057851,Yes,0.5785123966942148
64041,64041,99.00,96,120,216,0.4444444444444444,0.5555555555555556,No,0.5555555555555556
64042,64042,99.00,58,59,117,0.49572649572649574,0.5042735042735043,No,0.5042735042735043
64043,64043,99.00,81,82,163,0.49693251533742333,0.5030674846625767,No,0.5030674846625767
64044,64044,99.00,68,44,112,0.6071428571428571,0.39285714285714285,Yes,0.6071428571428571
64045,64045,99.00,9,8,17,0.5294117647058824,0.47058823529411764,Yes,0.5294117647058824
64046,64046,99.00,15,6,21,0.7142857142857143,0.2857142857142857,Yes,0.7142857142857143
64047,64047,99.00,152,174,326,0.4662576687116564,0.5337423312883436,No,0.5337423312883436
64048,64048,99.00,60,131,191,0.31413612565445026,0.6858638743455497,No,0.6858638743455497
64049,64049,99.00,88,72,160,0.55,0.45,Yes,0.55
64050,64050,99.00,4,2,6,0.6666666666666666,0.3333333333333333,Yes,0.6666666666666666
64051,64051,99.00,149,119,268,0.5559701492537313,0.44402985074626866,Yes,0.5559701492537313
64052,64052,99.00,6,3,9,0.6666666666666666,0.3333333333333333,Yes,0.6666666666666666
64053,64053,99.00,114,107,221,0.5158371040723982,0.4841628959276018,Yes,0.5158371040723982
64054,64054,99.00,72,132,204,0.35294117647058826,0.6470588235294118,No,0.6470588235294118
64055,64055,99.00,50,109,159,0.31446540880503143,0.6855345911949685,No,0.6855345911949685
64056,64056,57.14,20,16,36,0.5555555555555556,0.4444444444444444,Yes,0.5555555555555556
64057,64057,99.00,3,2,5,0.6,0.4,Yes,0.6
64058,64058,50.00,44,118,162,0.2716049382716049,0.7283950617283951,No,0.7283950617283951
64059,64059,99.00,45,76,121,0.371900826446281,0.628099173553719,No,0.628099173553719
64060,64060,99.00,6,4,10,0.6,0.4,Yes,0.6
64061,64061,99.00,2,6,8,0.25,0.75,No,0.75
64062,64062,99.00,70,85,155,0.45161290322580644,0.5483870967741935,No,0.5483870967741935
64063,64063,99.00,79,62,141,0.5602836879432624,0.4397163120567376,Yes,0.5602836879432624
64064,64064,99.00,0,0,0,0,0,n/a,0
64065,64065,99.00,0,0,0,0,0,n/a,0
64066,64066,99.00,0,0,0,0,0,n/a,0
64067,64067,99.00,0,0,0,0,0,n/a,0
64068,64068,99.00,0,0,0,0,0,n/a,0
64069,64069,99.00,0,0,0,0,0,n/a,0
64070,64070,99.00,0,0,0,0,0,n/a,0
64075,64075,99.00,116,76,192,0.6041666666666666,0.3958333333333333,Yes,0.6041666666666666
64076,64076,99.00,118,62,180,0.6555555555555556,0.34444444444444444,Yes,0.6555555555555556
64077,64077,99.00,145,74,219,0.6621004566210046,0.3378995433789954,Yes,0.6621004566210046
64078,64078,99.00,10,3,13,0.7692307692307693,0.23076923076923078,Yes,0.7692307692307693
64079,64079,99.00,215,119,334,0.6437125748502994,0.3562874251497006,Yes,0.6437125748502994
64080,64080,99.00,140,59,199,0.7035175879396985,0.2964824120603015,Yes,0.7035175879396985
64081,64081,99.00,3,1,4,0.75,0.25,Yes,0.75
64082,64082,99.00,1,0,1,1.0,0.0,Yes,1.0
64083,64083,99.00,122,87,209,0.583732057416268,0.41626794258373206,Yes,0.583732057416268
64084,64084,99.00,127,87,214,0.5934579439252337,0.40654205607476634,Yes,0.5934579439252337
64085,64085,99.00,16,2,18,0.8888888888888888,0.1111111111111111,Yes,0.8888888888888888
64086,64086,99.00,114,70,184,0.6195652173913043,0.3804347826086957,Yes,0.6195652173913043
64087,64087,99.00,144,37,181,0.7955801104972375,0.20441988950276244,Yes,0.7955801104972375
64088,64088,99.00,121,60,181,0.6685082872928176,0.3314917127071823,Yes,0.6685082872928176
64089,64089,33.33,109,128,237,0.459915611814346,0.540084388185654,No,0.540084388185654
64090,64090,0.00,14,3,17,0.8235294117647058,0.17647058823529413,Yes,0.8235294117647058
64091,64091,33.33,19,1,20,0.95,0.05,Yes,0.95
64092,64092,99.00,170,78,248,0.6854838709677419,0.31451612903225806,Yes,0.6854838709677419
64093,64093,99.00,148,74,222,0.6666666666666666,0.3333333333333333,Yes,0.6666666666666666
64094,64094,99.00,0,0,0,0,0,n/a,0
64095,64095,99.00,0,0,0,0,0,n/a,0
64096,64096,33.33,0,0,0,0,0,n/a,0
64097,64097,99.00,0,0,0,0,0,n/a,0
64098,64098,33.33,0,0,0,0,0,n/a,0
64099,64099,33.33,0,0,0,0,0,n/a,0
23001,23001,99.00,69,304,373,0.18498659517426275,0.8150134048257373,No,0.8150134048257373
23002,23002,99.00,76,335,411,0.18491484184914841,0.8150851581508516,No,0.8150851581508516
23003,23003,99.00,83,334,417,0.19904076738609114,0.8009592326139089,No,0.8009592326139089
23004,23004,99.00,1,2,3,0.3333333333333333,0.6666666666666666,No,0.6666666666666666
23005,23005,99.00,107,139,246,0.4349593495934959,0.5650406504065041,No,0.5650406504065041
23006,23006,99.00,199,333,532,0.37406015037593987,0.6259398496240601,No,0.6259398496240601
23007,23007,99.00,7,14,21,0.3333333333333333,0.6666666666666666,No,0.6666666666666666
23008,23008,99.00,211,375,586,0.36006825938566556,0.6399317406143344,No,0.6399317406143344
23009,23009,99.00,10,16,26,0.38461538461538464,0.6153846153846154,No,0.6153846153846154
23010,23010,99.00,165,312,477,0.34591194968553457,0.6540880503144654,No,0.6540880503144654
23011,23011,99.00,126,141,267,0.47191011235955055,0.5280898876404494,No,0.5280898876404494
23012,23012,99.00,92,85,177,0.519774011299435,0.480225988700565,Yes,0.519774011299435
23013,23013,99.00,114,123,237,0.4810126582278481,0.5189873417721519,No,0.5189873417721519
23014,23014,99.00,122,162,284,0.4295774647887324,0.5704225352112676,No,0.5704225352112676
23015,23015,99.00,155,72,227,0.6828193832599119,0.31718061674008813,Yes,0.6828193832599119
23016,23016,99.00,128,64,192,0.6666666666666666,0.3333333333333333,Yes,0.6666666666666666
23017,23017,99.00,185,88,273,0.6776556776556777,0.32234432234432236,Yes,0.6776556776556777
23018,23018,99.00,81,21,102,0.7941176470588235,0.20588235294117646,Yes,0.7941176470588235
23019,23019,99.00,153,76,229,0.6681222707423581,0.3318777292576419,Yes,0.6681222707423581
23020,23020,99.00,0,0,0,0,0,n/a,0
23021,23021,99.00,38,13,51,0.7450980392156863,0.2549019607843137,Yes,0.7450980392156863
23022,23022,99.00,0,0,0,0,0,n/a,0
23023,23023,99.00,127,55,182,0.6978021978021978,0.3021978021978022,Yes,0.6978021978021978
23024,23024,99.00,6,0,6,1.0,0.0,Yes,1.0
23025,23025,99.00,48,87,135,0.35555555555555557,0.6444444444444445,No,0.6444444444444445
23026,23026,99.00,90,34,124,0.7258064516129032,0.27419354838709675,Yes,0.7258064516129032
23027,23027,99.00,49,225,274,0.17883211678832117,0.8211678832116789,No,0.8211678832116789
23028,23028,99.00,30,133,163,0.18404907975460122,0.8159509202453987,No,0.8159509202453987
23029,23029,99.00,88,72,160,0.55,0.45,Yes,0.55
23030,23030,99.00,1,5,6,0.16666666666666666,0.8333333333333334,No,0.8333333333333334
23031,23031,99.00,90,203,293,0.30716723549488056,0.6928327645051194,No,0.6928327645051194
23032,23032,99.00,5,2,7,0.7142857142857143,0.2857142857142857,Yes,0.7142857142857143
23033,23033,99.00,159,60,219,0.726027397260274,0.273972602739726,Yes,0.726027397260274
23034,23034,99.00,63,21,84,0.75,0.25,Yes,0.75
23035,23035,99.00,3,4,7,0.42857142857142855,0.5714285714285714,No,0.5714285714285714
23036,23036,99.00,71,98,169,0.42011834319526625,0.5798816568047337,No,0.5798816568047337
23037,23037,99.00,136,120,256,0.53125,0.46875,Yes,0.53125
23038,23038,99.00,67,21,88,0.7613636363636364,0.23863636363636365,Yes,0.7613636363636364
23039,23039,99.00,2,4,6,0.3333333333333333,0.6666666666666666,No,0.6666666666666666
23040,23040,99.00,107,295,402,0.26616915422885573,0.7338308457711443,No,0.7338308457711443
23041,23041,99.00,2,9,11,0.18181818181818182,0.8181818181818182,No,0.8181818181818182
23042,23042,99.00,107,29,136,0.7867647058823529,0.21323529411764705,Yes,0.7867647058823529
23043,23043,99.00,48,20,68,0.7058823529411765,0.29411764705882354,Yes,0.7058823529411765
23044,23044,99.00,101,193,294,0.3435374149659864,0.6564625850340136,No,0.6564625850340136
23045,23045,99.00,118,223,341,0.3460410557184751,0.6539589442815249,No,0.6539589442815249
23046,23046,99.00,6,0,6,1.0,0.0,Yes,1.0
23047,23047,99.00,77,174,251,0.30677290836653387,0.6932270916334662,No,0.6932270916334662
23048,23048,99.00,1,2,3,0.3333333333333333,0.6666666666666666,No,0.6666666666666666
23049,23049,99.00,82,148,230,0.3565217391304348,0.6434782608695652,No,0.6434782608695652
23050,23050,99.00,73,118,191,0.38219895287958117,0.6178010471204188,No,0.6178010471204188
23051,23051,99.00,69,148,217,0.31797235023041476,0.6820276497695853,No,0.6820276497695853
23052,23052,99.00,76,113,189,0.4021164021164021,0.5978835978835979,No,0.5978835978835979
23053,23053,99.00,88,75,163,0.5398773006134969,0.4601226993865031,Yes,0.5398773006134969
23054,23054,99.00,85,57,142,0.5985915492957746,0.4014084507042254,Yes,0.5985915492957746
23055,23055,99.00,55,42,97,0.5670103092783505,0.4329896907216495,Yes,0.5670103092783505
23056,23056,99.00,54,39,93,0.5806451612903226,0.41935483870967744,Yes,0.5806451612903226
23057,23057,99.00,65,45,110,0.5909090909090909,0.4090909090909091,Yes,0.5909090909090909
23058,23058,99.00,80,51,131,0.6106870229007634,0.3893129770992366,Yes,0.6106870229007634
23059,23059,99.00,53,36,89,0.5955056179775281,0.4044943820224719,Yes,0.5955056179775281
23060,23060,99.00,108,69,177,0.6101694915254238,0.3898305084745763,Yes,0.6101694915254238
23061,23061,99.00,173,103,276,0.6268115942028986,0.37318840579710144,Yes,0.6268115942028986
23062,23062,99.00,207,163,370,0.5594594594594594,0.44054054054054054,Yes,0.5594594594594594
23063,23063,99.00,5,1,6,0.8333333333333334,0.16666666666666666,Yes,0.8333333333333334
23064,23064,99.00,157,149,306,0.5130718954248366,0.4869281045751634,Yes,0.5130718954248366
23065,23065,99.00,79,59,138,0.572463768115942,0.427536231884058,Yes,0.572463768115942
23066,23066,99.00,2,0,2,1.0,0.0,Yes,1.0
23067,23067,99.00,94,24,118,0.7966101694915254,0.2033898305084746,Yes,0.7966101694915254
23068,23068,99.00,0,0,0,0,0,n/a,0
23069,23069,99.00,1,2,3,0.3333333333333333,0.6666666666666666,No,0.6666666666666666
23070,23070,99.00,55,28,83,0.6626506024096386,0.3373493975903614,Yes,0.6626506024096386
23071,23071,99.00,0,0,0,0,0,n/a,0
23072,23072,99.00,0,0,0,0,0,n/a,0
23073,23073,99.00,0,0,0,0,0,n/a,0
23074,23074,99.00,0,0,0,0,0,n/a,0
23075,23075,99.00,0,0,0,0,0,n/a,0
23076,23076,99.00,0,0,0,0,0,n/a,0
23077,23077,99.00,0,0,0,0,0,n/a,0
23078,23078,99.00,0,0,0,0,0,n/a,0
23079,23079,99.00,0,0,0,0,0,n/a,0
23080,23080,99.00,0,0,0,0,0,n/a,0
23081,23081,99.00,0,0,0,0,0,n/a,0
23082,23082,99.00,0,0,0,0,0,n/a,0
23083,23083,99.00,0,0,0,0,0,n/a,0
23084,23084,99.00,3,0,3,1.0,0.0,Yes,1.0
23085,23085,99.00,10,5,15,0.6666666666666666,0.3333333333333333,Yes,0.6666666666666666
23086,23086,99.00,12,5,17,0.7058823529411765,0.29411764705882354,Yes,0.7058823529411765
23087,23087,99.00,11,4,15,0.7333333333333333,0.26666666666666666,Yes,0.7333333333333333
23088,23088,99.00,3,3,6,0.5,0.5,Tie,0.5
23089,23089,99.00,5,1,6,0.8333333333333334,0.16666666666666666,Yes,0.8333333333333334
23090,23090,99.00,1,0,1,1.0,0.0,Yes,1.0
23091,23091,99.00,1,0,1,1.0,0.0,Yes,1.0
23092,23092,99.00,10,11,21,0.47619047619047616,0.5238095238095238,No,0.5238095238095238
23093,23093,99.00,0,0,0,0,0,n/a,0
24001,24001,99.00,8,2,10,0.8,0.2,Yes,0.8
24002,24002,99.00,184,119,303,0.6072607260726073,0.3927392739273927,Yes,0.6072607260726073
24003,24003,99.00,169,112,281,0.6014234875444839,0.398576512455516,Yes,0.6014234875444839
24004,24004,99.00,11,3,14,0.7857142857142857,0.21428571428571427,Yes,0.7857142857142857
24005,24005,99.00,79,60,139,0.5683453237410072,0.4316546762589928,Yes,0.5683453237410072
24006,24006,99.00,132,104,236,0.559322033898305,0.4406779661016949,Yes,0.559322033898305
24007,24007,99.00,8,1,9,0.8888888888888888,0.1111111111111111,Yes,0.8888888888888888
24008,24008,99.00,23,7,30,0.7666666666666667,0.23333333333333334,Yes,0.7666666666666667
24009,24009,99.00,0,0,0,0,0,n/a,0
24010,24010,99.00,104,55,159,0.6540880503144654,0.34591194968553457,Yes,0.6540880503144654
24011,24011,99.00,2,1,3,0.6666666666666666,0.3333333333333333,Yes,0.6666666666666666
24012,24012,99.00,2,0,2,1.0,0.0,Yes,1.0
24013,24013,99.00,178,66,244,0.7295081967213115,0.27049180327868855,Yes,0.7295081967213115
24014,24014,99.00,11,3,14,0.7857142857142857,0.21428571428571427,Yes,0.7857142857142857
24015,24015,99.00,183,101,284,0.6443661971830986,0.35563380281690143,Yes,0.6443661971830986
24016,24016,99.00,131,104,235,0.5574468085106383,0.4425531914893617,Yes,0.5574468085106383
24017,24017,99.00,104,62,166,0.6265060240963856,0.37349397590361444,Yes,0.6265060240963856
24018,24018,99.00,4,1,5,0.8,0.2,Yes,0.8
24019,24019,99.00,193,156,349,0.5530085959885387,0.4469914040114613,Yes,0.5530085959885387
24020,24020,99.00,138,92,230,0.6,0.4,Yes,0.6
24021,24021,99.00,122,64,186,0.6559139784946236,0.34408602150537637,Yes,0.6559139784946236
24022,24022,99.00,8,4,12,0.6666666666666666,0.3333333333333333,Yes,0.6666666666666666
24023,24023,99.00,2,0,2,1.0,0.0,Yes,1.0
24024,24024,99.00,183,134,317,0.5772870662460567,0.4227129337539432,Yes,0.5772870662460567
24025,24025,99.00,9,0,9,1.0,0.0,Yes,1.0
24026,24026,99.00,50,8,58,0.8620689655172413,0.13793103448275862,Yes,0.8620689655172413
24027,24027,99.00,137,39,176,0.7784090909090909,0.2215909090909091,Yes,0.7784090909090909
24028,24028,99.00,177,109,286,0.6188811188811189,0.3811188811188811,Yes,0.6188811188811189
24029,24029,99.00,259,79,338,0.7662721893491125,0.23372781065088757,Yes,0.7662721893491125
24030,24030,99.00,9,2,11,0.8181818181818182,0.18181818181818182,Yes,0.8181818181818182
24031,24031,99.00,156,76,232,0.6724137931034483,0.3275862068965517,Yes,0.6724137931034483
24032,24032,99.00,0,0,0,0,0,n/a,0
24033,24033,99.00,72,75,147,0.4897959183673469,0.5102040816326531,No,0.5102040816326531
24034,24034,99.00,98,87,185,0.5297297297297298,0.4702702702702703,Yes,0.5297297297297298
24035,24035,99.00,4,0,4,1.0,0.0,Yes,1.0
24036,24036,99.00,151,44,195,0.7743589743589744,0.22564102564102564,Yes,0.7743589743589744
24037,24037,99.00,2,0,2,1.0,0.0,Yes,1.0
24038,24038,99.00,0,0,0,0,0,n/a,0
24039,24039,99.00,0,1,1,0.0,1.0,No,1.0
24040,24040,99.00,239,87,326,0.7331288343558282,0.2668711656441718,Yes,0.7331288343558282
24041,24041,99.00,145,52,197,0.7360406091370558,0.2639593908629442,Yes,0.7360406091370558
24042,24042,99.00,0,0,0,0,0,n/a,0
24043,24043,99.00,108,24,132,0.8181818181818182,0.18181818181818182,Yes,0.8181818181818182
24044,24044,99.00,55,25,80,0.6875,0.3125,Yes,0.6875
24045,24045,99.00,155,59,214,0.7242990654205608,0.2757009345794392,Yes,0.7242990654205608
24046,24046,99.00,8,4,12,0.6666666666666666,0.3333333333333333,Yes,0.6666666666666666
24047,24047,99.00,0,0,0,0,0,n/a,0
24048,24048,99.00,0,1,1,0.0,1.0,No,1.0
24049,24049,99.00,217,120,337,0.6439169139465876,0.3560830860534125,Yes,0.6439169139465876
24050,24050,99.00,6,3,9,0.6666666666666666,0.3333333333333333,Yes,0.6666666666666666
24051,24051,99.00,68,38,106,0.6415094339622641,0.3584905660377358,Yes,0.6415094339622641
24052,24052,99.00,1,2,3,0.3333333333333333,0.6666666666666666,No,0.6666666666666666
24053,24053,99.00,75,32,107,0.7009345794392523,0.29906542056074764,Yes,0.7009345794392523
24054,24054,99.00,73,20,93,0.7849462365591398,0.21505376344086022,Yes,0.7849462365591398
24055,24055,99.00,123,27,150,0.82,0.18,Yes,0.82
24056,24056,99.00,0,0,0,0,0,n/a,0
24057,24057,99.00,0,0,0,0,0,n/a,0
24058,24058,99.00,94,29,123,0.7642276422764228,0.23577235772357724,Yes,0.7642276422764228
24059,24059,99.00,92,53,145,0.6344827586206897,0.36551724137931035,Yes,0.6344827586206897
24060,24060,99.00,0,0,0,0,0,n/a,0
24061,24061,99.00,5,1,6,0.8333333333333334,0.16666666666666666,Yes,0.8333333333333334
24062,24062,99.00,0,0,0,0,0,n/a,0
24063,24063,99.00,2,0,2,1.0,0.0,Yes,1.0
24064,24064,99.00,88,33,121,0.7272727272727273,0.2727272727272727,Yes,0.7272727272727273
24065,24065,0.00,0,0,0,0,0,n/a,0
24066,24066,0.00,2,0,2,1.0,0.0,Yes,1.0
24067,24067,99.00,116,45,161,0.7204968944099379,0.2795031055900621,Yes,0.7204968944099379
24068,24068,99.00,79,38,117,0.6752136752136753,0.3247863247863248,Yes,0.6752136752136753
24069,24069,99.00,1,0,1,1.0,0.0,Yes,1.0
24070,24070,99.00,37,15,52,0.7115384615384616,0.28846153846153844,Yes,0.7115384615384616
24071,24071,99.00,74,11,85,0.8705882352941177,0.12941176470588237,Yes,0.8705882352941177
24072,24072,99.00,91,28,119,0.7647058823529411,0.23529411764705882,Yes,0.7647058823529411
24073,24073,99.00,48,24,72,0.6666666666666666,0.3333333333333333,Yes,0.6666666666666666
24074,24074,99.00,38,11,49,0.7755102040816326,0.22448979591836735,Yes,0.7755102040816326
24075,24075,99.00,88,30,118,0.7457627118644068,0.2542372881355932,Yes,0.7457627118644068
24076,24076,99.00,65,22,87,0.7471264367816092,0.25287356321839083,Yes,0.7471264367816092
24077,24077,99.00,46,23,69,0.6666666666666666,0.3333333333333333,Yes,0.6666666666666666
24078,24078,99.00,112,21,133,0.8421052631578947,0.15789473684210525,Yes,0.8421052631578947
24079,24079,99.00,60,25,85,0.7058823529411765,0.29411764705882354,Yes,0.7058823529411765
24080,24080,99.00,0,0,0,0,0,n/a,0
24081,24081,99.00,0,0,0,0,0,n/a,0
24082,24082,99.00,0,0,0,0,0,n/a,0
24083,24083,99.00,0,0,0,0,0,n/a,0
24084,24084,99.00,170,130,300,0.5666666666666667,0.43333333333333335,Yes,0.5666666666666667
24085,24085,99.00,109,46,155,0.7032258064516129,0.2967741935483871,Yes,0.7032258064516129
24086,24086,99.00,4,0,4,1.0,0.0,Yes,1.0
24087,24087,99.00,0,0,0,0,0,n/a,0
24088,24088,99.00,1,0,1,1.0,0.0,Yes,1.0
24089,24089,99.00,13,2,15,0.8666666666666667,0.13333333333333333,Yes,0.8666666666666667
24090,24090,99.00,0,0,0,0,0,n/a,0
24091,24091,99.00,98,43,141,0.6950354609929078,0.3049645390070922,Yes,0.6950354609929078
25001,25001,99.00,0,0,0,0,0,n/a,0
25002,25002,99.00,0,0,0,0,0,n/a,0
25003,25003,99.00,108,59,167,0.6467065868263473,0.3532934131736527,Yes,0.6467065868263473
25004,25004,99.00,93,33,126,0.7380952380952381,0.2619047619047619,Yes,0.7380952380952381
25005,25005,99.00,0,0,0,0,0,n/a,0
25006,25006,99.00,103,76,179,0.5754189944134078,0.4245810055865922,Yes,0.5754189944134078
25007,25007,99.00,112,127,239,0.4686192468619247,0.5313807531380753,No,0.5313807531380753
25008,25008,99.00,116,75,191,0.6073298429319371,0.39267015706806285,Yes,0.6073298429319371
25009,25009,99.00,0,0,0,0,0,n/a,0
25010,25010,99.00,0,0,0,0,0,n/a,0
25011,25011,99.00,4,4,8,0.5,0.5,Tie,0.5
25012,25012,99.00,133,163,296,0.44932432432432434,0.5506756756756757,No,0.5506756756756757
25013,25013,99.00,64,70,134,0.47761194029850745,0.5223880597014925,No,0.5223880597014925
25014,25014,99.00,3,4,7,0.42857142857142855,0.5714285714285714,No,0.5714285714285714
25015,25015,99.00,3,0,3,1.0,0.0,Yes,1.0
25016,25016,99.00,161,92,253,0.6363636363636364,0.36363636363636365,Yes,0.6363636363636364
25017,25017,99.00,176,56,232,0.7586206896551724,0.2413793103448276,Yes,0.7586206896551724
25018,25018,99.00,12,1,13,0.9230769230769231,0.07692307692307693,Yes,0.9230769230769231
25019,25019,99.00,164,77,241,0.6804979253112033,0.31950207468879666,Yes,0.6804979253112033
25020,25020,99.00,94,44,138,0.6811594202898551,0.3188405797101449,Yes,0.6811594202898551
25021,25021,99.00,79,37,116,0.6810344827586207,0.31896551724137934,Yes,0.6810344827586207
25022,25022,99.00,143,93,236,0.6059322033898306,0.3940677966101695,Yes,0.6059322033898306
25023,25023,99.00,94,70,164,0.573170731707317,0.4268292682926829,Yes,0.573170731707317
25024,25024,99.00,74,52,126,0.5873015873015873,0.4126984126984127,Yes,0.5873015873015873
25025,25025,99.00,77,43,120,0.6416666666666667,0.35833333333333334,Yes,0.6416666666666667
25026,25026,99.00,0,0,0,0,0,n/a,0
25027,25027,99.00,167,148,315,0.5301587301587302,0.46984126984126984,Yes,0.5301587301587302
25028,25028,99.00,115,94,209,0.5502392344497608,0.44976076555023925,Yes,0.5502392344497608
25029,25029,99.00,13,9,22,0.5909090909090909,0.4090909090909091,Yes,0.5909090909090909
25030,25030,99.00,153,85,238,0.6428571428571429,0.35714285714285715,Yes,0.6428571428571429
25031,25031,99.00,12,3,15,0.8,0.2,Yes,0.8
25032,25032,99.00,6,0,6,1.0,0.0,Yes,1.0
25033,25033,99.00,118,73,191,0.6178010471204188,0.38219895287958117,Yes,0.6178010471204188
25034,25034,99.00,91,68,159,0.5723270440251572,0.4276729559748428,Yes,0.5723270440251572
25035,25035,99.00,4,3,7,0.5714285714285714,0.42857142857142855,Yes,0.5714285714285714
25036,25036,99.00,85,64,149,0.5704697986577181,0.42953020134228187,Yes,0.5704697986577181
25037,25037,99.00,92,87,179,0.5139664804469274,0.4860335195530726,Yes,0.5139664804469274
25038,25038,99.00,57,52,109,0.5229357798165137,0.47706422018348627,Yes,0.5229357798165137
25039,25039,99.00,137,107,244,0.5614754098360656,0.4385245901639344,Yes,0.5614754098360656
25040,25040,99.00,117,129,246,0.47560975609756095,0.524390243902439,No,0.524390243902439
25041,25041,99.00,2,1,3,0.6666666666666666,0.3333333333333333,Yes,0.6666666666666666
25042,25042,99.00,0,4,4,0.0,1.0,No,1.0
25043,25043,99.00,102,80,182,0.5604395604395604,0.43956043956043955,Yes,0.5604395604395604
25044,25044,75.00,82,45,127,0.6456692913385826,0.3543307086614173,Yes,0.6456692913385826
25045,25045,75.00,49,30,79,0.620253164556962,0.379746835443038,Yes,0.620253164556962
25046,25046,75.00,64,23,87,0.735632183908046,0.26436781609195403,Yes,0.735632183908046
25047,25047,99.00,49,21,70,0.7,0.3,Yes,0.7
25048,25048,99.00,42,38,80,0.525,0.475,Yes,0.525
25049,25049,99.00,82,57,139,0.5899280575539568,0.41007194244604317,Yes,0.5899280575539568
25050,25050,99.00,40,26,66,0.6060606060606061,0.3939393939393939,Yes,0.6060606060606061
25051,25051,99.00,49,29,78,0.6282051282051282,0.3717948717948718,Yes,0.6282051282051282
25052,25052,99.00,106,36,142,0.7464788732394366,0.2535211267605634,Yes,0.7464788732394366
25053,25053,99.00,102,35,137,0.7445255474452555,0.25547445255474455,Yes,0.7445255474452555
25054,25054,99.00,109,51,160,0.68125,0.31875,Yes,0.68125
25055,25055,99.00,1,0,1,1.0,0.0,Yes,1.0
25056,25056,99.00,4,0,4,1.0,0.0,Yes,1.0
25057,25057,99.00,117,66,183,0.639344262295082,0.36065573770491804,Yes,0.639344262295082
25058,25058,99.00,85,54,139,0.6115107913669064,0.38848920863309355,Yes,0.6115107913669064
25059,25059,99.00,80,52,132,0.6060606060606061,0.3939393939393939,Yes,0.6060606060606061
25060,25060,99.00,0,0,0,0,0,n/a,0
25061,25061,99.00,73,48,121,0.6033057851239669,0.39669421487603307,Yes,0.6033057851239669
25062,25062,99.00,139,74,213,0.6525821596244131,0.3474178403755869,Yes,0.6525821596244131
25063,25063,99.00,102,64,166,0.6144578313253012,0.3855421686746988,Yes,0.6144578313253012
25064,25064,99.00,9,1,10,0.9,0.1,Yes,0.9
25065,25065,99.00,12,3,15,0.8,0.2,Yes,0.8
25066,25066,99.00,1,0,1,1.0,0.0,Yes,1.0
25067,25067,99.00,0,0,0,0,0,n/a,0
25068,25068,99.00,4,1,5,0.8,0.2,Yes,0.8
25069,25069,99.00,3,0,3,1.0,0.0,Yes,1.0
25070,25070,99.00,5,0,5,1.0,0.0,Yes,1.0
25071,25071,99.00,0,3,3,0.0,1.0,No,1.0
25072,25072,99.00,89,66,155,0.5741935483870968,0.4258064516129032,Yes,0.5741935483870968
25073,25073,99.00,4,3,7,0.5714285714285714,0.42857142857142855,Yes,0.5714285714285714
25074,25074,99.00,3,0,3,1.0,0.0,Yes,1.0
25075,25075,99.00,10,3,13,0.7692307692307693,0.23076923076923078,Yes,0.7692307692307693
25076,25076,99.00,3,2,5,0.6,0.4,Yes,0.6
25077,25077,99.00,1,4,5,0.2,0.8,No,0.8
25078,25078,99.00,7,4,11,0.6363636363636364,0.36363636363636365,Yes,0.6363636363636364
25079,25079,99.00,1,0,1,1.0,0.0,Yes,1.0
26001,26001,99.00,4,5,9,0.4444444444444444,0.5555555555555556,No,0.5555555555555556
26002,26002,99.00,1,3,4,0.25,0.75,No,0.75
26003,26003,99.00,160,142,302,0.5298013245033113,0.47019867549668876,Yes,0.5298013245033113
26004,26004,99.00,117,121,238,0.49159663865546216,0.5084033613445378,No,0.5084033613445378
26005,26005,99.00,2,0,2,1.0,0.0,Yes,1.0
26006,26006,99.00,121,153,274,0.4416058394160584,0.5583941605839416,No,0.5583941605839416
26007,26007,99.00,8,1,9,0.8888888888888888,0.1111111111111111,Yes,0.8888888888888888
26008,26008,99.00,121,94,215,0.5627906976744186,0.4372093023255814,Yes,0.5627906976744186
26009,26009,99.00,111,125,236,0.4703389830508475,0.5296610169491526,No,0.5296610169491526
26010,26010,99.00,150,141,291,0.5154639175257731,0.4845360824742268,Yes,0.5154639175257731
26011,26011,99.00,175,207,382,0.4581151832460733,0.5418848167539267,No,0.5418848167539267
26012,26012,99.00,13,8,21,0.6190476190476191,0.38095238095238093,Yes,0.6190476190476191
26013,26013,99.00,86,78,164,0.524390243902439,0.47560975609756095,Yes,0.524390243902439
26014,26014,99.00,71,100,171,0.4152046783625731,0.5847953216374269,No,0.5847953216374269
26015,26015,99.00,122,102,224,0.5446428571428571,0.45535714285714285,Yes,0.5446428571428571
26016,26016,99.00,120,100,220,0.5454545454545454,0.45454545454545453,Yes,0.5454545454545454
26017,26017,99.00,98,96,194,0.5051546391752577,0.4948453608247423,Yes,0.5051546391752577
26018,26018,99.00,72,106,178,0.4044943820224719,0.5955056179775281,No,0.5955056179775281
26019,26019,99.00,188,114,302,0.6225165562913907,0.37748344370860926,Yes,0.6225165562913907
26020,26020,99.00,19,15,34,0.5588235294117647,0.4411764705882353,Yes,0.5588235294117647
26021,26021,99.00,158,116,274,0.5766423357664233,0.4233576642335766,Yes,0.5766423357664233
26022,26022,99.00,168,114,282,0.5957446808510638,0.40425531914893614,Yes,0.5957446808510638
26023,26023,99.00,224,94,318,0.7044025157232704,0.29559748427672955,Yes,0.7044025157232704
26024,26024,99.00,23,11,34,0.6764705882352942,0.3235294117647059,Yes,0.6764705882352942
26025,26025,99.00,17,2,19,0.8947368421052632,0.10526315789473684,Yes,0.8947368421052632
26026,26026,99.00,191,113,304,0.6282894736842105,0.3717105263157895,Yes,0.6282894736842105
26027,26027,99.00,18,10,28,0.6428571428571429,0.35714285714285715,Yes,0.6428571428571429
26028,26028,99.00,102,105,207,0.4927536231884058,0.5072463768115942,No,0.5072463768115942
26029,26029,99.00,113,113,226,0.5,0.5,Tie,0.5
26030,26030,99.00,148,109,257,0.5758754863813229,0.42412451361867703,Yes,0.5758754863813229
26031,26031,99.00,95,107,202,0.47029702970297027,0.5297029702970297,No,0.5297029702970297
26032,26032,99.00,91,70,161,0.5652173913043478,0.43478260869565216,Yes,0.5652173913043478
26033,26033,99.00,120,80,200,0.6,0.4,Yes,0.6
26034,26034,99.00,118,95,213,0.5539906103286385,0.4460093896713615,Yes,0.5539906103286385
26035,26035,99.00,84,78,162,0.5185185185185185,0.48148148148148145,Yes,0.5185185185185185
26036,26036,99.00,2,0,2,1.0,0.0,Yes,1.0
26037,26037,99.00,189,125,314,0.6019108280254777,0.3980891719745223,Yes,0.6019108280254777
26038,26038,99.00,1,2,3,0.3333333333333333,0.6666666666666666,No,0.6666666666666666
26039,26039,99.00,122,112,234,0.5213675213675214,0.47863247863247865,Yes,0.5213675213675214
26040,26040,99.00,121,86,207,0.5845410628019324,0.41545893719806765,Yes,0.5845410628019324
26041,26041,99.00,0,0,0,0,0,n/a,0
26042,26042,99.00,7,3,10,0.7,0.3,Yes,0.7
26043,26043,99.00,3,0,3,1.0,0.0,Yes,1.0
26044,26044,99.00,3,2,5,0.6,0.4,Yes,0.6
26045,26045,99.00,129,67,196,0.6581632653061225,0.34183673469387754,Yes,0.6581632653061225
26046,26046,99.00,253,159,412,0.6140776699029126,0.3859223300970874,Yes,0.6140776699029126
26047,26047,99.00,11,9,20,0.55,0.45,Yes,0.55
26048,26048,99.00,170,132,302,0.5629139072847682,0.4370860927152318,Yes,0.5629139072847682
26049,26049,99.00,6,4,10,0.6,0.4,Yes,0.6
26050,26050,99.00,19,10,29,0.6551724137931034,0.3448275862068966,Yes,0.6551724137931034
26051,26051,99.00,3,4,7,0.42857142857142855,0.5714285714285714,No,0.5714285714285714
26052,26052,99.00,167,78,245,0.6816326530612244,0.3183673469387755,Yes,0.6816326530612244
26053,26053,99.00,160,100,260,0.6153846153846154,0.38461538461538464,Yes,0.6153846153846154
26054,26054,99.00,136,76,212,0.6415094339622641,0.3584905660377358,Yes,0.6415094339622641
26055,26055,99.00,88,63,151,0.5827814569536424,0.41721854304635764,Yes,0.5827814569536424
26056,26056,99.00,5,2,7,0.7142857142857143,0.2857142857142857,Yes,0.7142857142857143
26057,26057,99.00,11,2,13,0.8461538461538461,0.15384615384615385,Yes,0.8461538461538461
26058,26058,75.00,139,116,255,0.5450980392156862,0.4549019607843137,Yes,0.5450980392156862
26059,26059,99.00,6,5,11,0.5454545454545454,0.45454545454545453,Yes,0.5454545454545454
26060,26060,99.00,195,187,382,0.5104712041884817,0.4895287958115183,Yes,0.5104712041884817
26061,26061,75.00,77,68,145,0.5310344827586206,0.4689655172413793,Yes,0.5310344827586206
26062,26062,75.00,72,48,120,0.6,0.4,Yes,0.6
26063,26063,75.00,76,77,153,0.49673202614379086,0.5032679738562091,No,0.5032679738562091
26064,26064,75.00,17,2,19,0.8947368421052632,0.10526315789473684,Yes,0.8947368421052632
26065,26065,99.00,5,8,13,0.38461538461538464,0.6153846153846154,No,0.6153846153846154
26066,26066,99.00,155,144,299,0.5183946488294314,0.4816053511705686,Yes,0.5183946488294314
26067,26067,99.00,157,146,303,0.5181518151815182,0.48184818481848185,Yes,0.5181518151815182
26068,26068,99.00,153,146,299,0.5117056856187291,0.4882943143812709,Yes,0.5117056856187291
26069,26069,99.00,7,6,13,0.5384615384615384,0.46153846153846156,Yes,0.5384615384615384
26070,26070,99.00,167,151,318,0.5251572327044025,0.4748427672955975,Yes,0.5251572327044025
26071,26071,99.00,121,69,190,0.6368421052631579,0.3631578947368421,Yes,0.6368421052631579
26072,26072,99.00,15,9,24,0.625,0.375,Yes,0.625
26073,26073,99.00,253,101,354,0.7146892655367232,0.2853107344632768,Yes,0.7146892655367232
26074,26074,99.00,48,19,67,0.7164179104477612,0.2835820895522388,Yes,0.7164179104477612
26075,26075,99.00,148,107,255,0.5803921568627451,0.4196078431372549,Yes,0.5803921568627451
26076,26076,99.00,10,5,15,0.6666666666666666,0.3333333333333333,Yes,0.6666666666666666
26077,26077,99.00,0,0,0,0,0,n/a,0
26078,26078,99.00,0,0,0,0,0,n/a,0
26079,26079,99.00,5,1,6,0.8333333333333334,0.16666666666666666,Yes,0.8333333333333334
26080,26080,99.00,8,3,11,0.7272727272727273,0.2727272727272727,Yes,0.7272727272727273
26081,26081,99.00,7,2,9,0.7777777777777778,0.2222222222222222,Yes,0.7777777777777778
26082,26082,99.00,3,2,5,0.6,0.4,Yes,0.6
26083,26083,99.00,111,78,189,0.5873015873015873,0.4126984126984127,Yes,0.5873015873015873
26084,26084,99.00,5,2,7,0.7142857142857143,0.2857142857142857,Yes,0.7142857142857143
26085,26085,99.00,5,3,8,0.625,0.375,Yes,0.625
27001,27001,99.00,78,241,319,0.2445141065830721,0.7554858934169278,No,0.7554858934169278
27002,27002,0.00,3,0,3,1.0,0.0,Yes,1.0
27003,27003,99.00,163,68,231,0.7056277056277056,0.2943722943722944,Yes,0.7056277056277056
27004,27004,99.00,7,2,9,0.7777777777777778,0.2222222222222222,Yes,0.7777777777777778
27005,27005,0.00,11,5,16,0.6875,0.3125,Yes,0.6875
27006,27006,99.00,263,152,415,0.6337349397590362,0.36626506024096384,Yes,0.6337349397590362
27007,27007,99.00,228,72,300,0.76,0.24,Yes,0.76
27008,27008,99.00,237,72,309,0.7669902912621359,0.23300970873786409,Yes,0.7669902912621359
27009,27009,99.00,68,27,95,0.7157894736842105,0.28421052631578947,Yes,0.7157894736842105
27010,27010,99.00,0,0,0,0,0,n/a,0
27011,27011,99.00,6,1,7,0.8571428571428571,0.14285714285714285,Yes,0.8571428571428571
27012,27012,99.00,94,32,126,0.746031746031746,0.25396825396825395,Yes,0.746031746031746
27013,27013,99.00,250,75,325,0.7692307692307693,0.23076923076923078,Yes,0.7692307692307693
27014,27014,99.00,178,71,249,0.714859437751004,0.285140562248996,Yes,0.714859437751004
27015,27015,99.00,14,3,17,0.8235294117647058,0.17647058823529413,Yes,0.8235294117647058
27016,27016,99.00,31,8,39,0.7948717948717948,0.20512820512820512,Yes,0.7948717948717948
27017,27017,99.00,4,1,5,0.8,0.2,Yes,0.8
27018,27018,99.00,1,0,1,1.0,0.0,Yes,1.0
27019,27019,99.00,8,9,17,0.47058823529411764,0.5294117647058824,No,0.5294117647058824
27020,27020,99.00,238,80,318,0.7484276729559748,0.25157232704402516,Yes,0.7484276729559748
27021,27021,99.00,197,67,264,0.7462121212121212,0.2537878787878788,Yes,0.7462121212121212
27022,27022,99.00,16,6,22,0.7272727272727273,0.2727272727272727,Yes,0.7272727272727273
27023,27023,99.00,75,150,225,0.3333333333333333,0.6666666666666666,No,0.6666666666666666
27024,27024,99.00,10,4,14,0.7142857142857143,0.2857142857142857,Yes,0.7142857142857143
27025,27025,99.00,86,332,418,0.20574162679425836,0.7942583732057417,No,0.7942583732057417
27026,27026,99.00,92,186,278,0.33093525179856115,0.6690647482014388,No,0.6690647482014388
27027,27027,99.00,99,195,294,0.336734693877551,0.6632653061224489,No,0.6632653061224489
27028,27028,99.00,134,131,265,0.5056603773584906,0.49433962264150944,Yes,0.5056603773584906
27029,27029,99.00,0,0,0,0,0,n/a,0
27030,27030,99.00,85,152,237,0.35864978902953587,0.6413502109704642,No,0.6413502109704642
27031,27031,99.00,94,36,130,0.7230769230769231,0.27692307692307694,Yes,0.7230769230769231
27032,27032,99.00,0,0,0,0,0,n/a,0
27033,27033,99.00,1,0,1,1.0,0.0,Yes,1.0
27034,27034,99.00,3,2,5,0.6,0.4,Yes,0.6
27035,27035,99.00,91,32,123,0.7398373983739838,0.2601626016260163,Yes,0.7398373983739838
27036,27036,99.00,0,0,0,0,0,n/a,0
27037,27037,99.00,132,62,194,0.6804123711340206,0.31958762886597936,Yes,0.6804123711340206
27038,27038,99.00,123,75,198,0.6212121212121212,0.3787878787878788,Yes,0.6212121212121212
27039,27039,99.00,165,94,259,0.637065637065637,0.36293436293436293,Yes,0.637065637065637
27040,27040,99.00,3,0,3,1.0,0.0,Yes,1.0
27041,27041,99.00,104,30,134,0.7761194029850746,0.22388059701492538,Yes,0.7761194029850746
27042,27042,99.00,172,89,261,0.6590038314176245,0.34099616858237547,Yes,0.6590038314176245
27043,27043,99.00,3,2,5,0.6,0.4,Yes,0.6
27044,27044,99.00,5,1,6,0.8333333333333334,0.16666666666666666,Yes,0.8333333333333334
27045,27045,99.00,101,55,156,0.6474358974358975,0.3525641025641026,Yes,0.6474358974358975
27046,27046,99.00,80,47,127,0.6299212598425197,0.3700787401574803,Yes,0.6299212598425197
27047,27047,99.00,98,41,139,0.7050359712230215,0.2949640287769784,Yes,0.7050359712230215
27048,27048,99.00,0,2,2,0.0,1.0,No,1.0
27049,27049,99.00,4,2,6,0.6666666666666666,0.3333333333333333,Yes,0.6666666666666666
27050,27050,99.00,173,79,252,0.6865079365079365,0.3134920634920635,Yes,0.6865079365079365
27051,27051,99.00,78,112,190,0.4105263157894737,0.5894736842105263,No,0.5894736842105263
27052,27052,99.00,145,59,204,0.7107843137254902,0.28921568627450983,Yes,0.7107843137254902
27053,27053,99.00,100,60,160,0.625,0.375,Yes,0.625
27054,27054,99.00,99,45,144,0.6875,0.3125,Yes,0.6875
27055,27055,99.00,75,37,112,0.6696428571428571,0.33035714285714285,Yes,0.6696428571428571
27056,27056,99.00,2,0,2,1.0,0.0,Yes,1.0
27057,27057,99.00,0,2,2,0.0,1.0,No,1.0
27058,27058,99.00,0,0,0,0,0,n/a,0
27059,27059,99.00,38,65,103,0.36893203883495146,0.6310679611650486,No,0.6310679611650486
27060,27060,99.00,2,0,2,1.0,0.0,Yes,1.0
27061,27061,99.00,92,75,167,0.5508982035928144,0.4491017964071856,Yes,0.5508982035928144
27062,27062,99.00,50,38,88,0.5681818181818182,0.4318181818181818,Yes,0.5681818181818182
27063,27063,99.00,51,30,81,0.6296296296296297,0.37037037037037035,Yes,0.6296296296296297
27064,27064,99.00,59,37,96,0.6145833333333334,0.3854166666666667,Yes,0.6145833333333334
27065,27065,99.00,76,55,131,0.5801526717557252,0.4198473282442748,Yes,0.5801526717557252
27066,27066,99.00,94,92,186,0.5053763440860215,0.4946236559139785,Yes,0.5053763440860215
27067,27067,99.00,109,104,213,0.5117370892018779,0.48826291079812206,Yes,0.5117370892018779
27068,27068,99.00,73,58,131,0.5572519083969466,0.44274809160305345,Yes,0.5572519083969466
27069,27069,99.00,0,0,0,0,0,n/a,0
27070,27070,99.00,0,0,0,0,0,n/a,0
27071,27071,99.00,0,0,0,0,0,n/a,0
27072,27072,99.00,0,0,0,0,0,n/a,0
27073,27073,99.00,0,0,0,0,0,n/a,0
27074,27074,99.00,0,0,0,0,0,n/a,0
27075,27075,99.00,0,0,0,0,0,n/a,0
27076,27076,99.00,0,0,0,0,0,n/a,0
27077,27077,99.00,0,0,0,0,0,n/a,0
27078,27078,99.00,0,0,0,0,0,n/a,0
27079,27079,99.00,117,69,186,0.6290322580645161,0.3709677419354839,Yes,0.6290322580645161
27080,27080,99.00,3,2,5,0.6,0.4,Yes,0.6
27081,27081,99.00,89,48,137,0.6496350364963503,0.35036496350364965,Yes,0.6496350364963503
27082,27082,0.00,2,1,3,0.6666666666666666,0.3333333333333333,Yes,0.6666666666666666
27083,27083,0.00,15,2,17,0.8823529411764706,0.11764705882352941,Yes,0.8823529411764706
27084,27084,99.00,2,1,3,0.6666666666666666,0.3333333333333333,Yes,0.6666666666666666
27085,27085,99.00,0,2,2,0.0,1.0,No,1.0
27086,27086,99.00,118,49,167,0.7065868263473054,0.2934131736526946,Yes,0.7065868263473054
27087,27087,99.00,0,2,2,0.0,1.0,No,1.0
27088,27088,99.00,9,2,11,0.8181818181818182,0.18181818181818182,Yes,0.8181818181818182
27089,27089,99.00,0,5,5,0.0,1.0,No,1.0
28001,28001,99.00,146,67,213,0.6854460093896714,0.3145539906103286,Yes,0.6854460093896714
28002,28002,99.00,2,1,3,0.6666666666666666,0.3333333333333333,Yes,0.6666666666666666
28003,28003,99.00,145,120,265,0.5471698113207547,0.4528301886792453,Yes,0.5471698113207547
28004,28004,99.00,110,94,204,0.5392156862745098,0.46078431372549017,Yes,0.5392156862745098
28005,28005,99.00,2,1,3,0.6666666666666666,0.3333333333333333,Yes,0.6666666666666666
28006,28006,99.00,112,73,185,0.6054054054054054,0.3945945945945946,Yes,0.6054054054054054
28007,28007,99.00,4,3,7,0.5714285714285714,0.42857142857142855,Yes,0.5714285714285714
28008,28008,99.00,3,0,3,1.0,0.0,Yes,1.0
28009,28009,99.00,8,4,12,0.6666666666666666,0.3333333333333333,Yes,0.6666666666666666
28010,28010,99.00,151,86,237,0.6371308016877637,0.3628691983122363,Yes,0.6371308016877637
28011,28011,99.00,13,1,14,0.9285714285714286,0.07142857142857142,Yes,0.9285714285714286
28012,28012,99.00,30,2,32,0.9375,0.0625,Yes,0.9375
28013,28013,99.00,2,2,4,0.5,0.5,Tie,0.5
28014,28014,99.00,88,46,134,0.6567164179104478,0.34328358208955223,Yes,0.6567164179104478
28015,28015,99.00,104,103,207,0.5024154589371981,0.4975845410628019,Yes,0.5024154589371981
28016,28016,99.00,62,145,207,0.2995169082125604,0.7004830917874396,No,0.7004830917874396
28017,28017,99.00,134,170,304,0.4407894736842105,0.5592105263157895,No,0.5592105263157895
28018,28018,99.00,110,65,175,0.6285714285714286,0.37142857142857144,Yes,0.6285714285714286
28019,28019,99.00,245,119,364,0.6730769230769231,0.3269230769230769,Yes,0.6730769230769231
28020,28020,99.00,28,7,35,0.8,0.2,Yes,0.8
28021,28021,99.00,1,1,2,0.5,0.5,Tie,0.5
28022,28022,99.00,285,159,444,0.6418918918918919,0.3581081081081081,Yes,0.6418918918918919
28023,28023,99.00,316,130,446,0.7085201793721974,0.2914798206278027,Yes,0.7085201793721974
28024,28024,99.00,17,6,23,0.7391304347826086,0.2608695652173913,Yes,0.7391304347826086
28025,28025,99.00,177,79,256,0.69140625,0.30859375,Yes,0.69140625
28026,28026,99.00,175,66,241,0.7261410788381742,0.27385892116182575,Yes,0.7261410788381742
28027,28027,99.00,9,3,12,0.75,0.25,Yes,0.75
28028,28028,99.00,242,135,377,0.6419098143236074,0.35809018567639256,Yes,0.6419098143236074
28029,28029,50.00,116,24,140,0.8285714285714286,0.17142857142857143,Yes,0.8285714285714286
28030,28030,50.00,116,52,168,0.6904761904761905,0.30952380952380953,Yes,0.6904761904761905
28031,28031,99.00,209,79,288,0.7256944444444444,0.2743055555555556,Yes,0.7256944444444444
28032,28032,50.00,4,2,6,0.6666666666666666,0.3333333333333333,Yes,0.6666666666666666
28033,28033,99.00,0,0,0,0,0,n/a,0
28034,28034,99.00,4,0,4,1.0,0.0,Yes,1.0
28035,28035,99.00,228,82,310,0.7354838709677419,0.2645161290322581,Yes,0.7354838709677419
28036,28036,99.00,235,82,317,0.7413249211356467,0.2586750788643533,Yes,0.7413249211356467
28037,28037,99.00,7,2,9,0.7777777777777778,0.2222222222222222,Yes,0.7777777777777778
28038,28038,99.00,235,110,345,0.6811594202898551,0.3188405797101449,Yes,0.6811594202898551
28039,28039,99.00,15,2,17,0.8823529411764706,0.11764705882352941,Yes,0.8823529411764706
28040,28040,99.00,111,41,152,0.7302631578947368,0.26973684210526316,Yes,0.7302631578947368
28041,28041,99.00,207,94,301,0.6877076411960132,0.3122923588039867,Yes,0.6877076411960132
28042,28042,99.00,207,91,298,0.6946308724832215,0.3053691275167785,Yes,0.6946308724832215
28043,28043,99.00,149,76,225,0.6622222222222223,0.3377777777777778,Yes,0.6622222222222223
28044,28044,99.00,6,3,9,0.6666666666666666,0.3333333333333333,Yes,0.6666666666666666
28045,28045,99.00,2,4,6,0.3333333333333333,0.6666666666666666,No,0.6666666666666666
28046,28046,99.00,107,34,141,0.7588652482269503,0.24113475177304963,Yes,0.7588652482269503
28047,28047,99.00,205,87,292,0.702054794520548,0.2979452054794521,Yes,0.702054794520548
28048,28048,99.00,253,103,356,0.7106741573033708,0.2893258426966292,Yes,0.7106741573033708
28049,28049,99.00,6,3,9,0.6666666666666666,0.3333333333333333,Yes,0.6666666666666666
28050,28050,99.00,148,86,234,0.6324786324786325,0.36752136752136755,Yes,0.6324786324786325
28051,28051,99.00,154,66,220,0.7,0.3,Yes,0.7
28052,28052,99.00,1,0,1,1.0,0.0,Yes,1.0
28053,28053,99.00,5,2,7,0.7142857142857143,0.2857142857142857,Yes,0.7142857142857143
28054,28054,99.00,123,47,170,0.7235294117647059,0.27647058823529413,Yes,0.7235294117647059
28055,28055,99.00,2,0,2,1.0,0.0,Yes,1.0
28056,28056,99.00,138,44,182,0.7582417582417582,0.24175824175824176,Yes,0.7582417582417582
28057,28057,99.00,1,0,1,1.0,0.0,Yes,1.0
28058,28058,99.00,5,0,5,1.0,0.0,Yes,1.0
28059,28059,99.00,2,0,2,1.0,0.0,Yes,1.0
28060,28060,99.00,4,0,4,1.0,0.0,Yes,1.0
28061,28061,99.00,157,84,241,0.6514522821576764,0.34854771784232363,Yes,0.6514522821576764
28062,28062,99.00,169,72,241,0.7012448132780082,0.2987551867219917,Yes,0.7012448132780082
28063,28063,99.00,3,4,7,0.42857142857142855,0.5714285714285714,No,0.5714285714285714
28064,28064,99.00,131,91,222,0.5900900900900901,0.4099099099099099,Yes,0.5900900900900901
28065,28065,99.00,110,66,176,0.625,0.375,Yes,0.625
28066,28066,99.00,151,81,232,0.6508620689655172,0.34913793103448276,Yes,0.6508620689655172
28067,28067,99.00,152,80,232,0.6551724137931034,0.3448275862068966,Yes,0.6551724137931034
28068,28068,99.00,138,102,240,0.575,0.425,Yes,0.575
28069,28069,99.00,117,109,226,0.5176991150442478,0.4823008849557522,Yes,0.5176991150442478
28070,28070,99.00,102,195,297,0.3434343434343434,0.6565656565656566,No,0.6565656565656566
28071,28071,99.00,78,105,183,0.4262295081967213,0.5737704918032787,No,0.5737704918032787
28072,28072,99.00,77,92,169,0.4556213017751479,0.5443786982248521,No,0.5443786982248521
28073,28073,99.00,69,74,143,0.4825174825174825,0.5174825174825175,No,0.5174825174825175
28074,28074,99.00,4,2,6,0.6666666666666666,0.3333333333333333,Yes,0.6666666666666666
28075,28075,99.00,146,210,356,0.4101123595505618,0.5898876404494382,No,0.5898876404494382
28076,28076,99.00,79,141,220,0.35909090909090907,0.6409090909090909,No,0.6409090909090909
28077,28077,99.00,68,110,178,0.38202247191011235,0.6179775280898876,No,0.6179775280898876
28078,28078,99.00,53,41,94,0.5638297872340425,0.43617021276595747,Yes,0.5638297872340425
28079,28079,99.00,0,0,0,0,0,n/a,0
28080,28080,99.00,5,3,8,0.625,0.375,Yes,0.625
28081,28081,99.00,10,4,14,0.7142857142857143,0.2857142857142857,Yes,0.7142857142857143
28082,28082,99.00,4,1,5,0.8,0.2,Yes,0.8
28083,28083,99.00,94,69,163,0.5766871165644172,0.4233128834355828,Yes,0.5766871165644172
28084,28084,99.00,7,3,10,0.7,0.3,Yes,0.7
28085,28085,99.00,0,0,0,0,0,n/a,0
28086,28086,99.00,3,1,4,0.75,0.25,Yes,0.75
28087,28087,99.00,11,1,12,0.9166666666666666,0.08333333333333333,Yes,0.9166666666666666
28088,28088,99.00,2,0,2,1.0,0.0,Yes,1.0
28089,28089,99.00,2,0,2,1.0,0.0,Yes,1.0
29001,29001,99.00,7,3,10,0.7,0.3,Yes,0.7
29002,29002,99.00,112,33,145,0.7724137931034483,0.22758620689655173,Yes,0.7724137931034483
29003,29003,99.00,160,22,182,0.8791208791208791,0.12087912087912088,Yes,0.8791208791208791
29004,29004,99.00,101,18,119,0.8487394957983193,0.15126050420168066,Yes,0.8487394957983193
29005,29005,99.00,1,1,2,0.5,0.5,Tie,0.5
29006,29006,99.00,3,0,3,1.0,0.0,Yes,1.0
29007,29007,99.00,1,0,1,1.0,0.0,Yes,1.0
29008,29008,99.00,3,0,3,1.0,0.0,Yes,1.0
29009,29009,99.00,72,17,89,0.8089887640449438,0.19101123595505617,Yes,0.8089887640449438
29010,29010,99.00,37,16,53,0.6981132075471698,0.3018867924528302,Yes,0.6981132075471698
29011,29011,99.00,73,12,85,0.8588235294117647,0.1411764705882353,Yes,0.8588235294117647
29012,29012,99.00,80,30,110,0.7272727272727273,0.2727272727272727,Yes,0.7272727272727273
29013,29013,99.00,128,49,177,0.7231638418079096,0.2768361581920904,Yes,0.7231638418079096
29014,29014,99.00,2,0,2,1.0,0.0,Yes,1.0
29015,29015,99.00,67,12,79,0.8481012658227848,0.1518987341772152,Yes,0.8481012658227848
29016,29016,99.00,54,17,71,0.7605633802816901,0.23943661971830985,Yes,0.7605633802816901
29017,29017,99.00,120,27,147,0.8163265306122449,0.1836734693877551,Yes,0.8163265306122449
29018,29018,99.00,128,50,178,0.7191011235955056,0.2808988764044944,Yes,0.7191011235955056
29019,29019,99.00,6,2,8,0.75,0.25,Yes,0.75
29020,29020,99.00,6,2,8,0.75,0.25,Yes,0.75
29021,29021,99.00,1,1,2,0.5,0.5,Tie,0.5
29022,29022,99.00,9,1,10,0.9,0.1,Yes,0.9
29023,29023,80.00,137,50,187,0.732620320855615,0.26737967914438504,Yes,0.732620320855615
29024,29024,80.00,164,68,232,0.7068965517241379,0.29310344827586204,Yes,0.7068965517241379
29025,29025,80.00,159,49,208,0.7644230769230769,0.23557692307692307,Yes,0.7644230769230769
29026,29026,80.00,158,51,209,0.7559808612440191,0.24401913875598086,Yes,0.7559808612440191
29027,29027,0.00,8,0,8,1.0,0.0,Yes,1.0
29028,29028,0.00,11,2,13,0.8461538461538461,0.15384615384615385,Yes,0.8461538461538461
29029,29029,99.00,113,40,153,0.738562091503268,0.26143790849673204,Yes,0.738562091503268
29030,29030,99.00,156,32,188,0.8297872340425532,0.1702127659574468,Yes,0.8297872340425532
29031,29031,99.00,126,55,181,0.6961325966850829,0.30386740331491713,Yes,0.6961325966850829
29032,29032,99.00,120,46,166,0.7228915662650602,0.27710843373493976,Yes,0.7228915662650602
29033,29033,0.00,19,2,21,0.9047619047619048,0.09523809523809523,Yes,0.9047619047619048
29034,29034,0.00,9,1,10,0.9,0.1,Yes,0.9
29035,29035,99.00,98,35,133,0.7368421052631579,0.2631578947368421,Yes,0.7368421052631579
29036,29036,99.00,94,28,122,0.7704918032786885,0.22950819672131148,Yes,0.7704918032786885
29037,29037,99.00,4,3,7,0.5714285714285714,0.42857142857142855,Yes,0.5714285714285714
29038,29038,99.00,140,22,162,0.8641975308641975,0.13580246913580246,Yes,0.8641975308641975
29039,29039,99.00,3,0,3,1.0,0.0,Yes,1.0
29040,29040,99.00,7,2,9,0.7777777777777778,0.2222222222222222,Yes,0.7777777777777778
29041,29041,99.00,7,8,15,0.4666666666666667,0.5333333333333333,No,0.5333333333333333
29042,29042,99.00,150,51,201,0.746268656716418,0.2537313432835821,Yes,0.746268656716418
29043,29043,99.00,5,0,5,1.0,0.0,Yes,1.0
29044,29044,99.00,163,46,209,0.7799043062200957,0.22009569377990432,Yes,0.7799043062200957
29045,29045,99.00,214,53,267,0.8014981273408239,0.19850187265917604,Yes,0.8014981273408239
29046,29046,99.00,72,23,95,0.7578947368421053,0.24210526315789474,Yes,0.7578947368421053
29047,29047,99.00,147,55,202,0.7277227722772277,0.2722772277227723,Yes,0.7277227722772277
29048,29048,99.00,5,2,7,0.7142857142857143,0.2857142857142857,Yes,0.7142857142857143
29049,29049,99.00,150,46,196,0.7653061224489796,0.23469387755102042,Yes,0.7653061224489796
29050,29050,99.00,106,35,141,0.75177304964539,0.24822695035460993,Yes,0.75177304964539
29051,29051,99.00,233,71,304,0.7664473684210527,0.23355263157894737,Yes,0.7664473684210527
29052,29052,99.00,185,60,245,0.7551020408163265,0.24489795918367346,Yes,0.7551020408163265
29053,29053,99.00,6,0,6,1.0,0.0,Yes,1.0
29054,29054,99.00,165,53,218,0.7568807339449541,0.24311926605504589,Yes,0.7568807339449541
29055,29055,99.00,125,51,176,0.7102272727272727,0.2897727272727273,Yes,0.7102272727272727
29056,29056,99.00,86,26,112,0.7678571428571429,0.23214285714285715,Yes,0.7678571428571429
29057,29057,99.00,131,31,162,0.808641975308642,0.19135802469135801,Yes,0.808641975308642
29058,29058,99.00,115,41,156,0.7371794871794872,0.26282051282051283,Yes,0.7371794871794872
29059,29059,99.00,135,65,200,0.675,0.325,Yes,0.675
29060,29060,99.00,160,57,217,0.7373271889400922,0.2626728110599078,Yes,0.7373271889400922
29061,29061,99.00,173,35,208,0.8317307692307693,0.16826923076923078,Yes,0.8317307692307693
29062,29062,99.00,183,35,218,0.8394495412844036,0.16055045871559634,Yes,0.8394495412844036
29063,29063,99.00,169,37,206,0.8203883495145631,0.1796116504854369,Yes,0.8203883495145631
29064,29064,99.00,113,41,154,0.7337662337662337,0.2662337662337662,Yes,0.7337662337662337
29065,29065,99.00,116,41,157,0.7388535031847133,0.2611464968152866,Yes,0.7388535031847133
29066,29066,99.00,115,34,149,0.7718120805369127,0.22818791946308725,Yes,0.7718120805369127
29067,29067,99.00,119,29,148,0.8040540540540541,0.19594594594594594,Yes,0.8040540540540541
29068,29068,99.00,99,32,131,0.7557251908396947,0.24427480916030533,Yes,0.7557251908396947
29069,29069,99.00,3,1,4,0.75,0.25,Yes,0.75
29070,29070,99.00,5,2,7,0.7142857142857143,0.2857142857142857,Yes,0.7142857142857143
29071,29071,99.00,3,2,5,0.6,0.4,Yes,0.6
29072,29072,99.00,53,17,70,0.7571428571428571,0.24285714285714285,Yes,0.7571428571428571
29073,29073,99.00,2,0,2,1.0,0.0,Yes,1.0
29074,29074,99.00,7,1,8,0.875,0.125,Yes,0.875
29075,29075,0.00,4,1,5,0.8,0.2,Yes,0.8
29076,29076,99.00,107,32,139,0.7697841726618705,0.2302158273381295,Yes,0.7697841726618705
29077,29077,99.00,1,0,1,1.0,0.0,Yes,1.0
29078,29078,99.00,3,1,4,0.75,0.25,Yes,0.75
29079,29079,99.00,115,38,153,0.7516339869281046,0.24836601307189543,Yes,0.7516339869281046
29080,29080,99.00,6,1,7,0.8571428571428571,0.14285714285714285,Yes,0.8571428571428571
30001,30001,99.00,3,4,7,0.42857142857142855,0.5714285714285714,No,0.5714285714285714
30002,30002,99.00,48,27,75,0.64,0.36,Yes,0.64
30003,30003,99.00,1,0,1,1.0,0.0,Yes,1.0
30004,30004,99.00,81,92,173,0.4682080924855491,0.5317919075144508,No,0.5317919075144508
30005,30005,99.00,97,135,232,0.41810344827586204,0.5818965517241379,No,0.5818965517241379
30006,30006,99.00,90,132,222,0.40540540540540543,0.5945945945945946,No,0.5945945945945946
30007,30007,99.00,88,118,206,0.42718446601941745,0.5728155339805825,No,0.5728155339805825
30008,30008,99.00,120,122,242,0.49586776859504134,0.5041322314049587,No,0.5041322314049587
30009,30009,99.00,98,111,209,0.4688995215311005,0.5311004784688995,No,0.5311004784688995
30010,30010,99.00,124,112,236,0.5254237288135594,0.4745762711864407,Yes,0.5254237288135594
30011,30011,99.00,108,127,235,0.4595744680851064,0.5404255319148936,No,0.5404255319148936
30012,30012,99.00,66,116,182,0.3626373626373626,0.6373626373626373,No,0.6373626373626373
30013,30013,99.00,72,74,146,0.4931506849315068,0.5068493150684932,No,0.5068493150684932
30014,30014,99.00,70,95,165,0.42424242424242425,0.5757575757575758,No,0.5757575757575758
30015,30015,99.00,71,115,186,0.3817204301075269,0.6182795698924731,No,0.6182795698924731
30016,30016,99.00,56,53,109,0.5137614678899083,0.48623853211009177,Yes,0.5137614678899083
30017,30017,99.00,92,92,184,0.5,0.5,Tie,0.5
30018,30018,99.00,98,99,197,0.49746192893401014,0.5025380710659898,No,0.5025380710659898
30019,30019,99.00,47,36,83,0.5662650602409639,0.43373493975903615,Yes,0.5662650602409639
30020,30020,99.00,9,2,11,0.8181818181818182,0.18181818181818182,Yes,0.8181818181818182
30021,30021,99.00,124,115,239,0.5188284518828452,0.4811715481171548,Yes,0.5188284518828452
30022,30022,99.00,2,1,3,0.6666666666666666,0.3333333333333333,Yes,0.6666666666666666
30023,30023,99.00,141,138,279,0.5053763440860215,0.4946236559139785,Yes,0.5053763440860215
30024,30024,99.00,140,113,253,0.5533596837944664,0.44664031620553357,Yes,0.5533596837944664
30025,30025,99.00,125,87,212,0.589622641509434,0.41037735849056606,Yes,0.589622641509434
30026,30026,99.00,55,72,127,0.4330708661417323,0.5669291338582677,No,0.5669291338582677
30027,30027,99.00,138,120,258,0.5348837209302325,0.46511627906976744,Yes,0.5348837209302325
30028,30028,99.00,0,0,0,0,0,n/a,0
30029,30029,99.00,0,0,0,0,0,n/a,0
30030,30030,99.00,129,85,214,0.602803738317757,0.397196261682243,Yes,0.602803738317757
30031,30031,99.00,5,0,5,1.0,0.0,Yes,1.0
30032,30032,99.00,1,0,1,1.0,0.0,Yes,1.0
30033,30033,99.00,3,1,4,0.75,0.25,Yes,0.75
30034,30034,99.00,0,0,0,0,0,n/a,0
30035,30035,99.00,0,0,0,0,0,n/a,0
30036,30036,99.00,0,2,2,0.0,1.0,No,1.0
30037,30037,99.00,5,1,6,0.8333333333333334,0.16666666666666666,Yes,0.8333333333333334
30038,30038,99.00,244,54,298,0.8187919463087249,0.18120805369127516,Yes,0.8187919463087249
30039,30039,99.00,134,84,218,0.6146788990825688,0.3853211009174312,Yes,0.6146788990825688
30040,30040,99.00,133,92,225,0.5911111111111111,0.4088888888888889,Yes,0.5911111111111111
30041,30041,99.00,115,37,152,0.756578947368421,0.24342105263157895,Yes,0.756578947368421
30042,30042,99.00,4,2,6,0.6666666666666666,0.3333333333333333,Yes,0.6666666666666666
30043,30043,99.00,3,1,4,0.75,0.25,Yes,0.75
30044,30044,99.00,187,65,252,0.7420634920634921,0.25793650793650796,Yes,0.7420634920634921
30045,30045,99.00,66,36,102,0.6470588235294118,0.35294117647058826,Yes,0.6470588235294118
30046,30046,99.00,161,35,196,0.8214285714285714,0.17857142857142858,Yes,0.8214285714285714
30047,30047,99.00,129,37,166,0.7771084337349398,0.22289156626506024,Yes,0.7771084337349398
30048,30048,99.00,197,111,308,0.6396103896103896,0.36038961038961037,Yes,0.6396103896103896
30049,30049,99.00,168,60,228,0.7368421052631579,0.2631578947368421,Yes,0.7368421052631579
30050,30050,80.00,215,70,285,0.7543859649122807,0.24561403508771928,Yes,0.7543859649122807
30051,30051,99.00,117,43,160,0.73125,0.26875,Yes,0.73125
30052,30052,99.00,85,22,107,0.794392523364486,0.205607476635514,Yes,0.794392523364486
30053,30053,99.00,2,1,3,0.6666666666666666,0.3333333333333333,Yes,0.6666666666666666
30054,30054,99.00,0,0,0,0,0,n/a,0
30055,30055,99.00,124,47,171,0.7251461988304093,0.27485380116959063,Yes,0.7251461988304093
30056,30056,99.00,31,7,38,0.8157894736842105,0.18421052631578946,Yes,0.8157894736842105
30057,30057,99.00,5,1,6,0.8333333333333334,0.16666666666666666,Yes,0.8333333333333334
30058,30058,99.00,93,55,148,0.6283783783783784,0.3716216216216216,Yes,0.6283783783783784
30059,30059,99.00,72,36,108,0.6666666666666666,0.3333333333333333,Yes,0.6666666666666666
30060,30060,99.00,120,40,160,0.75,0.25,Yes,0.75
30061,30061,99.00,301,123,424,0.7099056603773585,0.29009433962264153,Yes,0.7099056603773585
30062,30062,99.00,193,62,255,0.7568627450980392,0.24313725490196078,Yes,0.7568627450980392
30063,30063,99.00,14,1,15,0.9333333333333333,0.06666666666666667,Yes,0.9333333333333333
30064,30064,99.00,6,1,7,0.8571428571428571,0.14285714285714285,Yes,0.8571428571428571
30065,30065,99.00,300,90,390,0.7692307692307693,0.23076923076923078,Yes,0.7692307692307693
30066,30066,99.00,20,5,25,0.8,0.2,Yes,0.8
30067,30067,99.00,158,37,195,0.8102564102564103,0.18974358974358974,Yes,0.8102564102564103
30068,30068,99.00,181,50,231,0.7835497835497836,0.21645021645021645,Yes,0.7835497835497836
30069,30069,99.00,245,65,310,0.7903225806451613,0.20967741935483872,Yes,0.7903225806451613
30070,30070,99.00,0,0,0,0,0,n/a,0
30071,30071,99.00,0,0,0,0,0,n/a,0
30072,30072,99.00,0,0,0,0,0,n/a,0
30073,30073,99.00,88,94,182,0.4835164835164835,0.5164835164835165,No,0.5164835164835165
30074,30074,99.00,0,0,0,0,0,n/a,0
30075,30075,99.00,1,1,2,0.5,0.5,Tie,0.5
30076,30076,99.00,148,62,210,0.7047619047619048,0.29523809523809524,Yes,0.7047619047619048
30077,30077,99.00,112,38,150,0.7466666666666667,0.25333333333333335,Yes,0.7466666666666667
30078,30078,99.00,24,2,26,0.9230769230769231,0.07692307692307693,Yes,0.9230769230769231
30079,30079,99.00,13,1,14,0.9285714285714286,0.07142857142857142,Yes,0.9285714285714286
30080,30080,80.00,5,1,6,0.8333333333333334,0.16666666666666666,Yes,0.8333333333333334
30081,30081,99.00,78,51,129,0.6046511627906976,0.3953488372093023,Yes,0.6046511627906976
30082,30082,99.00,156,46,202,0.7722772277227723,0.22772277227722773,Yes,0.7722772277227723
31001,31001,99.00,85,36,121,0.7024793388429752,0.2975206611570248,Yes,0.7024793388429752
31002,31002,99.00,6,0,6,1.0,0.0,Yes,1.0
31003,31003,99.00,58,24,82,0.7073170731707317,0.2926829268292683,Yes,0.7073170731707317
31004,31004,99.00,61,14,75,0.8133333333333334,0.18666666666666668,Yes,0.8133333333333334
31005,31005,99.00,48,32,80,0.6,0.4,Yes,0.6
31006,31006,99.00,0,0,0,0,0,n/a,0
31007,31007,99.00,47,11,58,0.8103448275862069,0.1896551724137931,Yes,0.8103448275862069
31008,31008,99.00,45,23,68,0.6617647058823529,0.3382352941176471,Yes,0.6617647058823529
31009,31009,99.00,41,8,49,0.8367346938775511,0.16326530612244897,Yes,0.8367346938775511
31010,31010,99.00,84,19,103,0.8155339805825242,0.18446601941747573,Yes,0.8155339805825242
31011,31011,99.00,68,32,100,0.68,0.32,Yes,0.68
31012,31012,99.00,55,10,65,0.8461538461538461,0.15384615384615385,Yes,0.8461538461538461
31013,31013,99.00,46,27,73,0.6301369863013698,0.3698630136986301,Yes,0.6301369863013698
31014,31014,99.00,66,11,77,0.8571428571428571,0.14285714285714285,Yes,0.8571428571428571
31015,31015,99.00,109,46,155,0.7032258064516129,0.2967741935483871,Yes,0.7032258064516129
31016,31016,99.00,4,2,6,0.6666666666666666,0.3333333333333333,Yes,0.6666666666666666
31017,31017,99.00,77,23,100,0.77,0.23,Yes,0.77
31018,31018,99.00,87,29,116,0.75,0.25,Yes,0.75
31019,31019,99.00,111,25,136,0.8161764705882353,0.18382352941176472,Yes,0.8161764705882353
31020,31020,99.00,1,0,1,1.0,0.0,Yes,1.0
31021,31021,99.00,99,32,131,0.7557251908396947,0.24427480916030533,Yes,0.7557251908396947
31022,31022,99.00,34,23,57,0.5964912280701754,0.40350877192982454,Yes,0.5964912280701754
31023,31023,99.00,102,53,155,0.6580645161290323,0.3419354838709677,Yes,0.6580645161290323
31024,31024,99.00,102,46,148,0.6891891891891891,0.3108108108108108,Yes,0.6891891891891891
31025,31025,99.00,71,35,106,0.6698113207547169,0.330188679245283,Yes,0.6698113207547169
31026,31026,99.00,8,3,11,0.7272727272727273,0.2727272727272727,Yes,0.7272727272727273
31027,31027,99.00,4,7,11,0.36363636363636365,0.6363636363636364,No,0.6363636363636364
31028,31028,99.00,4,2,6,0.6666666666666666,0.3333333333333333,Yes,0.6666666666666666
31029,31029,99.00,3,2,5,0.6,0.4,Yes,0.6
31030,31030,99.00,0,0,0,0,0,n/a,0
31031,31031,99.00,1,0,1,1.0,0.0,Yes,1.0
31032,31032,99.00,93,28,121,0.768595041322314,0.23140495867768596,Yes,0.768595041322314
31033,31033,99.00,5,3,8,0.625,0.375,Yes,0.625
31034,31034,99.00,135,44,179,0.7541899441340782,0.24581005586592178,Yes,0.7541899441340782
31035,31035,99.00,109,29,138,0.7898550724637681,0.21014492753623187,Yes,0.7898550724637681
31036,31036,99.00,97,26,123,0.7886178861788617,0.21138211382113822,Yes,0.7886178861788617
31037,31037,99.00,103,36,139,0.7410071942446043,0.2589928057553957,Yes,0.7410071942446043
31038,31038,99.00,235,57,292,0.8047945205479452,0.1952054794520548,Yes,0.8047945205479452
31039,31039,99.00,107,58,165,0.6484848484848484,0.3515151515151515,Yes,0.6484848484848484
31040,31040,99.00,117,36,153,0.7647058823529411,0.23529411764705882,Yes,0.7647058823529411
31041,31041,99.00,117,30,147,0.7959183673469388,0.20408163265306123,Yes,0.7959183673469388
31042,31042,99.00,160,62,222,0.7207207207207207,0.27927927927927926,Yes,0.7207207207207207
31043,31043,99.00,4,1,5,0.8,0.2,Yes,0.8
31044,31044,99.00,129,39,168,0.7678571428571429,0.23214285714285715,Yes,0.7678571428571429
31045,31045,99.00,195,57,252,0.7738095238095238,0.2261904761904762,Yes,0.7738095238095238
31046,31046,99.00,158,41,199,0.7939698492462312,0.20603015075376885,Yes,0.7939698492462312
31047,31047,99.00,107,30,137,0.781021897810219,0.21897810218978103,Yes,0.781021897810219
31048,31048,99.00,7,4,11,0.6363636363636364,0.36363636363636365,Yes,0.6363636363636364
31049,31049,99.00,114,40,154,0.7402597402597403,0.2597402597402597,Yes,0.7402597402597403
31050,31050,99.00,2,0,2,1.0,0.0,Yes,1.0
31051,31051,99.00,79,28,107,0.7383177570093458,0.2616822429906542,Yes,0.7383177570093458
31052,31052,99.00,129,31,160,0.80625,0.19375,Yes,0.80625
31053,31053,99.00,84,30,114,0.7368421052631579,0.2631578947368421,Yes,0.7368421052631579
31054,31054,99.00,106,33,139,0.762589928057554,0.23741007194244604,Yes,0.762589928057554
31055,31055,99.00,104,29,133,0.7819548872180451,0.21804511278195488,Yes,0.7819548872180451
31056,31056,99.00,61,22,83,0.7349397590361446,0.26506024096385544,Yes,0.7349397590361446
31057,31057,99.00,81,28,109,0.7431192660550459,0.25688073394495414,Yes,0.7431192660550459
31058,31058,99.00,132,33,165,0.8,0.2,Yes,0.8
31059,31059,99.00,64,14,78,0.8205128205128205,0.1794871794871795,Yes,0.8205128205128205
31060,31060,99.00,0,0,0,0,0,n/a,0
31061,31061,99.00,0,0,0,0,0,n/a,0
31062,31062,0.00,3,0,3,1.0,0.0,Yes,1.0
31063,31063,0.00,6,2,8,0.75,0.25,Yes,0.75
31064,31064,99.00,6,1,7,0.8571428571428571,0.14285714285714285,Yes,0.8571428571428571
31065,31065,99.00,0,0,0,0,0,n/a,0
31066,31066,99.00,0,0,0,0,0,n/a,0
31067,31067,99.00,0,0,0,0,0,n/a,0
31068,31068,99.00,0,0,0,0,0,n/a,0
31069,31069,99.00,0,0,0,0,0,n/a,0
31070,31070,99.00,0,0,0,0,0,n/a,0
31071,31071,99.00,0,0,0,0,0,n/a,0
31072,31072,99.00,0,0,0,0,0,n/a,0
31073,31073,99.00,0,0,0,0,0,n/a,0
31074,31074,99.00,0,0,0,0,0,n/a,0
31075,31075,99.00,0,0,0,0,0,n/a,0
31076,31076,99.00,0,0,0,0,0,n/a,0
31077,31077,99.00,0,0,0,0,0,n/a,0
31078,31078,99.00,80,23,103,0.7766990291262136,0.22330097087378642,Yes,0.7766990291262136
31079,31079,99.00,87,17,104,0.8365384615384616,0.16346153846153846,Yes,0.8365384615384616
31080,31080,99.00,0,0,0,0,0,n/a,0
31081,31081,99.00,1,1,2,0.5,0.5,Tie,0.5
31082,31082,99.00,72,20,92,0.782608695652174,0.21739130434782608,Yes,0.782608695652174
31083,31083,99.00,2,2,4,0.5,0.5,Tie,0.5
31084,31084,99.00,4,1,5,0.8,0.2,Yes,0.8
31085,31085,99.00,10,2,12,0.8333333333333334,0.16666666666666666,Yes,0.8333333333333334
31086,31086,99.00,105,25,130,0.8076923076923077,0.19230769230769232,Yes,0.8076923076923077
32001,32001,66.67,85,21,106,0.8018867924528302,0.19811320754716982,Yes,0.8018867924528302
32002,32002,66.67,1,0,1,1.0,0.0,Yes,1.0
32003,32003,99.00,118,33,151,0.7814569536423841,0.2185430463576159,Yes,0.7814569536423841
32004,32004,99.00,115,35,150,0.7666666666666667,0.23333333333333334,Yes,0.7666666666666667
32005,32005,66.67,99,19,118,0.8389830508474576,0.16101694915254236,Yes,0.8389830508474576
32006,32006,99.00,132,43,175,0.7542857142857143,0.24571428571428572,Yes,0.7542857142857143
32007,32007,66.67,2,0,2,1.0,0.0,Yes,1.0
32008,32008,66.67,0,0,0,0,0,n/a,0
32009,32009,99.00,0,0,0,0,0,n/a,0
32010,32010,99.00,0,0,0,0,0,n/a,0
32011,32011,99.00,147,24,171,0.8596491228070176,0.14035087719298245,Yes,0.8596491228070176
32012,32012,75.00,0,0,0,0,0,n/a,0
32013,32013,75.00,1,0,1,1.0,0.0,Yes,1.0
32014,32014,99.00,1,0,1,1.0,0.0,Yes,1.0
32015,32015,75.00,9,2,11,0.8181818181818182,0.18181818181818182,Yes,0.8181818181818182
32016,32016,75.00,105,24,129,0.813953488372093,0.18604651162790697,Yes,0.813953488372093
32017,32017,75.00,73,29,102,0.7156862745098039,0.28431372549019607,Yes,0.7156862745098039
32018,32018,75.00,42,18,60,0.7,0.3,Yes,0.7
32019,32019,99.00,1,0,1,1.0,0.0,Yes,1.0
32020,32020,99.00,38,10,48,0.7916666666666666,0.20833333333333334,Yes,0.7916666666666666
32021,32021,75.00,77,13,90,0.8555555555555555,0.14444444444444443,Yes,0.8555555555555555
32022,32022,99.00,3,2,5,0.6,0.4,Yes,0.6
32023,32023,75.00,110,32,142,0.7746478873239436,0.22535211267605634,Yes,0.7746478873239436
32024,32024,75.00,1,0,1,1.0,0.0,Yes,1.0
32025,32025,99.00,118,44,162,0.7283950617283951,0.2716049382716049,Yes,0.7283950617283951
32026,32026,75.00,7,0,7,1.0,0.0,Yes,1.0
32027,32027,75.00,92,17,109,0.8440366972477065,0.1559633027522936,Yes,0.8440366972477065
32028,32028,99.00,131,42,173,0.7572254335260116,0.24277456647398843,Yes,0.7572254335260116
32029,32029,83.33,82,30,112,0.7321428571428571,0.26785714285714285,Yes,0.7321428571428571
32030,32030,83.33,78,33,111,0.7027027027027027,0.2972972972972973,Yes,0.7027027027027027
32031,32031,99.00,75,22,97,0.7731958762886598,0.2268041237113402,Yes,0.7731958762886598
32032,32032,99.00,32,16,48,0.6666666666666666,0.3333333333333333,Yes,0.6666666666666666
32033,32033,83.33,93,31,124,0.75,0.25,Yes,0.75
32034,32034,83.33,98,38,136,0.7205882352941176,0.27941176470588236,Yes,0.7205882352941176
32035,32035,83.33,77,18,95,0.8105263157894737,0.18947368421052632,Yes,0.8105263157894737
32036,32036,99.00,82,21,103,0.7961165048543689,0.20388349514563106,Yes,0.7961165048543689
32037,32037,99.00,124,56,180,0.6888888888888889,0.3111111111111111,Yes,0.6888888888888889
32038,32038,99.00,132,31,163,0.8098159509202454,0.1901840490797546,Yes,0.8098159509202454
32039,32039,99.00,95,27,122,0.7786885245901639,0.22131147540983606,Yes,0.7786885245901639
32040,32040,99.00,125,40,165,0.7575757575757576,0.24242424242424243,Yes,0.7575757575757576
32041,32041,99.00,156,64,220,0.7090909090909091,0.2909090909090909,Yes,0.7090909090909091
32042,32042,99.00,104,28,132,0.7878787878787878,0.21212121212121213,Yes,0.7878787878787878
32043,32043,99.00,109,31,140,0.7785714285714286,0.22142857142857142,Yes,0.7785714285714286
32044,32044,99.00,1,0,1,1.0,0.0,Yes,1.0
32045,32045,99.00,174,43,217,0.8018433179723502,0.19815668202764977,Yes,0.8018433179723502
32046,32046,99.00,152,58,210,0.7238095238095238,0.2761904761904762,Yes,0.7238095238095238
32047,32047,99.00,126,59,185,0.6810810810810811,0.31891891891891894,Yes,0.6810810810810811
32048,32048,99.00,3,0,3,1.0,0.0,Yes,1.0
32049,32049,99.00,88,48,136,0.6470588235294118,0.35294117647058826,Yes,0.6470588235294118
32050,32050,99.00,96,27,123,0.7804878048780488,0.21951219512195122,Yes,0.7804878048780488
32051,32051,99.00,114,36,150,0.76,0.24,Yes,0.76
32052,32052,99.00,92,32,124,0.7419354838709677,0.25806451612903225,Yes,0.7419354838709677
32053,32053,99.00,89,26,115,0.7739130434782608,0.22608695652173913,Yes,0.7739130434782608
32054,32054,99.00,198,49,247,0.8016194331983806,0.19838056680161945,Yes,0.8016194331983806
32055,32055,99.00,7,1,8,0.875,0.125,Yes,0.875
32056,32056,99.00,2,0,2,1.0,0.0,Yes,1.0
32057,32057,99.00,132,36,168,0.7857142857142857,0.21428571428571427,Yes,0.7857142857142857
32058,32058,99.00,141,35,176,0.8011363636363636,0.19886363636363635,Yes,0.8011363636363636
32059,32059,99.00,106,30,136,0.7794117647058824,0.22058823529411764,Yes,0.7794117647058824
32060,32060,99.00,188,54,242,0.7768595041322314,0.2231404958677686,Yes,0.7768595041322314
32061,32061,99.00,4,3,7,0.5714285714285714,0.42857142857142855,Yes,0.5714285714285714
32062,32062,99.00,171,61,232,0.7370689655172413,0.2629310344827586,Yes,0.7370689655172413
32063,32063,99.00,247,76,323,0.7647058823529411,0.23529411764705882,Yes,0.7647058823529411
32064,32064,75.00,177,75,252,0.7023809523809523,0.2976190476190476,Yes,0.7023809523809523
32065,32065,75.00,35,14,49,0.7142857142857143,0.2857142857142857,Yes,0.7142857142857143
32066,32066,75.00,182,65,247,0.7368421052631579,0.2631578947368421,Yes,0.7368421052631579
32067,32067,75.00,51,14,65,0.7846153846153846,0.2153846153846154,Yes,0.7846153846153846
32068,32068,99.00,151,47,198,0.7626262626262627,0.23737373737373738,Yes,0.7626262626262627
32069,32069,99.00,278,85,363,0.7658402203856749,0.23415977961432508,Yes,0.7658402203856749
32070,32070,99.00,33,5,38,0.868421052631579,0.13157894736842105,Yes,0.868421052631579
32071,32071,75.00,75,59,134,0.5597014925373134,0.44029850746268656,Yes,0.5597014925373134
32072,32072,99.00,88,20,108,0.8148148148148148,0.18518518518518517,Yes,0.8148148148148148
32073,32073,0.00,18,5,23,0.782608695652174,0.21739130434782608,Yes,0.782608695652174
32074,32074,0.00,1,0,1,1.0,0.0,Yes,1.0
32075,32075,99.00,104,51,155,0.6709677419354839,0.32903225806451614,Yes,0.6709677419354839
32076,32076,99.00,0,0,0,0,0,n/a,0
32077,32077,75.00,71,19,90,0.7888888888888889,0.2111111111111111,Yes,0.7888888888888889
32078,32078,99.00,5,1,6,0.8333333333333334,0.16666666666666666,Yes,0.8333333333333334
32079,32079,99.00,131,91,222,0.5900900900900901,0.4099099099099099,Yes,0.5900900900900901
32080,32080,66.67,3,0,3,1.0,0.0,Yes,1.0
32081,32081,99.00,2,4,6,0.3333333333333333,0.6666666666666666,No,0.6666666666666666
32082,32082,83.33,97,34,131,0.7404580152671756,0.2595419847328244,Yes,0.7404580152671756
32083,32083,83.33,7,0,7,1.0,0.0,Yes,1.0
32084,32084,99.00,6,2,8,0.75,0.25,Yes,0.75
33001,33001,99.00,83,61,144,0.5763888888888888,0.4236111111111111,Yes,0.5763888888888888
33002,33002,99.00,66,83,149,0.4429530201342282,0.5570469798657718,No,0.5570469798657718
33003,33003,99.00,63,44,107,0.5887850467289719,0.411214953271028,Yes,0.5887850467289719
33004,33004,99.00,174,137,311,0.5594855305466238,0.4405144694533762,Yes,0.5594855305466238
33005,33005,99.00,85,59,144,0.5902777777777778,0.4097222222222222,Yes,0.5902777777777778
33006,33006,99.00,98,89,187,0.5240641711229946,0.47593582887700536,Yes,0.5240641711229946
33007,33007,99.00,9,8,17,0.5294117647058824,0.47058823529411764,Yes,0.5294117647058824
33008,33008,99.00,115,74,189,0.6084656084656085,0.3915343915343915,Yes,0.6084656084656085
33009,33009,99.00,86,95,181,0.47513812154696133,0.5248618784530387,No,0.5248618784530387
33010,33010,99.00,145,87,232,0.625,0.375,Yes,0.625
33011,33011,99.00,101,77,178,0.5674157303370787,0.43258426966292135,Yes,0.5674157303370787
33012,33012,99.00,6,1,7,0.8571428571428571,0.14285714285714285,Yes,0.8571428571428571
33013,33013,99.00,81,41,122,0.6639344262295082,0.3360655737704918,Yes,0.6639344262295082
33014,33014,99.00,68,34,102,0.6666666666666666,0.3333333333333333,Yes,0.6666666666666666
33015,33015,99.00,87,58,145,0.6,0.4,Yes,0.6
33016,33016,99.00,2,1,3,0.6666666666666666,0.3333333333333333,Yes,0.6666666666666666
33017,33017,99.00,91,53,144,0.6319444444444444,0.3680555555555556,Yes,0.6319444444444444
33018,33018,99.00,79,33,112,0.7053571428571429,0.29464285714285715,Yes,0.7053571428571429
33019,33019,99.00,80,39,119,0.6722689075630253,0.3277310924369748,Yes,0.6722689075630253
33020,33020,99.00,53,25,78,0.6794871794871795,0.32051282051282054,Yes,0.6794871794871795
33021,33021,99.00,85,23,108,0.7870370370370371,0.21296296296296297,Yes,0.7870370370370371
33022,33022,99.00,46,33,79,0.5822784810126582,0.4177215189873418,Yes,0.5822784810126582
33023,33023,99.00,55,18,73,0.7534246575342466,0.2465753424657534,Yes,0.7534246575342466
33024,33024,99.00,2,4,6,0.3333333333333333,0.6666666666666666,No,0.6666666666666666
33025,33025,99.00,84,22,106,0.7924528301886793,0.20754716981132076,Yes,0.7924528301886793
33026,33026,99.00,66,25,91,0.7252747252747253,0.27472527472527475,Yes,0.7252747252747253
33027,33027,99.00,138,46,184,0.75,0.25,Yes,0.75
33028,33028,99.00,7,0,7,1.0,0.0,Yes,1.0
33029,33029,99.00,178,69,247,0.7206477732793523,0.2793522267206478,Yes,0.7206477732793523
33030,33030,99.00,178,59,237,0.7510548523206751,0.2489451476793249,Yes,0.7510548523206751
33031,33031,99.00,95,52,147,0.6462585034013606,0.35374149659863946,Yes,0.6462585034013606
33032,33032,99.00,103,53,156,0.6602564102564102,0.33974358974358976,Yes,0.6602564102564102
33033,33033,99.00,95,35,130,0.7307692307692307,0.2692307692307692,Yes,0.7307692307692307
33034,33034,99.00,91,30,121,0.7520661157024794,0.24793388429752067,Yes,0.7520661157024794
33035,33035,99.00,147,38,185,0.7945945945945946,0.20540540540540542,Yes,0.7945945945945946
33036,33036,99.00,93,32,125,0.744,0.256,Yes,0.744
33037,33037,99.00,141,35,176,0.8011363636363636,0.19886363636363635,Yes,0.8011363636363636
33038,33038,99.00,109,38,147,0.7414965986394558,0.2585034013605442,Yes,0.7414965986394558
33039,33039,99.00,110,36,146,0.7534246575342466,0.2465753424657534,Yes,0.7534246575342466
33040,33040,99.00,99,33,132,0.75,0.25,Yes,0.75
33041,33041,99.00,112,37,149,0.7516778523489933,0.2483221476510067,Yes,0.7516778523489933
33042,33042,99.00,90,44,134,0.6716417910447762,0.3283582089552239,Yes,0.6716417910447762
33043,33043,85.71,71,17,88,0.8068181818181818,0.19318181818181818,Yes,0.8068181818181818
33044,33044,99.00,130,37,167,0.7784431137724551,0.2215568862275449,Yes,0.7784431137724551
33045,33045,99.00,112,49,161,0.6956521739130435,0.30434782608695654,Yes,0.6956521739130435
33046,33046,99.00,130,36,166,0.7831325301204819,0.21686746987951808,Yes,0.7831325301204819
33047,33047,85.71,191,61,252,0.7579365079365079,0.24206349206349206,Yes,0.7579365079365079
33048,33048,85.71,94,18,112,0.8392857142857143,0.16071428571428573,Yes,0.8392857142857143
33049,33049,99.00,141,53,194,0.7268041237113402,0.27319587628865977,Yes,0.7268041237113402
33050,33050,99.00,6,2,8,0.75,0.25,Yes,0.75
33051,33051,99.00,94,39,133,0.706766917293233,0.2932330827067669,Yes,0.706766917293233
33052,33052,85.71,91,30,121,0.7520661157024794,0.24793388429752067,Yes,0.7520661157024794
33053,33053,85.71,86,29,115,0.7478260869565218,0.25217391304347825,Yes,0.7478260869565218
33054,33054,85.71,113,46,159,0.710691823899371,0.2893081761006289,Yes,0.710691823899371
33055,33055,85.71,92,36,128,0.71875,0.28125,Yes,0.71875
33056,33056,57.14,136,55,191,0.7120418848167539,0.2879581151832461,Yes,0.7120418848167539
33057,33057,99.00,118,38,156,0.7564102564102564,0.24358974358974358,Yes,0.7564102564102564
33058,33058,99.00,110,50,160,0.6875,0.3125,Yes,0.6875
33059,33059,99.00,155,47,202,0.7673267326732673,0.23267326732673269,Yes,0.7673267326732673
33060,33060,99.00,127,35,162,0.7839506172839507,0.21604938271604937,Yes,0.7839506172839507
33061,33061,99.00,92,31,123,0.7479674796747967,0.25203252032520324,Yes,0.7479674796747967
33062,33062,99.00,113,45,158,0.7151898734177216,0.2848101265822785,Yes,0.7151898734177216
33063,33063,99.00,118,57,175,0.6742857142857143,0.32571428571428573,Yes,0.6742857142857143
33064,33064,99.00,152,44,196,0.7755102040816326,0.22448979591836735,Yes,0.7755102040816326
33065,33065,57.14,172,54,226,0.7610619469026548,0.23893805309734514,Yes,0.7610619469026548
33066,33066,57.14,164,53,217,0.7557603686635944,0.24423963133640553,Yes,0.7557603686635944
33067,33067,57.14,128,45,173,0.7398843930635838,0.26011560693641617,Yes,0.7398843930635838
33068,33068,99.00,126,46,172,0.7325581395348837,0.26744186046511625,Yes,0.7325581395348837
33069,33069,57.14,127,54,181,0.7016574585635359,0.2983425414364641,Yes,0.7016574585635359
33070,33070,99.00,142,58,200,0.71,0.29,Yes,0.71
33071,33071,99.00,168,51,219,0.7671232876712328,0.2328767123287671,Yes,0.7671232876712328
33072,33072,99.00,99,35,134,0.7388059701492538,0.26119402985074625,Yes,0.7388059701492538
33073,33073,85.71,104,23,127,0.8188976377952756,0.18110236220472442,Yes,0.8188976377952756
33074,33074,99.00,78,37,115,0.6782608695652174,0.3217391304347826,Yes,0.6782608695652174
33075,33075,99.00,79,58,137,0.5766423357664233,0.4233576642335766,Yes,0.5766423357664233
33076,33076,99.00,4,1,5,0.8,0.2,Yes,0.8
33077,33077,99.00,182,61,243,0.7489711934156379,0.25102880658436216,Yes,0.7489711934156379
33078,33078,99.00,106,41,147,0.7210884353741497,0.2789115646258503,Yes,0.7210884353741497
33079,33079,85.71,9,0,9,1.0,0.0,Yes,1.0
34001,34001,99.00,71,21,92,0.7717391304347826,0.22826086956521738,Yes,0.7717391304347826
34002,34002,99.00,67,22,89,0.7528089887640449,0.24719101123595505,Yes,0.7528089887640449
34003,34003,99.00,47,14,61,0.7704918032786885,0.22950819672131148,Yes,0.7704918032786885
34004,34004,99.00,113,34,147,0.7687074829931972,0.23129251700680273,Yes,0.7687074829931972
34005,34005,99.00,53,13,66,0.803030303030303,0.19696969696969696,Yes,0.803030303030303
34006,34006,99.00,32,9,41,0.7804878048780488,0.21951219512195122,Yes,0.7804878048780488
34007,34007,99.00,5,0,5,1.0,0.0,Yes,1.0
34008,34008,99.00,122,38,160,0.7625,0.2375,Yes,0.7625
34009,34009,99.00,1,1,2,0.5,0.5,Tie,0.5
34010,34010,99.00,102,44,146,0.6986301369863014,0.3013698630136986,Yes,0.6986301369863014
34011,34011,99.00,126,50,176,0.7159090909090909,0.2840909090909091,Yes,0.7159090909090909
34012,34012,99.00,4,4,8,0.5,0.5,Tie,0.5
34013,34013,99.00,2,2,4,0.5,0.5,Tie,0.5
34014,34014,99.00,81,24,105,0.7714285714285715,0.22857142857142856,Yes,0.7714285714285715
34015,34015,99.00,136,32,168,0.8095238095238095,0.19047619047619047,Yes,0.8095238095238095
34016,34016,99.00,197,72,269,0.7323420074349443,0.26765799256505574,Yes,0.7323420074349443
34017,34017,99.00,15,3,18,0.8333333333333334,0.16666666666666666,Yes,0.8333333333333334
34018,34018,99.00,2,1,3,0.6666666666666666,0.3333333333333333,Yes,0.6666666666666666
34019,34019,99.00,162,67,229,0.7074235807860262,0.2925764192139738,Yes,0.7074235807860262
34020,34020,99.00,150,47,197,0.7614213197969543,0.23857868020304568,Yes,0.7614213197969543
34021,34021,99.00,5,0,5,1.0,0.0,Yes,1.0
34022,34022,99.00,206,45,251,0.8207171314741036,0.17928286852589642,Yes,0.8207171314741036
34023,34023,99.00,115,34,149,0.7718120805369127,0.22818791946308725,Yes,0.7718120805369127
34024,34024,99.00,351,89,440,0.7977272727272727,0.20227272727272727,Yes,0.7977272727272727
34025,34025,83.33,250,63,313,0.7987220447284346,0.2012779552715655,Yes,0.7987220447284346
34026,34026,83.33,123,20,143,0.8601398601398601,0.13986013986013987,Yes,0.8601398601398601
34027,34027,83.33,11,0,11,1.0,0.0,Yes,1.0
34028,34028,99.00,151,35,186,0.8118279569892473,0.1881720430107527,Yes,0.8118279569892473
34029,34029,99.00,4,0,4,1.0,0.0,Yes,1.0
34030,34030,99.00,0,0,0,0,0,n/a,0
34031,34031,99.00,1,0,1,1.0,0.0,Yes,1.0
34032,34032,99.00,0,0,0,0,0,n/a,0
34033,34033,99.00,1,0,1,1.0,0.0,Yes,1.0
34034,34034,99.00,1,0,1,1.0,0.0,Yes,1.0
34035,34035,83.33,78,18,96,0.8125,0.1875,Yes,0.8125
34036,34036,83.33,83,23,106,0.7830188679245284,0.2169811320754717,Yes,0.7830188679245284
34037,34037,83.33,54,20,74,0.7297297297297297,0.2702702702702703,Yes,0.7297297297297297
34038,34038,99.00,128,48,176,0.7272727272727273,0.2727272727272727,Yes,0.7272727272727273
34039,34039,99.00,103,46,149,0.6912751677852349,0.3087248322147651,Yes,0.6912751677852349
34040,34040,99.00,61,47,108,0.5648148148148148,0.4351851851851852,Yes,0.5648148148148148
34041,34041,99.00,50,56,106,0.4716981132075472,0.5283018867924528,No,0.5283018867924528
34042,34042,99.00,2,1,3,0.6666666666666666,0.3333333333333333,Yes,0.6666666666666666
34043,34043,99.00,1,0,1,1.0,0.0,Yes,1.0
34044,34044,99.00,2,0,2,1.0,0.0,Yes,1.0
34045,34045,99.00,177,60,237,0.7468354430379747,0.25316455696202533,Yes,0.7468354430379747
34046,34046,99.00,76,15,91,0.8351648351648352,0.16483516483516483,Yes,0.8351648351648352
34047,34047,99.00,0,0,0,0,0,n/a,0
34048,34048,99.00,2,2,4,0.5,0.5,Tie,0.5
34049,34049,99.00,146,32,178,0.8202247191011236,0.1797752808988764,Yes,0.8202247191011236
34050,34050,99.00,3,0,3,1.0,0.0,Yes,1.0
34051,34051,99.00,86,41,127,0.6771653543307087,0.3228346456692913,Yes,0.6771653543307087
34052,34052,99.00,142,41,183,0.7759562841530054,0.22404371584699453,Yes,0.7759562841530054
34053,34053,99.00,0,0,0,0,0,n/a,0
34054,34054,99.00,0,0,0,0,0,n/a,0
34055,34055,99.00,0,0,0,0,0,n/a,0
34056,34056,99.00,0,0,0,0,0,n/a,0
34057,34057,99.00,0,0,0,0,0,n/a,0
34058,34058,99.00,0,0,0,0,0,n/a,0
34059,34059,99.00,0,0,0,0,0,n/a,0
34060,34060,99.00,156,32,188,0.8297872340425532,0.1702127659574468,Yes,0.8297872340425532
34061,34061,99.00,70,44,114,0.6140350877192983,0.38596491228070173,Yes,0.6140350877192983
34062,34062,99.00,2,0,2,1.0,0.0,Yes,1.0
34063,34063,83.33,223,47,270,0.825925925925926,0.17407407407407408,Yes,0.825925925925926
34064,34064,99.00,0,0,0,0,0,n/a,0
34065,34065,99.00,147,29,176,0.8352272727272727,0.16477272727272727,Yes,0.8352272727272727
34066,34066,99.00,183,45,228,0.8026315789473685,0.19736842105263158,Yes,0.8026315789473685
34067,34067,99.00,76,22,98,0.7755102040816326,0.22448979591836735,Yes,0.7755102040816326
34068,34068,99.00,10,1,11,0.9090909090909091,0.09090909090909091,Yes,0.9090909090909091
34069,34069,99.00,148,44,192,0.7708333333333334,0.22916666666666666,Yes,0.7708333333333334
34070,34070,99.00,1,0,1,1.0,0.0,Yes,1.0
34071,34071,99.00,0,0,0,0,0,n/a,0
34072,34072,99.00,276,87,363,0.7603305785123967,0.2396694214876033,Yes,0.7603305785123967
34073,34073,99.00,2,1,3,0.6666666666666666,0.3333333333333333,Yes,0.6666666666666666
35001,35001,99.00,0,0,0,0,0,n/a,0
35002,35002,99.00,57,35,92,0.6195652173913043,0.3804347826086957,Yes,0.6195652173913043
35003,35003,99.00,119,47,166,0.7168674698795181,0.28313253012048195,Yes,0.7168674698795181
35004,35004,99.00,78,33,111,0.7027027027027027,0.2972972972972973,Yes,0.7027027027027027
35005,35005,99.00,84,37,121,0.6942148760330579,0.30578512396694213,Yes,0.6942148760330579
35006,35006,0.00,3,2,5,0.6,0.4,Yes,0.6
35007,35007,99.00,119,34,153,0.7777777777777778,0.2222222222222222,Yes,0.7777777777777778
35008,35008,99.00,3,0,3,1.0,0.0,Yes,1.0
35009,35009,99.00,121,46,167,0.7245508982035929,0.2754491017964072,Yes,0.7245508982035929
35010,35010,99.00,1,1,2,0.5,0.5,Tie,0.5
35011,35011,99.00,58,14,72,0.8055555555555556,0.19444444444444445,Yes,0.8055555555555556
35012,35012,99.00,143,46,189,0.7566137566137566,0.24338624338624337,Yes,0.7566137566137566
35013,35013,99.00,48,27,75,0.64,0.36,Yes,0.64
35014,35014,99.00,1,2,3,0.3333333333333333,0.6666666666666666,No,0.6666666666666666
35015,35015,99.00,94,25,119,0.7899159663865546,0.21008403361344538,Yes,0.7899159663865546
35016,35016,99.00,79,25,104,0.7596153846153846,0.2403846153846154,Yes,0.7596153846153846
35017,35017,99.00,90,29,119,0.7563025210084033,0.24369747899159663,Yes,0.7563025210084033
35018,35018,99.00,141,40,181,0.7790055248618785,0.22099447513812154,Yes,0.7790055248618785
35019,35019,99.00,5,0,5,1.0,0.0,Yes,1.0
35020,35020,55.56,143,43,186,0.7688172043010753,0.23118279569892472,Yes,0.7688172043010753
35021,35021,99.00,87,39,126,0.6904761904761905,0.30952380952380953,Yes,0.6904761904761905
35022,35022,99.00,98,23,121,0.8099173553719008,0.19008264462809918,Yes,0.8099173553719008
35023,35023,99.00,2,0,2,1.0,0.0,Yes,1.0
35024,35024,99.00,146,58,204,0.7156862745098039,0.28431372549019607,Yes,0.7156862745098039
35025,35025,99.00,106,28,134,0.7910447761194029,0.208955223880597,Yes,0.7910447761194029
35026,35026,99.00,2,1,3,0.6666666666666666,0.3333333333333333,Yes,0.6666666666666666
35027,35027,99.00,138,55,193,0.7150259067357513,0.2849740932642487,Yes,0.7150259067357513
35028,35028,99.00,34,16,50,0.68,0.32,Yes,0.68
35029,35029,99.00,0,0,0,0,0,n/a,0
35030,35030,99.00,0,0,0,0,0,n/a,0
35031,35031,99.00,0,0,0,0,0,n/a,0
35032,35032,99.00,73,25,98,0.7448979591836735,0.25510204081632654,Yes,0.7448979591836735
35033,35033,0.00,2,2,4,0.5,0.5,Tie,0.5
35034,35034,99.00,0,0,0,0,0,n/a,0
35035,35035,99.00,2,0,2,1.0,0.0,Yes,1.0
35036,35036,99.00,0,0,0,0,0,n/a,0
35037,35037,99.00,60,15,75,0.8,0.2,Yes,0.8
35038,35038,99.00,113,41,154,0.7337662337662337,0.2662337662337662,Yes,0.7337662337662337
35039,35039,99.00,45,18,63,0.7142857142857143,0.2857142857142857,Yes,0.7142857142857143
35040,35040,99.00,0,0,0,0,0,n/a,0
35041,35041,99.00,94,32,126,0.746031746031746,0.25396825396825395,Yes,0.746031746031746
35042,35042,99.00,73,17,90,0.8111111111111111,0.18888888888888888,Yes,0.8111111111111111
35043,35043,99.00,70,16,86,0.813953488372093,0.18604651162790697,Yes,0.813953488372093
35044,35044,99.00,57,25,82,0.6951219512195121,0.3048780487804878,Yes,0.6951219512195121
35045,35045,99.00,7,1,8,0.875,0.125,Yes,0.875
35046,35046,55.56,72,21,93,0.7741935483870968,0.22580645161290322,Yes,0.7741935483870968
35047,35047,55.56,107,22,129,0.8294573643410853,0.17054263565891473,Yes,0.8294573643410853
35048,35048,55.56,111,31,142,0.7816901408450704,0.21830985915492956,Yes,0.7816901408450704
35049,35049,99.00,2,1,3,0.6666666666666666,0.3333333333333333,Yes,0.6666666666666666
35050,35050,99.00,91,41,132,0.6893939393939394,0.3106060606060606,Yes,0.6893939393939394
35051,35051,99.00,84,21,105,0.8,0.2,Yes,0.8
35052,35052,55.56,82,27,109,0.7522935779816514,0.24770642201834864,Yes,0.7522935779816514
35053,35053,55.56,97,29,126,0.7698412698412699,0.23015873015873015,Yes,0.7698412698412699
35054,35054,99.00,0,0,0,0,0,n/a,0
35055,35055,99.00,0,0,0,0,0,n/a,0
35056,35056,55.56,0,0,0,0,0,n/a,0
35057,35057,99.00,0,0,0,0,0,n/a,0
35058,35058,99.00,0,0,0,0,0,n/a,0
35059,35059,99.00,0,0,0,0,0,n/a,0
35060,35060,55.56,0,0,0,0,0,n/a,0
35061,35061,99.00,0,0,0,0,0,n/a,0
35062,35062,99.00,0,0,0,0,0,n/a,0
35063,35063,99.00,64,16,80,0.8,0.2,Yes,0.8
35064,35064,99.00,4,0,4,1.0,0.0,Yes,1.0
35065,35065,99.00,59,20,79,0.7468354430379747,0.25316455696202533,Yes,0.7468354430379747
35066,35066,99.00,9,3,12,0.75,0.25,Yes,0.75
36001,36001,99.00,309,86,395,0.7822784810126582,0.21772151898734177,Yes,0.7822784810126582
36002,36002,99.00,235,75,310,0.7580645161290323,0.24193548387096775,Yes,0.7580645161290323
36003,36003,99.00,17,9,26,0.6538461538461539,0.34615384615384615,Yes,0.6538461538461539
36004,36004,99.00,231,73,304,0.7598684210526315,0.24013157894736842,Yes,0.7598684210526315
36005,36005,99.00,46,19,65,0.7076923076923077,0.2923076923076923,Yes,0.7076923076923077
36006,36006,99.00,244,54,298,0.8187919463087249,0.18120805369127516,Yes,0.8187919463087249
36007,36007,99.00,20,3,23,0.8695652173913043,0.13043478260869565,Yes,0.8695652173913043
36008,36008,99.00,301,79,380,0.7921052631578948,0.20789473684210527,Yes,0.7921052631578948
36009,36009,99.00,179,48,227,0.788546255506608,0.21145374449339208,Yes,0.788546255506608
36010,36010,99.00,122,29,151,0.8079470198675497,0.19205298013245034,Yes,0.8079470198675497
36011,36011,80.00,90,36,126,0.7142857142857143,0.2857142857142857,Yes,0.7142857142857143
36012,36012,80.00,138,35,173,0.7976878612716763,0.2023121387283237,Yes,0.7976878612716763
36013,36013,99.00,12,2,14,0.8571428571428571,0.14285714285714285,Yes,0.8571428571428571
36014,36014,80.00,105,55,160,0.65625,0.34375,Yes,0.65625
36015,36015,80.00,129,39,168,0.7678571428571429,0.23214285714285715,Yes,0.7678571428571429
36016,36016,99.00,235,79,314,0.7484076433121019,0.2515923566878981,Yes,0.7484076433121019
36017,36017,99.00,8,0,8,1.0,0.0,Yes,1.0
36018,36018,99.00,279,77,356,0.7837078651685393,0.21629213483146068,Yes,0.7837078651685393
36019,36019,99.00,148,42,190,0.7789473684210526,0.22105263157894736,Yes,0.7789473684210526
36020,36020,99.00,29,10,39,0.7435897435897436,0.2564102564102564,Yes,0.7435897435897436
36021,36021,99.00,148,47,195,0.7589743589743589,0.24102564102564103,Yes,0.7589743589743589
36022,36022,99.00,228,76,304,0.75,0.25,Yes,0.75
36023,36023,99.00,18,3,21,0.8571428571428571,0.14285714285714285,Yes,0.8571428571428571
36024,36024,99.00,15,2,17,0.8823529411764706,0.11764705882352941,Yes,0.8823529411764706
36025,36025,99.00,188,66,254,0.7401574803149606,0.25984251968503935,Yes,0.7401574803149606
36026,36026,99.00,24,8,32,0.75,0.25,Yes,0.75
36027,36027,99.00,139,44,183,0.7595628415300546,0.24043715846994534,Yes,0.7595628415300546
36028,36028,99.00,199,75,274,0.7262773722627737,0.2737226277372263,Yes,0.7262773722627737
36029,36029,99.00,6,3,9,0.6666666666666666,0.3333333333333333,Yes,0.6666666666666666
36030,36030,99.00,169,89,258,0.6550387596899225,0.3449612403100775,Yes,0.6550387596899225
36031,36031,99.00,135,50,185,0.7297297297297297,0.2702702702702703,Yes,0.7297297297297297
36032,36032,99.00,185,78,263,0.7034220532319392,0.2965779467680608,Yes,0.7034220532319392
36033,36033,99.00,8,3,11,0.7272727272727273,0.2727272727272727,Yes,0.7272727272727273
36034,36034,99.00,236,81,317,0.7444794952681388,0.2555205047318612,Yes,0.7444794952681388
36035,36035,99.00,9,0,9,1.0,0.0,Yes,1.0
36036,36036,99.00,309,94,403,0.7667493796526055,0.23325062034739455,Yes,0.7667493796526055
36037,36037,99.00,242,72,314,0.7707006369426752,0.22929936305732485,Yes,0.7707006369426752
36038,36038,99.00,260,87,347,0.7492795389048992,0.2507204610951009,Yes,0.7492795389048992
36039,36039,99.00,16,2,18,0.8888888888888888,0.1111111111111111,Yes,0.8888888888888888
36040,36040,99.00,186,48,234,0.7948717948717948,0.20512820512820512,Yes,0.7948717948717948
36041,36041,99.00,180,65,245,0.7346938775510204,0.2653061224489796,Yes,0.7346938775510204
36042,36042,99.00,222,84,306,0.7254901960784313,0.27450980392156865,Yes,0.7254901960784313
36043,36043,99.00,2,2,4,0.5,0.5,Tie,0.5
36044,36044,99.00,0,0,0,0,0,n/a,0
36045,36045,80.00,119,43,162,0.7345679012345679,0.2654320987654321,Yes,0.7345679012345679
36046,36046,99.00,145,75,220,0.6590909090909091,0.3409090909090909,Yes,0.6590909090909091
36047,36047,99.00,4,4,8,0.5,0.5,Tie,0.5
36048,36048,99.00,132,95,227,0.5814977973568282,0.4185022026431718,Yes,0.5814977973568282
36049,36049,99.00,200,56,256,0.78125,0.21875,Yes,0.78125
36050,36050,99.00,1,0,1,1.0,0.0,Yes,1.0
36051,36051,99.00,0,1,1,0.0,1.0,No,1.0
36052,36052,99.00,171,48,219,0.7808219178082192,0.2191780821917808,Yes,0.7808219178082192
36053,36053,99.00,175,96,271,0.6457564575645757,0.35424354243542433,Yes,0.6457564575645757
36054,36054,99.00,109,68,177,0.615819209039548,0.384180790960452,Yes,0.615819209039548
36055,36055,99.00,140,58,198,0.7070707070707071,0.29292929292929293,Yes,0.7070707070707071
36056,36056,99.00,190,46,236,0.8050847457627118,0.19491525423728814,Yes,0.8050847457627118
36057,36057,99.00,11,1,12,0.9166666666666666,0.08333333333333333,Yes,0.9166666666666666
36058,36058,99.00,8,3,11,0.7272727272727273,0.2727272727272727,Yes,0.7272727272727273
36059,36059,99.00,234,98,332,0.7048192771084337,0.29518072289156627,Yes,0.7048192771084337
36060,36060,99.00,7,0,7,1.0,0.0,Yes,1.0
36061,36061,99.00,124,42,166,0.7469879518072289,0.25301204819277107,Yes,0.7469879518072289
36062,36062,99.00,3,2,5,0.6,0.4,Yes,0.6
36063,36063,99.00,155,54,209,0.7416267942583732,0.2583732057416268,Yes,0.7416267942583732
36064,36064,99.00,208,59,267,0.7790262172284644,0.2209737827715356,Yes,0.7790262172284644
36065,36065,99.00,8,0,8,1.0,0.0,Yes,1.0
36066,36066,99.00,190,45,235,0.8085106382978723,0.19148936170212766,Yes,0.8085106382978723
36067,36067,99.00,9,2,11,0.8181818181818182,0.18181818181818182,Yes,0.8181818181818182
36068,36068,99.00,0,0,0,0,0,n/a,0
36069,36069,99.00,0,0,0,0,0,n/a,0
36070,36070,99.00,0,0,0,0,0,n/a,0
36071,36071,99.00,0,0,0,0,0,n/a,0
36072,36072,99.00,171,40,211,0.8104265402843602,0.1895734597156398,Yes,0.8104265402843602
36073,36073,99.00,301,62,363,0.8292011019283747,0.17079889807162535,Yes,0.8292011019283747
36074,36074,99.00,4,3,7,0.5714285714285714,0.42857142857142855,Yes,0.5714285714285714
36075,36075,99.00,17,5,22,0.7727272727272727,0.22727272727272727,Yes,0.7727272727272727
36076,36076,99.00,154,30,184,0.8369565217391305,0.16304347826086957,Yes,0.8369565217391305
36077,36077,99.00,276,53,329,0.8389057750759878,0.16109422492401215,Yes,0.8389057750759878
36078,36078,99.00,7,2,9,0.7777777777777778,0.2222222222222222,Yes,0.7777777777777778
36079,36079,99.00,8,0,8,1.0,0.0,Yes,1.0
36080,36080,99.00,6,0,6,1.0,0.0,Yes,1.0
36081,36081,99.00,249,75,324,0.7685185185185185,0.23148148148148148,Yes,0.7685185185185185
36082,36082,99.00,14,7,21,0.6666666666666666,0.3333333333333333,Yes,0.6666666666666666
36083,36083,99.00,1,0,1,1.0,0.0,Yes,1.0
37001,37001,99.00,99,45,144,0.6875,0.3125,Yes,0.6875
37002,37002,99.00,81,28,109,0.7431192660550459,0.25688073394495414,Yes,0.7431192660550459
37003,37003,99.00,79,32,111,0.7117117117117117,0.2882882882882883,Yes,0.7117117117117117
37004,37004,99.00,98,37,135,0.725925925925926,0.2740740740740741,Yes,0.725925925925926
37005,37005,80.00,114,28,142,0.8028169014084507,0.19718309859154928,Yes,0.8028169014084507
37006,37006,99.00,76,22,98,0.7755102040816326,0.22448979591836735,Yes,0.7755102040816326
37007,37007,50.00,41,15,56,0.7321428571428571,0.26785714285714285,Yes,0.7321428571428571
37008,37008,50.00,6,3,9,0.6666666666666666,0.3333333333333333,Yes,0.6666666666666666
37009,37009,50.00,19,10,29,0.6551724137931034,0.3448275862068966,Yes,0.6551724137931034
37010,37010,99.00,9,1,10,0.9,0.1,Yes,0.9
37011,37011,99.00,166,41,207,0.8019323671497585,0.19806763285024154,Yes,0.8019323671497585
37012,37012,99.00,126,34,160,0.7875,0.2125,Yes,0.7875
37013,37013,99.00,1,0,1,1.0,0.0,Yes,1.0
37014,37014,99.00,146,40,186,0.7849462365591398,0.21505376344086022,Yes,0.7849462365591398
37015,37015,99.00,2,1,3,0.6666666666666666,0.3333333333333333,Yes,0.6666666666666666
37016,37016,99.00,130,43,173,0.7514450867052023,0.24855491329479767,Yes,0.7514450867052023
37017,37017,99.00,1,0,1,1.0,0.0,Yes,1.0
37018,37018,99.00,142,38,180,0.7888888888888889,0.2111111111111111,Yes,0.7888888888888889
37019,37019,99.00,116,40,156,0.7435897435897436,0.2564102564102564,Yes,0.7435897435897436
37020,37020,99.00,11,1,12,0.9166666666666666,0.08333333333333333,Yes,0.9166666666666666
37021,37021,99.00,325,78,403,0.8064516129032258,0.1935483870967742,Yes,0.8064516129032258
37022,37022,99.00,220,62,282,0.7801418439716312,0.2198581560283688,Yes,0.7801418439716312
37023,37023,99.00,186,64,250,0.744,0.256,Yes,0.744
37024,37024,99.00,295,74,369,0.7994579945799458,0.2005420054200542,Yes,0.7994579945799458
37025,37025,99.00,3,0,3,1.0,0.0,Yes,1.0
37026,37026,99.00,0,0,0,0,0,n/a,0
37027,37027,80.00,224,54,278,0.8057553956834532,0.19424460431654678,Yes,0.8057553956834532
37028,37028,80.00,175,36,211,0.8293838862559242,0.17061611374407584,Yes,0.8293838862559242
37029,37029,80.00,137,41,178,0.7696629213483146,0.2303370786516854,Yes,0.7696629213483146
37030,37030,80.00,123,24,147,0.8367346938775511,0.16326530612244897,Yes,0.8367346938775511
37031,37031,99.00,8,1,9,0.8888888888888888,0.1111111111111111,Yes,0.8888888888888888
37032,37032,99.00,241,77,318,0.7578616352201258,0.24213836477987422,Yes,0.7578616352201258
37033,37033,99.00,11,3,14,0.7857142857142857,0.21428571428571427,Yes,0.7857142857142857
37034,37034,99.00,88,14,102,0.8627450980392157,0.13725490196078433,Yes,0.8627450980392157
37035,37035,99.00,98,32,130,0.7538461538461538,0.24615384615384617,Yes,0.7538461538461538
37036,37036,99.00,164,46,210,0.780952380952381,0.21904761904761905,Yes,0.780952380952381
37037,37037,99.00,162,51,213,0.7605633802816901,0.23943661971830985,Yes,0.7605633802816901
37038,37038,99.00,147,34,181,0.8121546961325967,0.1878453038674033,Yes,0.8121546961325967
37039,37039,99.00,234,100,334,0.7005988023952096,0.2994011976047904,Yes,0.7005988023952096
37040,37040,99.00,0,0,0,0,0,n/a,0
37041,37041,99.00,1,0,1,1.0,0.0,Yes,1.0
37042,37042,99.00,101,46,147,0.6870748299319728,0.3129251700680272,Yes,0.6870748299319728
37043,37043,99.00,0,1,1,0.0,1.0,No,1.0
37044,37044,99.00,5,3,8,0.625,0.375,Yes,0.625
37045,37045,99.00,79,57,136,0.5808823529411765,0.41911764705882354,Yes,0.5808823529411765
37046,37046,99.00,76,33,109,0.6972477064220184,0.30275229357798167,Yes,0.6972477064220184
37047,37047,99.00,81,32,113,0.7168141592920354,0.2831858407079646,Yes,0.7168141592920354
37048,37048,99.00,168,65,233,0.721030042918455,0.27896995708154504,Yes,0.721030042918455
37049,37049,99.00,111,48,159,0.6981132075471698,0.3018867924528302,Yes,0.6981132075471698
37050,37050,99.00,87,32,119,0.7310924369747899,0.2689075630252101,Yes,0.7310924369747899
37051,37051,99.00,0,0,0,0,0,n/a,0
37052,37052,99.00,100,48,148,0.6756756756756757,0.32432432432432434,Yes,0.6756756756756757
37053,37053,99.00,1,0,1,1.0,0.0,Yes,1.0
37054,37054,99.00,118,52,170,0.6941176470588235,0.3058823529411765,Yes,0.6941176470588235
37055,37055,99.00,1,0,1,1.0,0.0,Yes,1.0
37056,37056,99.00,176,42,218,0.8073394495412844,0.1926605504587156,Yes,0.8073394495412844
37057,37057,99.00,4,1,5,0.8,0.2,Yes,0.8
37058,37058,99.00,122,38,160,0.7625,0.2375,Yes,0.7625
37059,37059,99.00,114,37,151,0.7549668874172185,0.24503311258278146,Yes,0.7549668874172185
37060,37060,99.00,0,0,0,0,0,n/a,0
37061,37061,99.00,4,3,7,0.5714285714285714,0.42857142857142855,Yes,0.5714285714285714
37062,37062,99.00,70,40,110,0.6363636363636364,0.36363636363636365,Yes,0.6363636363636364
37063,37063,99.00,8,1,9,0.8888888888888888,0.1111111111111111,Yes,0.8888888888888888
37064,37064,99.00,17,6,23,0.7391304347826086,0.2608695652173913,Yes,0.7391304347826086
37065,37065,99.00,295,114,409,0.7212713936430318,0.2787286063569682,Yes,0.7212713936430318
37066,37066,99.00,0,0,0,0,0,n/a,0
37067,37067,99.00,1,0,1,1.0,0.0,Yes,1.0
37068,37068,99.00,132,50,182,0.7252747252747253,0.27472527472527475,Yes,0.7252747252747253
37069,37069,99.00,0,0,0,0,0,n/a,0
37070,37070,99.00,0,0,0,0,0,n/a,0
37071,37071,99.00,0,0,0,0,0,n/a,0
37072,37072,99.00,0,0,0,0,0,n/a,0
37073,37073,99.00,0,0,0,0,0,n/a,0
37074,37074,99.00,0,0,0,0,0,n/a,0
37075,37075,99.00,147,46,193,0.7616580310880829,0.23834196891191708,Yes,0.7616580310880829
37076,37076,99.00,9,1,10,0.9,0.1,Yes,0.9
37077,37077,99.00,126,43,169,0.7455621301775148,0.25443786982248523,Yes,0.7455621301775148
37078,37078,99.00,186,63,249,0.7469879518072289,0.25301204819277107,Yes,0.7469879518072289
37079,37079,99.00,171,37,208,0.8221153846153846,0.1778846153846154,Yes,0.8221153846153846
37080,37080,99.00,153,33,186,0.8225806451612904,0.1774193548387097,Yes,0.8225806451612904
37081,37081,99.00,176,59,235,0.7489361702127659,0.251063829787234,Yes,0.7489361702127659
37082,37082,80.00,128,39,167,0.7664670658682635,0.23353293413173654,Yes,0.7664670658682635
37083,37083,99.00,178,50,228,0.7807017543859649,0.21929824561403508,Yes,0.7807017543859649
37084,37084,99.00,76,29,105,0.7238095238095238,0.2761904761904762,Yes,0.7238095238095238
37085,37085,99.00,6,5,11,0.5454545454545454,0.45454545454545453,Yes,0.5454545454545454
37086,37086,99.00,3,0,3,1.0,0.0,Yes,1.0
37087,37087,99.00,205,64,269,0.7620817843866171,0.2379182156133829,Yes,0.7620817843866171
37088,37088,99.00,10,1,11,0.9090909090909091,0.09090909090909091,Yes,0.9090909090909091
38001,38001,99.00,66,20,86,0.7674418604651163,0.23255813953488372,Yes,0.7674418604651163
38002,38002,99.00,4,2,6,0.6666666666666666,0.3333333333333333,Yes,0.6666666666666666
38003,38003,99.00,80,17,97,0.8247422680412371,0.17525773195876287,Yes,0.8247422680412371
38004,38004,99.00,130,31,161,0.8074534161490683,0.19254658385093168,Yes,0.8074534161490683
38005,38005,99.00,101,18,119,0.8487394957983193,0.15126050420168066,Yes,0.8487394957983193
38006,38006,99.00,105,30,135,0.7777777777777778,0.2222222222222222,Yes,0.7777777777777778
38007,38007,99.00,70,23,93,0.7526881720430108,0.24731182795698925,Yes,0.7526881720430108
38008,38008,99.00,142,90,232,0.6120689655172413,0.3879310344827586,Yes,0.6120689655172413
38009,38009,99.00,71,42,113,0.6283185840707964,0.37168141592920356,Yes,0.6283185840707964
38010,38010,99.00,3,5,8,0.375,0.625,No,0.625
38011,38011,99.00,125,87,212,0.589622641509434,0.41037735849056606,Yes,0.589622641509434
38012,38012,99.00,1,1,2,0.5,0.5,Tie,0.5
38013,38013,99.00,6,0,6,1.0,0.0,Yes,1.0
38014,38014,99.00,149,84,233,0.6394849785407726,0.3605150214592275,Yes,0.6394849785407726
38015,38015,99.00,5,1,6,0.8333333333333334,0.16666666666666666,Yes,0.8333333333333334
38016,38016,99.00,78,81,159,0.49056603773584906,0.5094339622641509,No,0.5094339622641509
38017,38017,99.00,74,79,153,0.48366013071895425,0.5163398692810458,No,0.5163398692810458
38018,38018,99.00,55,77,132,0.4166666666666667,0.5833333333333334,No,0.5833333333333334
38019,38019,99.00,6,3,9,0.6666666666666666,0.3333333333333333,Yes,0.6666666666666666
38020,38020,99.00,4,0,4,1.0,0.0,Yes,1.0
38021,38021,60.00,0,0,0,0,0,n/a,0
38022,38022,99.00,138,96,234,0.5897435897435898,0.41025641025641024,Yes,0.5897435897435898
38023,38023,60.00,131,53,184,0.7119565217391305,0.28804347826086957,Yes,0.7119565217391305
38024,38024,60.00,83,29,112,0.7410714285714286,0.25892857142857145,Yes,0.7410714285714286
38025,38025,60.00,1,0,1,1.0,0.0,Yes,1.0
38026,38026,99.00,70,47,117,0.5982905982905983,0.4017094017094017,Yes,0.5982905982905983
38027,38027,99.00,100,33,133,0.7518796992481203,0.24812030075187969,Yes,0.7518796992481203
38028,38028,99.00,110,84,194,0.5670103092783505,0.4329896907216495,Yes,0.5670103092783505
38029,38029,99.00,0,1,1,0.0,1.0,No,1.0
38030,38030,99.00,51,21,72,0.7083333333333334,0.2916666666666667,Yes,0.7083333333333334
38031,38031,99.00,91,39,130,0.7,0.3,Yes,0.7
38032,38032,99.00,120,28,148,0.8108108108108109,0.1891891891891892,Yes,0.8108108108108109
38033,38033,99.00,76,42,118,0.6440677966101694,0.3559322033898305,Yes,0.6440677966101694
38034,38034,0.00,0,1,1,0.0,1.0,No,1.0
38035,38035,99.00,0,0,0,0,0,n/a,0
38036,38036,99.00,3,1,4,0.75,0.25,Yes,0.75
38037,38037,99.00,72,39,111,0.6486486486486487,0.35135135135135137,Yes,0.6486486486486487
38038,38038,99.00,57,24,81,0.7037037037037037,0.2962962962962963,Yes,0.7037037037037037
38039,38039,99.00,5,1,6,0.8333333333333334,0.16666666666666666,Yes,0.8333333333333334
38040,38040,99.00,56,15,71,0.7887323943661971,0.2112676056338028,Yes,0.7887323943661971
38041,38041,99.00,78,26,104,0.75,0.25,Yes,0.75
38042,38042,99.00,61,27,88,0.6931818181818182,0.3068181818181818,Yes,0.6931818181818182
38043,38043,99.00,65,30,95,0.6842105263157895,0.3157894736842105,Yes,0.6842105263157895
38044,38044,99.00,5,0,5,1.0,0.0,Yes,1.0
38045,38045,99.00,2,1,3,0.6666666666666666,0.3333333333333333,Yes,0.6666666666666666
38046,38046,99.00,4,2,6,0.6666666666666666,0.3333333333333333,Yes,0.6666666666666666
38047,38047,99.00,121,58,179,0.6759776536312849,0.3240223463687151,Yes,0.6759776536312849
38048,38048,0.00,1,0,1,1.0,0.0,Yes,1.0
38049,38049,0.00,4,0,4,1.0,0.0,Yes,1.0
38050,38050,99.00,3,1,4,0.75,0.25,Yes,0.75
38051,38051,60.00,122,55,177,0.6892655367231638,0.3107344632768362,Yes,0.6892655367231638
38052,38052,60.00,1,0,1,1.0,0.0,Yes,1.0
38053,38053,60.00,0,0,0,0,0,n/a,0
38054,38054,60.00,80,41,121,0.6611570247933884,0.33884297520661155,Yes,0.6611570247933884
38055,38055,99.00,63,45,108,0.5833333333333334,0.4166666666666667,Yes,0.5833333333333334
38056,38056,99.00,92,33,125,0.736,0.264,Yes,0.736
38057,38057,99.00,91,35,126,0.7222222222222222,0.2777777777777778,Yes,0.7222222222222222
38058,38058,99.00,91,34,125,0.728,0.272,Yes,0.728
38059,38059,0.00,5,1,6,0.8333333333333334,0.16666666666666666,Yes,0.8333333333333334
38060,38060,60.00,0,0,0,0,0,n/a,0
38061,38061,99.00,0,0,0,0,0,n/a,0
38062,38062,99.00,111,25,136,0.8161764705882353,0.18382352941176472,Yes,0.8161764705882353
38063,38063,99.00,59,21,80,0.7375,0.2625,Yes,0.7375
38064,38064,99.00,79,21,100,0.79,0.21,Yes,0.79
38065,38065,99.00,2,0,2,1.0,0.0,Yes,1.0
38066,38066,99.00,1,3,4,0.25,0.75,No,0.75
38067,38067,99.00,3,0,3,1.0,0.0,Yes,1.0
38068,38068,99.00,1,0,1,1.0,0.0,Yes,1.0
38069,38069,99.00,4,2,6,0.6666666666666666,0.3333333333333333,Yes,0.6666666666666666
38070,38070,99.00,51,19,70,0.7285714285714285,0.2714285714285714,Yes,0.7285714285714285
38071,38071,0.00,2,0,2,1.0,0.0,Yes,1.0
39001,39001,99.00,110,33,143,0.7692307692307693,0.23076923076923078,Yes,0.7692307692307693
39002,39002,99.00,90,17,107,0.8411214953271028,0.1588785046728972,Yes,0.8411214953271028
39003,39003,99.00,108,37,145,0.7448275862068966,0.25517241379310346,Yes,0.7448275862068966
39004,39004,99.00,74,19,93,0.7956989247311828,0.20430107526881722,Yes,0.7956989247311828
39005,39005,99.00,73,42,115,0.6347826086956522,0.3652173913043478,Yes,0.6347826086956522
39006,39006,99.00,2,0,2,1.0,0.0,Yes,1.0
39007,39007,99.00,130,42,172,0.7558139534883721,0.2441860465116279,Yes,0.7558139534883721
39008,39008,99.00,0,0,0,0,0,n/a,0
39009,39009,99.00,79,14,93,0.8494623655913979,0.15053763440860216,Yes,0.8494623655913979
39010,39010,99.00,110,31,141,0.7801418439716312,0.2198581560283688,Yes,0.7801418439716312
39011,39011,99.00,53,18,71,0.7464788732394366,0.2535211267605634,Yes,0.7464788732394366
39012,39012,99.00,51,16,67,0.7611940298507462,0.23880597014925373,Yes,0.7611940298507462
39013,39013,99.00,78,18,96,0.8125,0.1875,Yes,0.8125
39014,39014,99.00,40,22,62,0.6451612903225806,0.3548387096774194,Yes,0.6451612903225806
39015,39015,20.00,23,7,30,0.7666666666666667,0.23333333333333334,Yes,0.7666666666666667
39016,39016,20.00,19,2,21,0.9047619047619048,0.09523809523809523,Yes,0.9047619047619048
39017,39017,20.00,19,2,21,0.9047619047619048,0.09523809523809523,Yes,0.9047619047619048
39018,39018,99.00,126,39,165,0.7636363636363637,0.23636363636363636,Yes,0.7636363636363637
39019,39019,99.00,262,53,315,0.8317460317460318,0.16825396825396827,Yes,0.8317460317460318
39020,39020,99.00,0,0,0,0,0,n/a,0
39021,39021,99.00,0,0,0,0,0,n/a,0
39022,39022,99.00,1,1,2,0.5,0.5,Tie,0.5
39023,39023,20.00,17,12,29,0.5862068965517241,0.41379310344827586,Yes,0.5862068965517241
39024,39024,99.00,54,24,78,0.6923076923076923,0.3076923076923077,Yes,0.6923076923076923
39025,39025,99.00,55,24,79,0.6962025316455697,0.3037974683544304,Yes,0.6962025316455697
39026,39026,20.00,2,0,2,1.0,0.0,Yes,1.0
39027,39027,20.00,3,0,3,1.0,0.0,Yes,1.0
39028,39028,20.00,0,0,0,0,0,n/a,0
39029,39029,99.00,55,15,70,0.7857142857142857,0.21428571428571427,Yes,0.7857142857142857
39030,39030,99.00,103,38,141,0.7304964539007093,0.2695035460992908,Yes,0.7304964539007093
39031,39031,99.00,81,38,119,0.680672268907563,0.31932773109243695,Yes,0.680672268907563
39032,39032,99.00,0,0,0,0,0,n/a,0
39033,39033,99.00,5,0,5,1.0,0.0,Yes,1.0
39034,39034,99.00,66,16,82,0.8048780487804879,0.1951219512195122,Yes,0.8048780487804879
39035,39035,99.00,1,0,1,1.0,0.0,Yes,1.0
39036,39036,99.00,0,0,0,0,0,n/a,0
39037,39037,99.00,89,16,105,0.8476190476190476,0.1523809523809524,Yes,0.8476190476190476
39038,39038,99.00,2,0,2,1.0,0.0,Yes,1.0
39039,39039,99.00,0,0,0,0,0,n/a,0
39040,39040,99.00,0,0,0,0,0,n/a,0
39041,39041,99.00,3,0,3,1.0,0.0,Yes,1.0
39042,39042,99.00,0,0,0,0,0,n/a,0
39043,39043,99.00,139,32,171,0.8128654970760234,0.1871345029239766,Yes,0.8128654970760234
39044,39044,99.00,7,0,7,1.0,0.0,Yes,1.0
39045,39045,99.00,383,92,475,0.8063157894736842,0.1936842105263158,Yes,0.8063157894736842
39046,39046,99.00,5,2,7,0.7142857142857143,0.2857142857142857,Yes,0.7142857142857143
39047,39047,99.00,194,43,237,0.8185654008438819,0.18143459915611815,Yes,0.8185654008438819
39048,39048,99.00,105,30,135,0.7777777777777778,0.2222222222222222,Yes,0.7777777777777778
39049,39049,99.00,81,18,99,0.8181818181818182,0.18181818181818182,Yes,0.8181818181818182
39050,39050,99.00,1,0,1,1.0,0.0,Yes,1.0
39051,39051,99.00,190,48,238,0.7983193277310925,0.20168067226890757,Yes,0.7983193277310925
39052,39052,99.00,0,0,0,0,0,n/a,0
39053,39053,99.00,1,0,1,1.0,0.0,Yes,1.0
39054,39054,99.00,2,0,2,1.0,0.0,Yes,1.0
39055,39055,99.00,3,0,3,1.0,0.0,Yes,1.0
39056,39056,99.00,183,45,228,0.8026315789473685,0.19736842105263158,Yes,0.8026315789473685
40001,40001,99.00,7,2,9,0.7777777777777778,0.2222222222222222,Yes,0.7777777777777778
40002,40002,99.00,114,109,223,0.5112107623318386,0.48878923766816146,Yes,0.5112107623318386
40003,40003,99.00,5,1,6,0.8333333333333334,0.16666666666666666,Yes,0.8333333333333334
40004,40004,99.00,132,166,298,0.4429530201342282,0.5570469798657718,No,0.5570469798657718
40005,40005,99.00,120,125,245,0.4897959183673469,0.5102040816326531,No,0.5102040816326531
40006,40006,99.00,79,109,188,0.42021276595744683,0.5797872340425532,No,0.5797872340425532
40007,40007,99.00,10,1,11,0.9090909090909091,0.09090909090909091,Yes,0.9090909090909091
40008,40008,99.00,5,3,8,0.625,0.375,Yes,0.625
40009,40009,99.00,149,103,252,0.5912698412698413,0.4087301587301587,Yes,0.5912698412698413
40010,40010,99.00,0,0,0,0,0,n/a,0
40011,40011,99.00,2,0,2,1.0,0.0,Yes,1.0
40012,40012,99.00,0,0,0,0,0,n/a,0
40013,40013,99.00,135,107,242,0.5578512396694215,0.44214876033057854,Yes,0.5578512396694215
40014,40014,99.00,2,1,3,0.6666666666666666,0.3333333333333333,Yes,0.6666666666666666
40015,40015,99.00,125,75,200,0.625,0.375,Yes,0.625
40016,40016,99.00,152,74,226,0.672566371681416,0.3274336283185841,Yes,0.672566371681416
40017,40017,99.00,5,2,7,0.7142857142857143,0.2857142857142857,Yes,0.7142857142857143
40018,40018,99.00,0,1,1,0.0,1.0,No,1.0
40019,40019,99.00,73,22,95,0.7684210526315789,0.23157894736842105,Yes,0.7684210526315789
40020,40020,99.00,109,33,142,0.7676056338028169,0.2323943661971831,Yes,0.7676056338028169
40021,40021,99.00,82,26,108,0.7592592592592593,0.24074074074074073,Yes,0.7592592592592593
40022,40022,99.00,115,32,147,0.782312925170068,0.21768707482993196,Yes,0.782312925170068
40023,40023,99.00,103,50,153,0.673202614379085,0.32679738562091504,Yes,0.673202614379085
40024,40024,99.00,3,1,4,0.75,0.25,Yes,0.75
40025,40025,99.00,68,19,87,0.7816091954022989,0.21839080459770116,Yes,0.7816091954022989
40026,40026,99.00,97,59,156,0.6217948717948718,0.3782051282051282,Yes,0.6217948717948718
40027,40027,99.00,105,43,148,0.7094594594594594,0.2905405405405405,Yes,0.7094594594594594
40028,40028,99.00,3,1,4,0.75,0.25,Yes,0.75
40029,40029,99.00,2,3,5,0.4,0.6,No,0.6
40030,40030,99.00,98,71,169,0.5798816568047337,0.42011834319526625,Yes,0.5798816568047337
40031,40031,99.00,100,42,142,0.704225352112676,0.29577464788732394,Yes,0.704225352112676
40032,40032,99.00,92,41,133,0.6917293233082706,0.3082706766917293,Yes,0.6917293233082706
40033,40033,99.00,12,2,14,0.8571428571428571,0.14285714285714285,Yes,0.8571428571428571
40034,40034,99.00,108,44,152,0.7105263157894737,0.2894736842105263,Yes,0.7105263157894737
40035,40035,99.00,76,16,92,0.8260869565217391,0.17391304347826086,Yes,0.8260869565217391
40036,40036,99.00,110,45,155,0.7096774193548387,0.2903225806451613,Yes,0.7096774193548387
40037,40037,99.00,83,29,112,0.7410714285714286,0.25892857142857145,Yes,0.7410714285714286
40038,40038,99.00,5,1,6,0.8333333333333334,0.16666666666666666,Yes,0.8333333333333334
40039,40039,99.00,97,32,129,0.751937984496124,0.24806201550387597,Yes,0.751937984496124
40040,40040,99.00,107,19,126,0.8492063492063492,0.15079365079365079,Yes,0.8492063492063492
40041,40041,99.00,1,1,2,0.5,0.5,Tie,0.5
40042,40042,99.00,5,0,5,1.0,0.0,Yes,1.0
40043,40043,99.00,48,20,68,0.7058823529411765,0.29411764705882354,Yes,0.7058823529411765
40044,40044,99.00,5,0,5,1.0,0.0,Yes,1.0
40045,40045,99.00,49,14,63,0.7777777777777778,0.2222222222222222,Yes,0.7777777777777778
40046,40046,99.00,48,13,61,0.7868852459016393,0.21311475409836064,Yes,0.7868852459016393
40047,40047,99.00,4,3,7,0.5714285714285714,0.42857142857142855,Yes,0.5714285714285714
40048,40048,99.00,156,78,234,0.6666666666666666,0.3333333333333333,Yes,0.6666666666666666
40049,40049,99.00,2,0,2,1.0,0.0,Yes,1.0
40050,40050,99.00,119,23,142,0.8380281690140845,0.1619718309859155,Yes,0.8380281690140845
40051,40051,99.00,74,39,113,0.6548672566371682,0.34513274336283184,Yes,0.6548672566371682
40052,40052,99.00,1,0,1,1.0,0.0,Yes,1.0
40053,40053,99.00,2,1,3,0.6666666666666666,0.3333333333333333,Yes,0.6666666666666666
40054,40054,99.00,0,0,0,0,0,n/a,0
40055,40055,99.00,0,0,0,0,0,n/a,0
40056,40056,99.00,7,0,7,1.0,0.0,Yes,1.0
40057,40057,99.00,72,48,120,0.6,0.4,Yes,0.6
40058,40058,99.00,6,1,7,0.8571428571428571,0.14285714285714285,Yes,0.8571428571428571
40059,40059,99.00,1,0,1,1.0,0.0,Yes,1.0
40060,40060,99.00,57,22,79,0.7215189873417721,0.27848101265822783,Yes,0.7215189873417721
61001,61001,99.00,146,64,210,0.6952380952380952,0.3047619047619048,Yes,0.6952380952380952
61002,61002,99.00,178,55,233,0.7639484978540773,0.23605150214592274,Yes,0.7639484978540773
61003,61003,99.00,207,80,287,0.7212543554006968,0.2787456445993031,Yes,0.7212543554006968
61004,61004,99.00,201,79,280,0.7178571428571429,0.28214285714285714,Yes,0.7178571428571429
61005,61005,99.00,9,1,10,0.9,0.1,Yes,0.9
61006,61006,99.00,96,51,147,0.6530612244897959,0.3469387755102041,Yes,0.6530612244897959
61007,61007,99.00,79,26,105,0.7523809523809524,0.24761904761904763,Yes,0.7523809523809524
61008,61008,99.00,139,45,184,0.7554347826086957,0.24456521739130435,Yes,0.7554347826086957
61009,61009,99.00,286,167,453,0.6313465783664459,0.3686534216335541,Yes,0.6313465783664459
61010,61010,99.00,116,52,168,0.6904761904761905,0.30952380952380953,Yes,0.6904761904761905
61011,61011,99.00,8,5,13,0.6153846153846154,0.38461538461538464,Yes,0.6153846153846154
61012,61012,99.00,202,186,388,0.520618556701031,0.4793814432989691,Yes,0.520618556701031
61013,61013,99.00,119,59,178,0.6685393258426966,0.33146067415730335,Yes,0.6685393258426966
61014,61014,99.00,98,122,220,0.44545454545454544,0.5545454545454546,No,0.5545454545454546
61015,61015,99.00,92,65,157,0.5859872611464968,0.4140127388535032,Yes,0.5859872611464968
61016,61016,99.00,90,32,122,0.7377049180327869,0.26229508196721313,Yes,0.7377049180327869
61017,61017,75.00,100,31,131,0.7633587786259542,0.2366412213740458,Yes,0.7633587786259542
61018,61018,99.00,148,224,372,0.3978494623655914,0.6021505376344086,No,0.6021505376344086
61019,61019,75.00,113,81,194,0.5824742268041238,0.4175257731958763,Yes,0.5824742268041238
61020,61020,75.00,95,84,179,0.5307262569832403,0.4692737430167598,Yes,0.5307262569832403
61021,61021,99.00,109,44,153,0.7124183006535948,0.2875816993464052,Yes,0.7124183006535948
61022,61022,99.00,91,69,160,0.56875,0.43125,Yes,0.56875
61023,61023,99.00,70,69,139,0.5035971223021583,0.49640287769784175,Yes,0.5035971223021583
61024,61024,99.00,76,97,173,0.4393063583815029,0.5606936416184971,No,0.5606936416184971
61025,61025,99.00,73,82,155,0.47096774193548385,0.5290322580645161,No,0.5290322580645161
61026,61026,50.00,94,40,134,0.7014925373134329,0.29850746268656714,Yes,0.7014925373134329
61027,61027,50.00,97,38,135,0.7185185185185186,0.2814814814814815,Yes,0.7185185185185186
61028,61028,99.00,137,91,228,0.6008771929824561,0.3991228070175439,Yes,0.6008771929824561
61029,61029,99.00,12,6,18,0.6666666666666666,0.3333333333333333,Yes,0.6666666666666666
61030,61030,99.00,94,65,159,0.5911949685534591,0.4088050314465409,Yes,0.5911949685534591
61031,61031,50.00,83,37,120,0.6916666666666667,0.30833333333333335,Yes,0.6916666666666667
61032,61032,50.00,77,26,103,0.7475728155339806,0.2524271844660194,Yes,0.7475728155339806
61033,61033,62.50,97,39,136,0.7132352941176471,0.2867647058823529,Yes,0.7132352941176471
61034,61034,99.00,148,293,441,0.3356009070294785,0.6643990929705216,No,0.6643990929705216
61035,61035,99.00,108,194,302,0.3576158940397351,0.6423841059602649,No,0.6423841059602649
61036,61036,99.00,6,7,13,0.46153846153846156,0.5384615384615384,No,0.5384615384615384
61037,61037,57.14,223,198,421,0.5296912114014252,0.47030878859857483,Yes,0.5296912114014252
61038,61038,57.14,127,187,314,0.40445859872611467,0.5955414012738853,No,0.5955414012738853
61039,61039,57.14,27,21,48,0.5625,0.4375,Yes,0.5625
61040,61040,57.14,186,232,418,0.4449760765550239,0.5550239234449761,No,0.5550239234449761
61041,61041,99.00,4,4,8,0.5,0.5,Tie,0.5
61042,61042,99.00,139,187,326,0.4263803680981595,0.5736196319018405,No,0.5736196319018405
61043,61043,99.00,135,293,428,0.31542056074766356,0.6845794392523364,No,0.6845794392523364
61044,61044,99.00,147,264,411,0.35766423357664234,0.6423357664233577,No,0.6423357664233577
61045,61045,99.00,3,2,5,0.6,0.4,Yes,0.6
61046,61046,99.00,1,2,3,0.3333333333333333,0.6666666666666666,No,0.6666666666666666
61047,61047,99.00,2,0,2,1.0,0.0,Yes,1.0
61048,61048,99.00,120,304,424,0.2830188679245283,0.7169811320754716,No,0.7169811320754716
61049,61049,99.00,144,65,209,0.6889952153110048,0.31100478468899523,Yes,0.6889952153110048
61050,61050,99.00,132,59,191,0.6910994764397905,0.3089005235602094,Yes,0.6910994764397905
61051,61051,99.00,20,5,25,0.8,0.2,Yes,0.8
61052,61052,99.00,119,79,198,0.601010101010101,0.398989898989899,Yes,0.601010101010101
61053,61053,99.00,84,33,117,0.717948717948718,0.28205128205128205,Yes,0.717948717948718
61054,61054,99.00,56,27,83,0.6746987951807228,0.3253012048192771,Yes,0.6746987951807228
61055,61055,99.00,96,32,128,0.75,0.25,Yes,0.75
61056,61056,99.00,85,28,113,0.7522123893805309,0.24778761061946902,Yes,0.7522123893805309
61057,61057,99.00,93,81,174,0.5344827586206896,0.46551724137931033,Yes,0.5344827586206896
61058,61058,62.50,135,39,174,0.7758620689655172,0.22413793103448276,Yes,0.7758620689655172
61059,61059,62.50,6,3,9,0.6666666666666666,0.3333333333333333,Yes,0.6666666666666666
61060,61060,62.50,82,45,127,0.6456692913385826,0.3543307086614173,Yes,0.6456692913385826
61061,61061,62.50,83,12,95,0.8736842105263158,0.12631578947368421,Yes,0.8736842105263158
61062,61062,99.00,69,93,162,0.42592592592592593,0.5740740740740741,No,0.5740740740740741
61063,61063,99.00,21,24,45,0.4666666666666667,0.5333333333333333,No,0.5333333333333333
61064,61064,99.00,5,4,9,0.5555555555555556,0.4444444444444444,Yes,0.5555555555555556
61065,61065,99.00,115,42,157,0.732484076433121,0.267515923566879,Yes,0.732484076433121
61066,61066,99.00,125,69,194,0.6443298969072165,0.3556701030927835,Yes,0.6443298969072165
61067,61067,99.00,94,50,144,0.6527777777777778,0.3472222222222222,Yes,0.6527777777777778
61068,61068,99.00,88,48,136,0.6470588235294118,0.35294117647058826,Yes,0.6470588235294118
61069,61069,99.00,78,26,104,0.75,0.25,Yes,0.75
61070,61070,99.00,79,15,94,0.8404255319148937,0.1595744680851064,Yes,0.8404255319148937
61071,61071,99.00,6,3,9,0.6666666666666666,0.3333333333333333,Yes,0.6666666666666666
61072,61072,57.14,19,15,34,0.5588235294117647,0.4411764705882353,Yes,0.5588235294117647
61073,61073,62.50,78,23,101,0.7722772277227723,0.22772277227722773,Yes,0.7722772277227723
61074,61074,99.00,8,0,8,1.0,0.0,Yes,1.0
61075,61075,99.00,70,39,109,0.6422018348623854,0.3577981651376147,Yes,0.6422018348623854
61076,61076,99.00,112,72,184,0.6086956521739131,0.391304347826087,Yes,0.6086956521739131
61077,61077,99.00,9,2,11,0.8181818181818182,0.18181818181818182,Yes,0.8181818181818182
61078,61078,99.00,4,3,7,0.5714285714285714,0.42857142857142855,Yes,0.5714285714285714
61079,61079,99.00,0,0,0,0,0,n/a,0
62001,62001,99.00,59,135,194,0.30412371134020616,0.6958762886597938,No,0.6958762886597938
62002,62002,99.00,71,208,279,0.25448028673835127,0.7455197132616488,No,0.7455197132616488
62003,62003,57.14,86,171,257,0.3346303501945525,0.6653696498054474,No,0.6653696498054474
62004,62004,99.00,55,156,211,0.26066350710900477,0.7393364928909952,No,0.7393364928909952
62005,62005,57.14,50,121,171,0.29239766081871343,0.7076023391812866,No,0.7076023391812866
62006,62006,99.00,52,147,199,0.2613065326633166,0.7386934673366834,No,0.7386934673366834
62007,62007,57.14,47,170,217,0.21658986175115208,0.783410138248848,No,0.783410138248848
62008,62008,0.00,9,7,16,0.5625,0.4375,Yes,0.5625
62009,62009,50.00,22,20,42,0.5238095238095238,0.47619047619047616,Yes,0.5238095238095238
62010,62010,57.14,10,15,25,0.4,0.6,No,0.6
62011,62011,0.00,6,9,15,0.4,0.6,No,0.6
62012,62012,99.00,83,158,241,0.34439834024896265,0.6556016597510373,No,0.6556016597510373
62013,62013,99.00,100,177,277,0.36101083032490977,0.6389891696750902,No,0.6389891696750902
62014,62014,99.00,1,3,4,0.25,0.75,No,0.75
62015,62015,99.00,90,194,284,0.31690140845070425,0.6830985915492958,No,0.6830985915492958
62016,62016,99.00,101,181,282,0.35815602836879434,0.6418439716312057,No,0.6418439716312057
62017,62017,99.00,3,4,7,0.42857142857142855,0.5714285714285714,No,0.5714285714285714
62018,62018,99.00,3,1,4,0.75,0.25,Yes,0.75
62019,62019,99.00,3,5,8,0.375,0.625,No,0.625
62020,62020,66.67,84,230,314,0.267515923566879,0.732484076433121,No,0.732484076433121
62021,62021,66.67,91,180,271,0.33579335793357934,0.6642066420664207,No,0.6642066420664207
62022,62022,66.67,86,252,338,0.25443786982248523,0.7455621301775148,No,0.7455621301775148
62023,62023,66.67,3,20,23,0.13043478260869565,0.8695652173913043,No,0.8695652173913043
62024,62024,66.67,15,6,21,0.7142857142857143,0.2857142857142857,Yes,0.7142857142857143
62025,62025,66.67,12,15,27,0.4444444444444444,0.5555555555555556,No,0.5555555555555556
62026,62026,99.00,75,96,171,0.43859649122807015,0.5614035087719298,No,0.5614035087719298
62027,62027,99.00,53,162,215,0.24651162790697675,0.7534883720930232,No,0.7534883720930232
62028,62028,99.00,41,128,169,0.24260355029585798,0.757396449704142,No,0.757396449704142
62029,62029,0.00,6,0,6,1.0,0.0,Yes,1.0
62030,62030,0.00,6,9,15,0.4,0.6,No,0.6
62031,62031,0.00,15,11,26,0.5769230769230769,0.4230769230769231,Yes,0.5769230769230769
62032,62032,99.00,50,124,174,0.28735632183908044,0.7126436781609196,No,0.7126436781609196
62033,62033,99.00,68,108,176,0.38636363636363635,0.6136363636363636,No,0.6136363636363636
62034,62034,99.00,50,136,186,0.26881720430107525,0.7311827956989247,No,0.7311827956989247
62035,62035,99.00,114,242,356,0.3202247191011236,0.6797752808988764,No,0.6797752808988764
62036,62036,99.00,6,11,17,0.35294117647058826,0.6470588235294118,No,0.6470588235294118
62037,62037,99.00,70,170,240,0.2916666666666667,0.7083333333333334,No,0.7083333333333334
62038,62038,99.00,76,186,262,0.2900763358778626,0.7099236641221374,No,0.7099236641221374
62039,62039,99.00,60,179,239,0.2510460251046025,0.7489539748953975,No,0.7489539748953975
62040,62040,99.00,57,136,193,0.29533678756476683,0.7046632124352331,No,0.7046632124352331
62041,62041,99.00,53,152,205,0.25853658536585367,0.7414634146341463,No,0.7414634146341463
62042,62042,99.00,93,126,219,0.4246575342465753,0.5753424657534246,No,0.5753424657534246
62043,62043,99.00,62,146,208,0.2980769230769231,0.7019230769230769,No,0.7019230769230769
62044,62044,99.00,97,206,303,0.3201320132013201,0.6798679867986799,No,0.6798679867986799
62045,62045,99.00,2,6,8,0.25,0.75,No,0.75
62046,62046,99.00,62,130,192,0.3229166666666667,0.6770833333333334,No,0.6770833333333334
62047,62047,99.00,85,231,316,0.2689873417721519,0.7310126582278481,No,0.7310126582278481
62048,62048,99.00,56,99,155,0.36129032258064514,0.6387096774193548,No,0.6387096774193548
62049,62049,99.00,81,146,227,0.3568281938325991,0.6431718061674009,No,0.6431718061674009
62050,62050,99.00,70,164,234,0.29914529914529914,0.7008547008547008,No,0.7008547008547008
62051,62051,99.00,51,125,176,0.2897727272727273,0.7102272727272727,No,0.7102272727272727
62052,62052,99.00,61,159,220,0.2772727272727273,0.7227272727272728,No,0.7227272727272728
62053,62053,99.00,63,151,214,0.29439252336448596,0.705607476635514,No,0.705607476635514
62054,62054,99.00,74,87,161,0.45962732919254656,0.5403726708074534,No,0.5403726708074534
62055,62055,99.00,53,159,212,0.25,0.75,No,0.75
62056,62056,99.00,67,107,174,0.3850574712643678,0.6149425287356322,No,0.6149425287356322
62057,62057,99.00,53,126,179,0.29608938547486036,0.7039106145251397,No,0.7039106145251397
62058,62058,99.00,65,125,190,0.34210526315789475,0.6578947368421053,No,0.6578947368421053
62059,62059,99.00,54,101,155,0.34838709677419355,0.6516129032258065,No,0.6516129032258065
62060,62060,99.00,98,119,217,0.45161290322580644,0.5483870967741935,No,0.5483870967741935
62061,62061,99.00,75,153,228,0.32894736842105265,0.6710526315789473,No,0.6710526315789473
62062,62062,99.00,61,137,198,0.30808080808080807,0.6919191919191919,No,0.6919191919191919
62063,62063,99.00,112,212,324,0.345679012345679,0.654320987654321,No,0.654320987654321
62064,62064,99.00,41,68,109,0.3761467889908257,0.6238532110091743,No,0.6238532110091743
62065,62065,99.00,73,172,245,0.2979591836734694,0.7020408163265306,No,0.7020408163265306
62066,62066,99.00,112,261,373,0.3002680965147453,0.6997319034852547,No,0.6997319034852547
62067,62067,99.00,115,257,372,0.30913978494623656,0.6908602150537635,No,0.6908602150537635
62068,62068,99.00,121,232,353,0.34277620396600567,0.6572237960339944,No,0.6572237960339944
62069,62069,99.00,11,15,26,0.4230769230769231,0.5769230769230769,No,0.5769230769230769
62070,62070,99.00,34,62,96,0.3541666666666667,0.6458333333333334,No,0.6458333333333334
62071,62071,99.00,10,9,19,0.5263157894736842,0.47368421052631576,Yes,0.5263157894736842
62072,62072,99.00,60,81,141,0.425531914893617,0.574468085106383,No,0.574468085106383
62073,62073,99.00,9,7,16,0.5625,0.4375,Yes,0.5625
62074,62074,99.00,52,193,245,0.21224489795918366,0.7877551020408163,No,0.7877551020408163
62075,62075,66.67,63,95,158,0.3987341772151899,0.6012658227848101,No,0.6012658227848101
62076,62076,57.14,50,133,183,0.273224043715847,0.726775956284153,No,0.726775956284153
62077,62077,99.00,48,147,195,0.24615384615384617,0.7538461538461538,No,0.7538461538461538
62078,62078,0.00,2,4,6,0.3333333333333333,0.6666666666666666,No,0.6666666666666666
62079,62079,99.00,75,187,262,0.2862595419847328,0.7137404580152672,No,0.7137404580152672
62080,62080,99.00,54,82,136,0.39705882352941174,0.6029411764705882,No,0.6029411764705882
62081,62081,99.00,50,103,153,0.32679738562091504,0.673202614379085,No,0.673202614379085
62082,62082,99.00,12,8,20,0.6,0.4,Yes,0.6
62083,62083,66.67,43,115,158,0.2721518987341772,0.7278481012658228,No,0.7278481012658228
62084,62084,99.00,50,156,206,0.24271844660194175,0.7572815533980582,No,0.7572815533980582
62085,62085,99.00,2,5,7,0.2857142857142857,0.7142857142857143,No,0.7142857142857143
62086,62086,99.00,0,2,2,0.0,1.0,No,1.0
62087,62087,99.00,0,0,0,0,0,n/a,0
62088,62088,99.00,0,0,0,0,0,n/a,0
63001,63001,99.00,125,188,313,0.3993610223642173,0.6006389776357828,No,0.6006389776357828
63002,63002,99.00,77,82,159,0.48427672955974843,0.5157232704402516,No,0.5157232704402516
63003,63003,99.00,5,7,12,0.4166666666666667,0.5833333333333334,No,0.5833333333333334
63004,63004,99.00,57,88,145,0.3931034482758621,0.6068965517241379,No,0.6068965517241379
63005,63005,99.00,85,187,272,0.3125,0.6875,No,0.6875
63006,63006,99.00,7,6,13,0.5384615384615384,0.46153846153846156,Yes,0.5384615384615384
63007,63007,0.00,1,2,3,0.3333333333333333,0.6666666666666666,No,0.6666666666666666
63008,63008,99.00,69,73,142,0.4859154929577465,0.5140845070422535,No,0.5140845070422535
63009,63009,99.00,5,8,13,0.38461538461538464,0.6153846153846154,No,0.6153846153846154
63010,63010,99.00,102,76,178,0.5730337078651685,0.42696629213483145,Yes,0.5730337078651685
63011,63011,99.00,124,122,246,0.5040650406504065,0.4959349593495935,Yes,0.5040650406504065
63012,63012,99.00,2,2,4,0.5,0.5,Tie,0.5
63013,63013,99.00,81,88,169,0.47928994082840237,0.5207100591715976,No,0.5207100591715976
63014,63014,99.00,47,65,112,0.41964285714285715,0.5803571428571429,No,0.5803571428571429
63015,63015,99.00,63,84,147,0.42857142857142855,0.5714285714285714,No,0.5714285714285714
63016,63016,99.00,101,118,219,0.4611872146118721,0.5388127853881278,No,0.5388127853881278
63017,63017,99.00,1,0,1,1.0,0.0,Yes,1.0
63018,63018,99.00,124,208,332,0.37349397590361444,0.6265060240963856,No,0.6265060240963856
63019,63019,99.00,1,4,5,0.2,0.8,No,0.8
63020,63020,99.00,49,84,133,0.3684210526315789,0.631578947368421,No,0.631578947368421
63021,63021,99.00,37,67,104,0.3557692307692308,0.6442307692307693,No,0.6442307692307693
63022,63022,99.00,72,73,145,0.496551724137931,0.503448275862069,No,0.503448275862069
63023,63023,99.00,52,67,119,0.4369747899159664,0.5630252100840336,No,0.5630252100840336
63024,63024,99.00,93,169,262,0.3549618320610687,0.6450381679389313,No,0.6450381679389313
63025,63025,99.00,3,4,7,0.42857142857142855,0.5714285714285714,No,0.5714285714285714
63026,63026,99.00,56,134,190,0.29473684210526313,0.7052631578947368,No,0.7052631578947368
63027,63027,99.00,96,139,235,0.4085106382978723,0.5914893617021276,No,0.5914893617021276
63028,63028,99.00,3,2,5,0.6,0.4,Yes,0.6
63029,63029,99.00,105,209,314,0.3343949044585987,0.6656050955414012,No,0.6656050955414012
63030,63030,99.00,65,69,134,0.48507462686567165,0.5149253731343284,No,0.5149253731343284
63031,63031,99.00,102,91,193,0.5284974093264249,0.47150259067357514,Yes,0.5284974093264249
63032,63032,99.00,56,94,150,0.37333333333333335,0.6266666666666667,No,0.6266666666666667
63033,63033,99.00,82,140,222,0.36936936936936937,0.6306306306306306,No,0.6306306306306306
63034,63034,99.00,58,114,172,0.3372093023255814,0.6627906976744186,No,0.6627906976744186
63035,63035,99.00,79,157,236,0.3347457627118644,0.6652542372881356,No,0.6652542372881356
63036,63036,99.00,109,146,255,0.42745098039215684,0.5725490196078431,No,0.5725490196078431
63037,63037,99.00,128,61,189,0.6772486772486772,0.32275132275132273,Yes,0.6772486772486772
63038,63038,99.00,104,60,164,0.6341463414634146,0.36585365853658536,Yes,0.6341463414634146
63039,63039,99.00,65,27,92,0.7065217391304348,0.29347826086956524,Yes,0.7065217391304348
63040,63040,99.00,1,3,4,0.25,0.75,No,0.75
63041,63041,50.00,52,21,73,0.7123287671232876,0.2876712328767123,Yes,0.7123287671232876
63042,63042,99.00,59,21,80,0.7375,0.2625,Yes,0.7375
63043,63043,99.00,93,35,128,0.7265625,0.2734375,Yes,0.7265625
63044,63044,99.00,92,38,130,0.7076923076923077,0.2923076923076923,Yes,0.7076923076923077
63045,63045,99.00,77,17,94,0.8191489361702128,0.18085106382978725,Yes,0.8191489361702128
63046,63046,99.00,110,229,339,0.32448377581120946,0.6755162241887905,No,0.6755162241887905
63047,63047,99.00,6,2,8,0.75,0.25,Yes,0.75
63048,63048,99.00,48,112,160,0.3,0.7,No,0.7
63049,63049,99.00,134,201,335,0.4,0.6,No,0.6
63050,63050,99.00,66,89,155,0.4258064516129032,0.5741935483870968,No,0.5741935483870968
63051,63051,99.00,2,8,10,0.2,0.8,No,0.8
63052,63052,99.00,99,116,215,0.4604651162790698,0.5395348837209303,No,0.5395348837209303
63053,63053,99.00,80,87,167,0.47904191616766467,0.5209580838323353,No,0.5209580838323353
63054,63054,99.00,86,82,168,0.5119047619047619,0.4880952380952381,Yes,0.5119047619047619
63055,63055,99.00,66,78,144,0.4583333333333333,0.5416666666666666,No,0.5416666666666666
63056,63056,99.00,0,2,2,0.0,1.0,No,1.0
63057,63057,99.00,131,204,335,0.39104477611940297,0.608955223880597,No,0.608955223880597
63058,63058,99.00,55,110,165,0.3333333333333333,0.6666666666666666,No,0.6666666666666666
63059,63059,99.00,130,198,328,0.39634146341463417,0.6036585365853658,No,0.6036585365853658
63060,63060,99.00,3,3,6,0.5,0.5,Tie,0.5
63061,63061,57.14,111,113,224,0.4955357142857143,0.5044642857142857,No,0.5044642857142857
63062,63062,99.00,121,178,299,0.40468227424749165,0.5953177257525084,No,0.5953177257525084
63063,63063,99.00,100,173,273,0.3663003663003663,0.6336996336996337,No,0.6336996336996337
63064,63064,99.00,163,330,493,0.3306288032454361,0.6693711967545639,No,0.6693711967545639
63065,63065,99.00,88,139,227,0.3876651982378855,0.6123348017621145,No,0.6123348017621145
63066,63066,99.00,4,4,8,0.5,0.5,Tie,0.5
63067,63067,99.00,86,171,257,0.3346303501945525,0.6653696498054474,No,0.6653696498054474
63068,63068,99.00,1,1,2,0.5,0.5,Tie,0.5
63069,63069,99.00,5,5,10,0.5,0.5,Tie,0.5
63070,63070,99.00,1,3,4,0.25,0.75,No,0.75
63071,63071,99.00,66,20,86,0.7674418604651163,0.23255813953488372,Yes,0.7674418604651163
63072,63072,99.00,82,132,214,0.38317757009345793,0.616822429906542,No,0.616822429906542
63073,63073,99.00,69,84,153,0.45098039215686275,0.5490196078431373,No,0.5490196078431373
63074,63074,99.00,7,2,9,0.7777777777777778,0.2222222222222222,Yes,0.7777777777777778
63075,63075,99.00,34,16,50,0.68,0.32,Yes,0.68
63076,63076,99.00,62,103,165,0.37575757575757573,0.6242424242424243,No,0.6242424242424243
63077,63077,99.00,55,64,119,0.46218487394957986,0.5378151260504201,No,0.5378151260504201
63078,63078,99.00,3,1,4,0.75,0.25,Yes,0.75
63079,63079,99.00,9,1,10,0.9,0.1,Yes,0.9
63080,63080,99.00,75,50,125,0.6,0.4,Yes,0.6
63081,63081,99.00,2,0,2,1.0,0.0,Yes,1.0
63082,63082,99.00,90,129,219,0.410958904109589,0.589041095890411,No,0.589041095890411
63083,63083,99.00,105,124,229,0.4585152838427948,0.5414847161572053,No,0.5414847161572053
63084,63084,99.00,75,66,141,0.5319148936170213,0.46808510638297873,Yes,0.5319148936170213
63085,63085,0.00,3,2,5,0.6,0.4,Yes,0.6
63086,63086,99.00,0,0,0,0,0,n/a,0
63087,63087,99.00,0,0,0,0,0,n/a,0
63088,63088,99.00,0,0,0,0,0,n/a,0
63089,63089,99.00,0,0,0,0,0,n/a,0
63090,63090,99.00,0,0,0,0,0,n/a,0
